Input Number, Run_Number, Result@ 100, U, X2, X1, Reaction1, Reaction2, Reaction3, Reaction4
INVAR-1, Run: 001, F, 0, 38, 0, 102, 25, 126, 151
INVAR-1, Run: 002, F, 0, 0, 38, 156, 485, 142, 627
INVAR-1, Run: 003, F, 0, 0, 38, 83, 216, 69, 285
INVAR-1, Run: 004, F, 0, 38, 0, 396, 266, 420, 686
INVAR-1, Run: 005, F, 0, 38, 0, 107, 42, 131, 173
INVAR-1, Run: 006, F, 0, 38, 0, 180, 96, 204, 300
INVAR-1, Run: 007, F, 0, 0, 38, 133, 172, 119, 291
INVAR-1, Run: 008, F, 0, 38, 0, 345, 159, 369, 528
INVAR-1, Run: 009, F, 0, 0, 38, 50, 228, 36, 264
INVAR-1, Run: 010, F, 0, 0, 38, 143, 603, 129, 732
INVAR-1, Run: 011, F, 0, 38, 0, 224, 420, 248, 668
INVAR-1, Run: 012, F, 0, 0, 38, 65, 206, 51, 257
INVAR-1, Run: 013, F, 0, 38, 0, 53, 25, 77, 102
INVAR-1, Run: 014, F, 0, 0, 38, 109, 257, 95, 352
INVAR-1, Run: 015, F, 0, 0, 38, 55, 325, 41, 366
INVAR-1, Run: 016, F, 0, 38, 0, 132, 58, 156, 214
INVAR-1, Run: 017, F, 0, 0, 38, 158, 306, 144, 450
INVAR-1, Run: 018, F, 0, 38, 0, 186, 326, 210, 536
INVAR-1, Run: 019, F, 0, 38, 0, 132, 140, 156, 296
INVAR-1, Run: 020, F, 0, 0, 38, 108, 287, 94, 381
INVAR-1, Run: 021, F, 0, 0, 38, 200, 202, 186, 388
INVAR-1, Run: 022, F, 0, 38, 0, 98, 45, 122, 167
INVAR-1, Run: 023, F, 0, 0, 38, 75, 132, 61, 193
INVAR-1, Run: 024, F, 0, 0, 38, 265, 448, 251, 699
INVAR-1, Run: 025, F, 0, 38, 0, 82, 73, 106, 179
INVAR-1, Run: 026, F, 0, 38, 0, 121, 96, 145, 241
INVAR-1, Run: 027, F, 0, 38, 0, 19, 21, 43, 64
INVAR-1, Run: 028, F, 0, 0, 38, 53, 363, 39, 402
INVAR-1, Run: 029, F, 0, 0, 38, 110, 490, 96, 586
INVAR-1, Run: 030, F, 0, 0, 38, 155, 178, 141, 319
INVAR-1, Run: 031, F, 0, 38, 0, 144, 49, 168, 217
INVAR-1, Run: 032, F, 0, 0, 38, 42, 161, 28, 189
INVAR-1, Run: 033, F, 0, 0, 38, 250, 721, 236, 957
INVAR-1, Run: 034, F, 0, 0, 38, 335, 463, 321, 784
INVAR-1, Run: 035, F, 0, 38, 0, 94, 72, 118, 190
INVAR-1, Run: 036, F, 0, 0, 38, 127, 209, 113, 322
INVAR-1, Run: 037, F, 0, 0, 38, 89, 128, 75, 203
INVAR-1, Run: 038, F, 0, 38, 0, 314, 267, 338, 605
INVAR-1, Run: 039, F, 0, 0, 38, 266, 428, 252, 680
INVAR-1, Run: 040, F, 0, 0, 38, 160, 499, 146, 645
INVAR-1, Run: 041, F, 0, 38, 0, 130, 64, 154, 218
INVAR-1, Run: 042, F, 0, 0, 38, 102, 150, 88, 238
INVAR-1, Run: 043, F, 0, 0, 38, 148, 253, 134, 387
INVAR-1, Run: 044, F, 0, 0, 38, 22, 98, 8, 106
INVAR-1, Run: 045, F, 0, 0, 38, 57, 211, 43, 254
INVAR-1, Run: 046, F, 0, 0, 38, 98, 208, 84, 292
INVAR-1, Run: 047, F, 0, 38, 0, 236, 123, 260, 383
INVAR-1, Run: 048, F, 0, 0, 38, 72, 92, 58, 150
INVAR-1, Run: 049, F, 0, 0, 38, 71, 271, 57, 328
INVAR-1, Run: 050, F, 0, 0, 38, 56, 257, 42, 299
INVAR-1, Run: 051, F, 0, 0, 38, 159, 230, 145, 375
INVAR-1, Run: 052, F, 0, 38, 0, 475, 255, 499, 754
INVAR-1, Run: 053, F, 0, 38, 0, 61, 48, 85, 133
INVAR-1, Run: 054, F, 0, 0, 38, 47, 172, 33, 205
INVAR-1, Run: 055, F, 0, 0, 38, 586, 611, 572, 1183
INVAR-1, Run: 056, F, 0, 38, 0, 425, 576, 449, 1025
INVAR-1, Run: 057, F, 0, 0, 38, 41, 237, 27, 264
INVAR-1, Run: 058, F, 0, 38, 0, 185, 130, 209, 339
INVAR-1, Run: 059, F, 0, 0, 38, 271, 568, 257, 825
INVAR-1, Run: 060, F, 0, 0, 38, 28, 101, 14, 115
INVAR-1, Run: 061, F, 0, 38, 0, 410, 305, 434, 739
INVAR-1, Run: 062, F, 0, 38, 0, 25, 25, 49, 74
INVAR-1, Run: 063, F, 0, 0, 38, 216, 438, 202, 640
INVAR-1, Run: 064, F, 0, 38, 0, 173, 328, 197, 525
INVAR-1, Run: 065, F, 0, 0, 38, 84, 254, 70, 324
INVAR-1, Run: 066, F, 0, 38, 0, 156, 104, 180, 284
INVAR-1, Run: 067, F, 0, 0, 38, 329, 384, 315, 699
INVAR-1, Run: 068, F, 0, 38, 0, 568, 298, 592, 890
INVAR-1, Run: 069, F, 0, 0, 38, 36, 86, 22, 108
INVAR-1, Run: 070, F, 0, 0, 38, 136, 294, 122, 416
INVAR-1, Run: 071, F, 0, 0, 38, 169, 331, 155, 486
INVAR-1, Run: 072, F, 0, 0, 38, 107, 349, 93, 442
INVAR-1, Run: 073, F, 0, 38, 0, 303, 113, 327, 440
INVAR-1, Run: 074, F, 0, 0, 38, 15, 52, 1, 53
INVAR-1, Run: 075, F, 0, 0, 38, 163, 401, 149, 550
INVAR-1, Run: 076, F, 0, 0, 38, 132, 189, 118, 307
INVAR-1, Run: 077, F, 0, 0, 38, 49, 324, 35, 359
INVAR-1, Run: 078, F, 0, 0, 38, 307, 590, 293, 883
INVAR-1, Run: 079, F, 0, 0, 38, 321, 314, 307, 621
INVAR-1, Run: 080, F, 0, 0, 38, 89, 307, 75, 382
INVAR-1, Run: 081, F, 0, 0, 38, 111, 382, 97, 479
INVAR-1, Run: 082, F, 0, 0, 38, 117, 202, 103, 305
INVAR-1, Run: 083, F, 0, 0, 38, 116, 299, 102, 401
INVAR-1, Run: 084, F, 0, 0, 38, 76, 219, 62, 281
INVAR-1, Run: 085, F, 0, 38, 0, 83, 60, 107, 167
INVAR-1, Run: 086, F, 0, 0, 38, 57, 152, 43, 195
INVAR-1, Run: 087, F, 0, 38, 0, 117, 136, 141, 277
INVAR-1, Run: 088, F, 0, 0, 38, 124, 276, 110, 386
INVAR-1, Run: 089, F, 0, 0, 38, 305, 356, 291, 647
INVAR-1, Run: 090, F, 0, 0, 38, 304, 991, 290, 1281
INVAR-1, Run: 091, F, 0, 0, 38, 195, 587, 181, 768
INVAR-1, Run: 092, F, 0, 38, 0, 211, 142, 235, 377
INVAR-1, Run: 093, F, 0, 0, 38, 303, 594, 289, 883
INVAR-1, Run: 094, F, 0, 0, 38, 280, 427, 266, 693
INVAR-1, Run: 095, F, 0, 38, 0, 204, 224, 228, 452
INVAR-1, Run: 096, F, 0, 0, 38, 38, 147, 24, 171
INVAR-1, Run: 097, F, 0, 0, 38, 353, 208, 339, 547
INVAR-1, Run: 098, F, 0, 38, 0, 212, 159, 236, 395
INVAR-1, Run: 099, F, 0, 0, 38, 93, 417, 79, 496
INVAR-1, Run: 100, F, 0, 38, 0, 116, 28, 140, 168
INVAR-10, Run: 001, F, 0, 0, 12, 27, 32, 22, 54
INVAR-10, Run: 002, F, 0, 12, 0, 3, 3, 10, 13
INVAR-10, Run: 003, F, 0, 0, 12, 29, 28, 24, 52
INVAR-10, Run: 004, F, 0, 0, 12, 49, 23, 44, 67
INVAR-10, Run: 005, F, 0, 0, 12, 23, 22, 18, 40
INVAR-10, Run: 006, F, 0, 0, 12, 22, 22, 17, 39
INVAR-10, Run: 007, F, 0, 0, 12, 21, 36, 16, 52
INVAR-10, Run: 008, F, 0, 0, 12, 10, 11, 5, 16
INVAR-10, Run: 009, F, 0, 0, 12, 37, 43, 32, 75
INVAR-10, Run: 010, F, 0, 0, 12, 16, 30, 11, 41
INVAR-10, Run: 011, F, 0, 0, 12, 46, 38, 41, 79
INVAR-10, Run: 012, F, 0, 12, 0, 2, 2, 9, 11
INVAR-10, Run: 013, F, 0, 12, 0, 12, 0, 19, 19
INVAR-10, Run: 014, F, 0, 12, 0, 2, 2, 9, 11
INVAR-10, Run: 015, F, 0, 0, 12, 12, 20, 7, 27
INVAR-10, Run: 016, F, 0, 12, 0, 17, 22, 24, 46
INVAR-10, Run: 017, F, 0, 12, 0, 7, 1, 14, 15
INVAR-10, Run: 018, F, 0, 12, 0, 31, 18, 38, 56
INVAR-10, Run: 019, F, 0, 0, 12, 9, 10, 4, 14
INVAR-10, Run: 020, F, 0, 0, 12, 15, 57, 10, 67
INVAR-10, Run: 021, F, 0, 12, 0, 5, 3, 12, 15
INVAR-10, Run: 022, F, 0, 12, 0, 5, 1, 12, 13
INVAR-10, Run: 023, F, 0, 0, 12, 13, 32, 8, 40
INVAR-10, Run: 024, F, 0, 12, 0, 11, 4, 18, 22
INVAR-10, Run: 025, F, 0, 0, 12, 16, 21, 11, 32
INVAR-10, Run: 026, F, 0, 0, 12, 9, 26, 4, 30
INVAR-10, Run: 027, F, 0, 0, 12, 7, 59, 2, 61
INVAR-10, Run: 028, F, 0, 0, 12, 9, 28, 4, 32
INVAR-10, Run: 029, F, 0, 0, 12, 6, 6, 1, 7
INVAR-10, Run: 030, F, 0, 12, 0, 8, 7, 15, 22
INVAR-10, Run: 031, F, 0, 12, 0, 21, 20, 28, 48
INVAR-10, Run: 032, F, 0, 0, 12, 9, 26, 4, 30
INVAR-10, Run: 033, F, 0, 0, 12, 20, 19, 15, 34
INVAR-10, Run: 034, F, 0, 12, 0, 21, 6, 28, 34
INVAR-10, Run: 035, F, 0, 12, 0, 5, 3, 12, 15
INVAR-10, Run: 036, F, 0, 12, 0, 7, 3, 14, 17
INVAR-10, Run: 037, F, 0, 12, 0, 24, 13, 31, 44
INVAR-10, Run: 038, F, 0, 0, 12, 29, 50, 24, 74
INVAR-10, Run: 039, F, 0, 12, 0, 15, 5, 22, 27
INVAR-10, Run: 040, F, 0, 0, 12, 11, 16, 6, 22
INVAR-10, Run: 041, F, 0, 12, 0, 12, 8, 19, 27
INVAR-10, Run: 042, F, 0, 0, 12, 16, 20, 11, 31
INVAR-10, Run: 043, F, 0, 12, 0, 11, 0, 18, 18
INVAR-10, Run: 044, F, 0, 0, 12, 12, 21, 7, 28
INVAR-10, Run: 045, F, 0, 12, 0, 12, 10, 19, 29
INVAR-10, Run: 046, F, 0, 12, 0, 22, 6, 29, 35
INVAR-10, Run: 047, P, 0, 12, 0, 0, 0, 7, 7
INVAR-10, Run: 048, F, 0, 0, 12, 10, 16, 5, 21
INVAR-10, Run: 049, F, 0, 0, 12, 13, 21, 8, 29
INVAR-10, Run: 050, F, 0, 0, 12, 16, 29, 11, 40
INVAR-10, Run: 051, F, 0, 0, 12, 17, 34, 12, 46
INVAR-10, Run: 052, F, 0, 0, 12, 8, 22, 3, 25
INVAR-10, Run: 053, F, 0, 0, 12, 16, 17, 11, 28
INVAR-10, Run: 054, F, 0, 0, 12, 45, 55, 40, 95
INVAR-10, Run: 055, F, 0, 12, 0, 5, 7, 12, 19
INVAR-10, Run: 056, F, 0, 0, 12, 19, 51, 14, 65
INVAR-10, Run: 057, F, 0, 0, 12, 7, 39, 2, 41
INVAR-10, Run: 058, F, 0, 0, 12, 89, 95, 84, 179
INVAR-10, Run: 059, F, 0, 12, 0, 4, 1, 11, 12
INVAR-10, Run: 060, F, 0, 12, 0, 37, 44, 44, 88
INVAR-10, Run: 061, F, 0, 12, 0, 27, 11, 34, 45
INVAR-10, Run: 062, F, 0, 0, 12, 5, 6, 0, 6
INVAR-10, Run: 063, F, 0, 0, 12, 9, 23, 4, 27
INVAR-10, Run: 064, F, 0, 0, 12, 6, 19, 1, 20
INVAR-10, Run: 065, F, 0, 0, 12, 9, 6, 4, 10
INVAR-10, Run: 066, F, 0, 12, 0, 17, 21, 24, 45
INVAR-10, Run: 067, F, 0, 0, 12, 15, 19, 10, 29
INVAR-10, Run: 068, F, 0, 0, 12, 21, 32, 16, 48
INVAR-10, Run: 069, F, 0, 0, 12, 17, 25, 12, 37
INVAR-10, Run: 070, F, 0, 12, 0, 5, 1, 12, 13
INVAR-10, Run: 071, F, 0, 0, 12, 7, 32, 2, 34
INVAR-10, Run: 072, F, 0, 12, 0, 11, 9, 18, 27
INVAR-10, Run: 073, F, 0, 0, 12, 75, 50, 70, 120
INVAR-10, Run: 074, F, 0, 12, 0, 29, 30, 36, 66
INVAR-10, Run: 075, F, 0, 0, 12, 5, 9, 0, 9
INVAR-10, Run: 076, F, 0, 12, 0, 18, 13, 25, 38
INVAR-10, Run: 077, F, 0, 0, 12, 34, 22, 29, 51
INVAR-10, Run: 078, F, 0, 0, 12, 38, 32, 33, 65
INVAR-10, Run: 079, F, 0, 12, 0, 10, 3, 17, 20
INVAR-10, Run: 080, F, 0, 0, 12, 12, 44, 7, 51
INVAR-10, Run: 081, F, 0, 12, 0, 3, 3, 10, 13
INVAR-10, Run: 082, F, 0, 0, 12, 5, 8, 0, 8
INVAR-10, Run: 083, F, 0, 12, 0, 7, 5, 14, 19
INVAR-10, Run: 084, F, 0, 0, 12, 38, 95, 33, 128
INVAR-10, Run: 085, F, 0, 0, 12, 32, 79, 27, 106
INVAR-10, Run: 086, F, 0, 0, 12, 24, 33, 19, 52
INVAR-10, Run: 087, F, 0, 0, 12, 8, 21, 3, 24
INVAR-10, Run: 088, F, 0, 0, 12, 7, 13, 2, 15
INVAR-10, Run: 089, F, 0, 0, 12, 17, 30, 12, 42
INVAR-10, Run: 090, F, 0, 0, 12, 7, 18, 2, 20
INVAR-10, Run: 091, F, 0, 0, 12, 9, 28, 4, 32
INVAR-10, Run: 092, F, 0, 0, 12, 21, 37, 16, 53
INVAR-10, Run: 093, F, 0, 12, 0, 3, 1, 10, 11
INVAR-10, Run: 094, F, 0, 12, 0, 4, 0, 11, 11
INVAR-10, Run: 095, F, 0, 12, 0, 14, 3, 21, 24
INVAR-10, Run: 096, F, 0, 12, 0, 2, 8, 9, 17
INVAR-10, Run: 097, F, 0, 0, 12, 16, 24, 11, 35
INVAR-10, Run: 098, F, 0, 0, 12, 15, 50, 10, 60
INVAR-10, Run: 099, F, 0, 0, 12, 14, 24, 9, 33
INVAR-10, Run: 100, F, 0, 0, 12, 31, 42, 26, 68
INVAR-11, Run: 001, P, 0, 0, 13, 0, 0, 0, 0
INVAR-11, Run: 002, P, 0, 0, 13, 0, 0, 0, 0
INVAR-11, Run: 003, P, 0, 0, 13, 0, 0, 0, 0
INVAR-11, Run: 004, P, 0, 0, 13, 0, 0, 0, 0
INVAR-11, Run: 005, P, 0, 0, 13, 0, 0, 0, 0
INVAR-11, Run: 006, P, 0, 0, 13, 0, 0, 0, 0
INVAR-11, Run: 007, P, 0, 0, 13, 0, 0, 0, 0
INVAR-11, Run: 008, P, 0, 0, 13, 0, 0, 0, 0
INVAR-11, Run: 009, P, 0, 0, 13, 0, 0, 0, 0
INVAR-11, Run: 010, P, 0, 0, 13, 0, 0, 0, 0
INVAR-11, Run: 011, P, 0, 0, 13, 0, 0, 0, 0
INVAR-11, Run: 012, P, 0, 0, 13, 0, 0, 0, 0
INVAR-11, Run: 013, P, 0, 0, 13, 0, 0, 0, 0
INVAR-11, Run: 014, P, 0, 0, 13, 0, 0, 0, 0
INVAR-11, Run: 015, P, 0, 0, 13, 0, 0, 0, 0
INVAR-11, Run: 016, P, 0, 0, 13, 0, 0, 0, 0
INVAR-11, Run: 017, P, 0, 0, 13, 0, 0, 0, 0
INVAR-11, Run: 018, P, 0, 0, 13, 0, 0, 0, 0
INVAR-11, Run: 019, P, 0, 0, 13, 0, 0, 0, 0
INVAR-11, Run: 020, P, 0, 0, 13, 0, 0, 0, 0
INVAR-11, Run: 021, P, 0, 0, 13, 0, 0, 0, 0
INVAR-11, Run: 022, P, 0, 0, 13, 0, 0, 0, 0
INVAR-11, Run: 023, P, 0, 0, 13, 0, 0, 0, 0
INVAR-11, Run: 024, P, 0, 0, 13, 0, 0, 0, 0
INVAR-11, Run: 025, P, 0, 0, 13, 0, 0, 0, 0
INVAR-11, Run: 026, P, 0, 0, 13, 0, 0, 0, 0
INVAR-11, Run: 027, P, 0, 0, 13, 0, 0, 0, 0
INVAR-11, Run: 028, P, 0, 0, 13, 0, 0, 0, 0
INVAR-11, Run: 029, P, 0, 0, 13, 0, 0, 0, 0
INVAR-11, Run: 030, P, 0, 0, 13, 0, 0, 0, 0
INVAR-11, Run: 031, P, 0, 0, 13, 0, 0, 0, 0
INVAR-11, Run: 032, P, 0, 0, 13, 0, 0, 0, 0
INVAR-11, Run: 033, P, 0, 0, 13, 0, 0, 0, 0
INVAR-11, Run: 034, P, 0, 0, 13, 0, 0, 0, 0
INVAR-11, Run: 035, P, 0, 0, 13, 0, 0, 0, 0
INVAR-11, Run: 036, P, 0, 0, 13, 0, 0, 0, 0
INVAR-11, Run: 037, P, 0, 0, 13, 0, 0, 0, 0
INVAR-11, Run: 038, P, 0, 0, 13, 0, 0, 0, 0
INVAR-11, Run: 039, P, 0, 0, 13, 0, 0, 0, 0
INVAR-11, Run: 040, P, 0, 0, 13, 0, 0, 0, 0
INVAR-11, Run: 041, P, 0, 0, 13, 0, 0, 0, 0
INVAR-11, Run: 042, P, 0, 0, 13, 0, 0, 0, 0
INVAR-11, Run: 043, P, 0, 0, 13, 0, 0, 0, 0
INVAR-11, Run: 044, P, 0, 0, 13, 0, 0, 0, 0
INVAR-11, Run: 045, P, 0, 0, 13, 0, 0, 0, 0
INVAR-11, Run: 046, P, 0, 0, 13, 0, 0, 0, 0
INVAR-11, Run: 047, P, 0, 0, 13, 0, 0, 0, 0
INVAR-11, Run: 048, P, 0, 0, 13, 0, 0, 0, 0
INVAR-11, Run: 049, P, 0, 0, 13, 0, 0, 0, 0
INVAR-11, Run: 050, P, 0, 0, 13, 0, 0, 0, 0
INVAR-11, Run: 051, P, 0, 0, 13, 0, 0, 0, 0
INVAR-11, Run: 052, P, 0, 0, 13, 0, 0, 0, 0
INVAR-11, Run: 053, P, 0, 0, 13, 0, 0, 0, 0
INVAR-11, Run: 054, P, 0, 0, 13, 0, 0, 0, 0
INVAR-11, Run: 055, P, 0, 0, 13, 0, 0, 0, 0
INVAR-11, Run: 056, P, 0, 0, 13, 0, 0, 0, 0
INVAR-11, Run: 057, P, 0, 0, 13, 0, 0, 0, 0
INVAR-11, Run: 058, P, 0, 0, 13, 0, 0, 0, 0
INVAR-11, Run: 059, P, 0, 0, 13, 0, 0, 0, 0
INVAR-11, Run: 060, P, 0, 0, 13, 0, 0, 0, 0
INVAR-11, Run: 061, P, 0, 0, 13, 0, 0, 0, 0
INVAR-11, Run: 062, P, 0, 0, 13, 0, 0, 0, 0
INVAR-11, Run: 063, P, 0, 0, 13, 0, 0, 0, 0
INVAR-11, Run: 064, P, 0, 0, 13, 0, 0, 0, 0
INVAR-11, Run: 065, P, 0, 0, 13, 0, 0, 0, 0
INVAR-11, Run: 066, P, 0, 0, 13, 0, 0, 0, 0
INVAR-11, Run: 067, P, 0, 0, 13, 0, 0, 0, 0
INVAR-11, Run: 068, P, 0, 0, 13, 0, 0, 0, 0
INVAR-11, Run: 069, P, 0, 0, 13, 0, 0, 0, 0
INVAR-11, Run: 070, P, 0, 0, 13, 0, 0, 0, 0
INVAR-11, Run: 071, P, 0, 0, 13, 0, 0, 0, 0
INVAR-11, Run: 072, P, 0, 0, 13, 0, 0, 0, 0
INVAR-11, Run: 073, P, 0, 0, 13, 0, 0, 0, 0
INVAR-11, Run: 074, P, 0, 0, 13, 0, 0, 0, 0
INVAR-11, Run: 075, P, 0, 0, 13, 0, 0, 0, 0
INVAR-11, Run: 076, P, 0, 0, 13, 0, 0, 0, 0
INVAR-11, Run: 077, P, 0, 0, 13, 0, 0, 0, 0
INVAR-11, Run: 078, P, 0, 0, 13, 0, 0, 0, 0
INVAR-11, Run: 079, P, 0, 0, 13, 0, 0, 0, 0
INVAR-11, Run: 080, P, 0, 0, 13, 0, 0, 0, 0
INVAR-11, Run: 081, P, 0, 0, 13, 0, 0, 0, 0
INVAR-11, Run: 082, P, 0, 0, 13, 0, 0, 0, 0
INVAR-11, Run: 083, P, 0, 0, 13, 0, 0, 0, 0
INVAR-11, Run: 084, P, 0, 0, 13, 0, 0, 0, 0
INVAR-11, Run: 085, P, 0, 0, 13, 0, 0, 0, 0
INVAR-11, Run: 086, P, 0, 0, 13, 0, 0, 0, 0
INVAR-11, Run: 087, P, 0, 0, 13, 0, 0, 0, 0
INVAR-11, Run: 088, P, 0, 0, 13, 0, 0, 0, 0
INVAR-11, Run: 089, P, 0, 0, 13, 0, 0, 0, 0
INVAR-11, Run: 090, P, 0, 0, 13, 0, 0, 0, 0
INVAR-11, Run: 091, P, 0, 0, 13, 0, 0, 0, 0
INVAR-11, Run: 092, P, 0, 0, 13, 0, 0, 0, 0
INVAR-11, Run: 093, P, 0, 0, 13, 0, 0, 0, 0
INVAR-11, Run: 094, P, 0, 0, 13, 0, 0, 0, 0
INVAR-11, Run: 095, P, 0, 0, 13, 0, 0, 0, 0
INVAR-11, Run: 096, P, 0, 0, 13, 0, 0, 0, 0
INVAR-11, Run: 097, P, 0, 0, 13, 0, 0, 0, 0
INVAR-11, Run: 098, P, 0, 0, 13, 0, 0, 0, 0
INVAR-11, Run: 099, P, 0, 0, 13, 0, 0, 0, 0
INVAR-11, Run: 100, P, 0, 0, 13, 0, 0, 0, 0
INVAR-12, Run: 001, P, 0, 0, 7, 0, 0, 0, 0
INVAR-12, Run: 002, P, 0, 0, 7, 0, 0, 0, 0
INVAR-12, Run: 003, P, 0, 0, 7, 0, 0, 0, 0
INVAR-12, Run: 004, P, 0, 0, 7, 0, 0, 0, 0
INVAR-12, Run: 005, P, 0, 0, 7, 0, 0, 0, 0
INVAR-12, Run: 006, P, 0, 0, 7, 0, 0, 0, 0
INVAR-12, Run: 007, P, 0, 0, 7, 0, 0, 0, 0
INVAR-12, Run: 008, P, 0, 0, 7, 0, 0, 0, 0
INVAR-12, Run: 009, P, 0, 0, 7, 0, 0, 0, 0
INVAR-12, Run: 010, P, 0, 0, 7, 0, 0, 0, 0
INVAR-12, Run: 011, P, 0, 0, 7, 0, 0, 0, 0
INVAR-12, Run: 012, P, 0, 0, 7, 0, 0, 0, 0
INVAR-12, Run: 013, P, 0, 0, 7, 0, 0, 0, 0
INVAR-12, Run: 014, P, 0, 0, 7, 0, 0, 0, 0
INVAR-12, Run: 015, P, 0, 0, 7, 0, 0, 0, 0
INVAR-12, Run: 016, P, 0, 0, 7, 0, 0, 0, 0
INVAR-12, Run: 017, P, 0, 0, 7, 0, 0, 0, 0
INVAR-12, Run: 018, P, 0, 0, 7, 0, 0, 0, 0
INVAR-12, Run: 019, P, 0, 0, 7, 0, 0, 0, 0
INVAR-12, Run: 020, P, 0, 0, 7, 0, 0, 0, 0
INVAR-12, Run: 021, P, 0, 0, 7, 0, 0, 0, 0
INVAR-12, Run: 022, P, 0, 0, 7, 0, 0, 0, 0
INVAR-12, Run: 023, P, 0, 0, 7, 0, 0, 0, 0
INVAR-12, Run: 024, P, 0, 0, 7, 0, 0, 0, 0
INVAR-12, Run: 025, P, 0, 0, 7, 0, 0, 0, 0
INVAR-12, Run: 026, P, 0, 0, 7, 0, 0, 0, 0
INVAR-12, Run: 027, P, 0, 0, 7, 0, 0, 0, 0
INVAR-12, Run: 028, P, 0, 0, 7, 0, 0, 0, 0
INVAR-12, Run: 029, P, 0, 0, 7, 0, 0, 0, 0
INVAR-12, Run: 030, P, 0, 0, 7, 0, 0, 0, 0
INVAR-12, Run: 031, P, 0, 0, 7, 0, 0, 0, 0
INVAR-12, Run: 032, P, 0, 0, 7, 0, 0, 0, 0
INVAR-12, Run: 033, P, 0, 0, 7, 0, 0, 0, 0
INVAR-12, Run: 034, P, 0, 0, 7, 0, 0, 0, 0
INVAR-12, Run: 035, P, 0, 0, 7, 0, 0, 0, 0
INVAR-12, Run: 036, P, 0, 0, 7, 0, 0, 0, 0
INVAR-12, Run: 037, P, 0, 0, 7, 0, 0, 0, 0
INVAR-12, Run: 038, P, 0, 0, 7, 0, 0, 0, 0
INVAR-12, Run: 039, P, 0, 0, 7, 0, 0, 0, 0
INVAR-12, Run: 040, P, 0, 0, 7, 0, 0, 0, 0
INVAR-12, Run: 041, P, 0, 0, 7, 0, 0, 0, 0
INVAR-12, Run: 042, P, 0, 0, 7, 0, 0, 0, 0
INVAR-12, Run: 043, P, 0, 0, 7, 0, 0, 0, 0
INVAR-12, Run: 044, P, 0, 0, 7, 0, 0, 0, 0
INVAR-12, Run: 045, P, 0, 0, 7, 0, 0, 0, 0
INVAR-12, Run: 046, P, 0, 0, 7, 0, 0, 0, 0
INVAR-12, Run: 047, P, 0, 0, 7, 0, 0, 0, 0
INVAR-12, Run: 048, P, 0, 0, 7, 0, 0, 0, 0
INVAR-12, Run: 049, P, 0, 0, 7, 0, 0, 0, 0
INVAR-12, Run: 050, P, 0, 0, 7, 0, 0, 0, 0
INVAR-12, Run: 051, P, 0, 0, 7, 0, 0, 0, 0
INVAR-12, Run: 052, P, 0, 0, 7, 0, 0, 0, 0
INVAR-12, Run: 053, P, 0, 0, 7, 0, 0, 0, 0
INVAR-12, Run: 054, P, 0, 0, 7, 0, 0, 0, 0
INVAR-12, Run: 055, P, 0, 0, 7, 0, 0, 0, 0
INVAR-12, Run: 056, P, 0, 0, 7, 0, 0, 0, 0
INVAR-12, Run: 057, P, 0, 0, 7, 0, 0, 0, 0
INVAR-12, Run: 058, P, 0, 0, 7, 0, 0, 0, 0
INVAR-12, Run: 059, P, 0, 0, 7, 0, 0, 0, 0
INVAR-12, Run: 060, P, 0, 0, 7, 0, 0, 0, 0
INVAR-12, Run: 061, P, 0, 0, 7, 0, 0, 0, 0
INVAR-12, Run: 062, P, 0, 0, 7, 0, 0, 0, 0
INVAR-12, Run: 063, P, 0, 0, 7, 0, 0, 0, 0
INVAR-12, Run: 064, P, 0, 0, 7, 0, 0, 0, 0
INVAR-12, Run: 065, P, 0, 0, 7, 0, 0, 0, 0
INVAR-12, Run: 066, P, 0, 0, 7, 0, 0, 0, 0
INVAR-12, Run: 067, P, 0, 0, 7, 0, 0, 0, 0
INVAR-12, Run: 068, P, 0, 0, 7, 0, 0, 0, 0
INVAR-12, Run: 069, P, 0, 0, 7, 0, 0, 0, 0
INVAR-12, Run: 070, P, 0, 0, 7, 0, 0, 0, 0
INVAR-12, Run: 071, P, 0, 0, 7, 0, 0, 0, 0
INVAR-12, Run: 072, P, 0, 0, 7, 0, 0, 0, 0
INVAR-12, Run: 073, P, 0, 0, 7, 0, 0, 0, 0
INVAR-12, Run: 074, P, 0, 0, 7, 0, 0, 0, 0
INVAR-12, Run: 075, P, 0, 0, 7, 0, 0, 0, 0
INVAR-12, Run: 076, P, 0, 0, 7, 0, 0, 0, 0
INVAR-12, Run: 077, P, 0, 0, 7, 0, 0, 0, 0
INVAR-12, Run: 078, P, 0, 0, 7, 0, 0, 0, 0
INVAR-12, Run: 079, P, 0, 0, 7, 0, 0, 0, 0
INVAR-12, Run: 080, P, 0, 0, 7, 0, 0, 0, 0
INVAR-12, Run: 081, P, 0, 0, 7, 0, 0, 0, 0
INVAR-12, Run: 082, P, 0, 0, 7, 0, 0, 0, 0
INVAR-12, Run: 083, P, 0, 0, 7, 0, 0, 0, 0
INVAR-12, Run: 084, P, 0, 0, 7, 0, 0, 0, 0
INVAR-12, Run: 085, P, 0, 0, 7, 0, 0, 0, 0
INVAR-12, Run: 086, P, 0, 0, 7, 0, 0, 0, 0
INVAR-12, Run: 087, P, 0, 0, 7, 0, 0, 0, 0
INVAR-12, Run: 088, P, 0, 0, 7, 0, 0, 0, 0
INVAR-12, Run: 089, P, 0, 0, 7, 0, 0, 0, 0
INVAR-12, Run: 090, P, 0, 0, 7, 0, 0, 0, 0
INVAR-12, Run: 091, P, 0, 0, 7, 0, 0, 0, 0
INVAR-12, Run: 092, P, 0, 0, 7, 0, 0, 0, 0
INVAR-12, Run: 093, P, 0, 0, 7, 0, 0, 0, 0
INVAR-12, Run: 094, P, 0, 0, 7, 0, 0, 0, 0
INVAR-12, Run: 095, P, 0, 0, 7, 0, 0, 0, 0
INVAR-12, Run: 096, P, 0, 0, 7, 0, 0, 0, 0
INVAR-12, Run: 097, P, 0, 0, 7, 0, 0, 0, 0
INVAR-12, Run: 098, P, 0, 0, 7, 0, 0, 0, 0
INVAR-12, Run: 099, P, 0, 0, 7, 0, 0, 0, 0
INVAR-12, Run: 100, P, 0, 0, 7, 0, 0, 0, 0
INVAR-13, Run: 001, P, 0, 0, 1, 0, 0, 0, 0
INVAR-13, Run: 002, P, 0, 0, 1, 0, 0, 0, 0
INVAR-13, Run: 003, P, 0, 0, 1, 0, 0, 0, 0
INVAR-13, Run: 004, P, 0, 0, 1, 0, 0, 0, 0
INVAR-13, Run: 005, P, 0, 0, 1, 0, 0, 0, 0
INVAR-13, Run: 006, P, 0, 0, 1, 0, 0, 0, 0
INVAR-13, Run: 007, P, 0, 0, 1, 0, 0, 0, 0
INVAR-13, Run: 008, P, 0, 0, 1, 0, 0, 0, 0
INVAR-13, Run: 009, P, 0, 0, 1, 0, 0, 0, 0
INVAR-13, Run: 010, P, 0, 0, 1, 0, 0, 0, 0
INVAR-13, Run: 011, P, 0, 0, 1, 0, 0, 0, 0
INVAR-13, Run: 012, P, 0, 0, 1, 0, 0, 0, 0
INVAR-13, Run: 013, P, 0, 0, 1, 0, 0, 0, 0
INVAR-13, Run: 014, P, 0, 0, 1, 0, 0, 0, 0
INVAR-13, Run: 015, P, 0, 0, 1, 0, 0, 0, 0
INVAR-13, Run: 016, P, 0, 0, 1, 0, 0, 0, 0
INVAR-13, Run: 017, P, 0, 0, 1, 0, 0, 0, 0
INVAR-13, Run: 018, P, 0, 0, 1, 0, 0, 0, 0
INVAR-13, Run: 019, P, 0, 0, 1, 0, 0, 0, 0
INVAR-13, Run: 020, P, 0, 0, 1, 0, 0, 0, 0
INVAR-13, Run: 021, P, 0, 0, 1, 0, 0, 0, 0
INVAR-13, Run: 022, P, 0, 0, 1, 0, 0, 0, 0
INVAR-13, Run: 023, P, 0, 0, 1, 0, 0, 0, 0
INVAR-13, Run: 024, P, 0, 0, 1, 0, 0, 0, 0
INVAR-13, Run: 025, P, 0, 0, 1, 0, 0, 0, 0
INVAR-13, Run: 026, P, 0, 0, 1, 0, 0, 0, 0
INVAR-13, Run: 027, P, 0, 0, 1, 0, 0, 0, 0
INVAR-13, Run: 028, P, 0, 0, 1, 0, 0, 0, 0
INVAR-13, Run: 029, P, 0, 0, 1, 0, 0, 0, 0
INVAR-13, Run: 030, P, 0, 0, 1, 0, 0, 0, 0
INVAR-13, Run: 031, P, 0, 0, 1, 0, 0, 0, 0
INVAR-13, Run: 032, P, 0, 0, 1, 0, 0, 0, 0
INVAR-13, Run: 033, P, 0, 0, 1, 0, 0, 0, 0
INVAR-13, Run: 034, P, 0, 0, 1, 0, 0, 0, 0
INVAR-13, Run: 035, P, 0, 0, 1, 0, 0, 0, 0
INVAR-13, Run: 036, P, 0, 0, 1, 0, 0, 0, 0
INVAR-13, Run: 037, P, 0, 0, 1, 0, 0, 0, 0
INVAR-13, Run: 038, P, 0, 0, 1, 0, 0, 0, 0
INVAR-13, Run: 039, P, 0, 0, 1, 0, 0, 0, 0
INVAR-13, Run: 040, P, 0, 0, 1, 0, 0, 0, 0
INVAR-13, Run: 041, P, 0, 0, 1, 0, 0, 0, 0
INVAR-13, Run: 042, P, 0, 0, 1, 0, 0, 0, 0
INVAR-13, Run: 043, P, 0, 0, 1, 0, 0, 0, 0
INVAR-13, Run: 044, P, 0, 0, 1, 0, 0, 0, 0
INVAR-13, Run: 045, P, 0, 0, 1, 0, 0, 0, 0
INVAR-13, Run: 046, P, 0, 0, 1, 0, 0, 0, 0
INVAR-13, Run: 047, P, 0, 0, 1, 0, 0, 0, 0
INVAR-13, Run: 048, P, 0, 0, 1, 0, 0, 0, 0
INVAR-13, Run: 049, P, 0, 0, 1, 0, 0, 0, 0
INVAR-13, Run: 050, P, 0, 0, 1, 0, 0, 0, 0
INVAR-13, Run: 051, P, 0, 0, 1, 0, 0, 0, 0
INVAR-13, Run: 052, P, 0, 0, 1, 0, 0, 0, 0
INVAR-13, Run: 053, P, 0, 0, 1, 0, 0, 0, 0
INVAR-13, Run: 054, P, 0, 0, 1, 0, 0, 0, 0
INVAR-13, Run: 055, P, 0, 0, 1, 0, 0, 0, 0
INVAR-13, Run: 056, P, 0, 0, 1, 0, 0, 0, 0
INVAR-13, Run: 057, P, 0, 0, 1, 0, 0, 0, 0
INVAR-13, Run: 058, P, 0, 0, 1, 0, 0, 0, 0
INVAR-13, Run: 059, P, 0, 0, 1, 0, 0, 0, 0
INVAR-13, Run: 060, P, 0, 0, 1, 0, 0, 0, 0
INVAR-13, Run: 061, P, 0, 0, 1, 0, 0, 0, 0
INVAR-13, Run: 062, P, 0, 0, 1, 0, 0, 0, 0
INVAR-13, Run: 063, P, 0, 0, 1, 0, 0, 0, 0
INVAR-13, Run: 064, P, 0, 0, 1, 0, 0, 0, 0
INVAR-13, Run: 065, P, 0, 0, 1, 0, 0, 0, 0
INVAR-13, Run: 066, P, 0, 0, 1, 0, 0, 0, 0
INVAR-13, Run: 067, P, 0, 0, 1, 0, 0, 0, 0
INVAR-13, Run: 068, P, 0, 0, 1, 0, 0, 0, 0
INVAR-13, Run: 069, P, 0, 0, 1, 0, 0, 0, 0
INVAR-13, Run: 070, P, 0, 0, 1, 0, 0, 0, 0
INVAR-13, Run: 071, P, 0, 0, 1, 0, 0, 0, 0
INVAR-13, Run: 072, P, 0, 0, 1, 0, 0, 0, 0
INVAR-13, Run: 073, P, 0, 0, 1, 0, 0, 0, 0
INVAR-13, Run: 074, P, 0, 0, 1, 0, 0, 0, 0
INVAR-13, Run: 075, P, 0, 0, 1, 0, 0, 0, 0
INVAR-13, Run: 076, P, 0, 0, 1, 0, 0, 0, 0
INVAR-13, Run: 077, P, 0, 0, 1, 0, 0, 0, 0
INVAR-13, Run: 078, P, 0, 0, 1, 0, 0, 0, 0
INVAR-13, Run: 079, P, 0, 0, 1, 0, 0, 0, 0
INVAR-13, Run: 080, P, 0, 0, 1, 0, 0, 0, 0
INVAR-13, Run: 081, P, 0, 0, 1, 0, 0, 0, 0
INVAR-13, Run: 082, P, 0, 0, 1, 0, 0, 0, 0
INVAR-13, Run: 083, P, 0, 0, 1, 0, 0, 0, 0
INVAR-13, Run: 084, P, 0, 0, 1, 0, 0, 0, 0
INVAR-13, Run: 085, P, 0, 0, 1, 0, 0, 0, 0
INVAR-13, Run: 086, P, 0, 0, 1, 0, 0, 0, 0
INVAR-13, Run: 087, P, 0, 0, 1, 0, 0, 0, 0
INVAR-13, Run: 088, P, 0, 0, 1, 0, 0, 0, 0
INVAR-13, Run: 089, P, 0, 0, 1, 0, 0, 0, 0
INVAR-13, Run: 090, P, 0, 0, 1, 0, 0, 0, 0
INVAR-13, Run: 091, P, 0, 0, 1, 0, 0, 0, 0
INVAR-13, Run: 092, P, 0, 0, 1, 0, 0, 0, 0
INVAR-13, Run: 093, P, 0, 0, 1, 0, 0, 0, 0
INVAR-13, Run: 094, P, 0, 0, 1, 0, 0, 0, 0
INVAR-13, Run: 095, P, 0, 0, 1, 0, 0, 0, 0
INVAR-13, Run: 096, P, 0, 0, 1, 0, 0, 0, 0
INVAR-13, Run: 097, P, 0, 0, 1, 0, 0, 0, 0
INVAR-13, Run: 098, P, 0, 0, 1, 0, 0, 0, 0
INVAR-13, Run: 099, P, 0, 0, 1, 0, 0, 0, 0
INVAR-13, Run: 100, P, 0, 0, 1, 0, 0, 0, 0
INVAR-14, Run: 001, F, 0, 0, 28, 27, 63, 19, 82
INVAR-14, Run: 002, F, 0, 0, 28, 107, 202, 99, 301
INVAR-14, Run: 003, F, 0, 28, 0, 66, 109, 86, 195
INVAR-14, Run: 004, F, 0, 0, 28, 76, 144, 68, 212
INVAR-14, Run: 005, F, 0, 0, 28, 325, 350, 317, 667
INVAR-14, Run: 006, F, 0, 0, 28, 58, 69, 50, 119
INVAR-14, Run: 007, F, 0, 28, 0, 210, 292, 230, 522
INVAR-14, Run: 008, F, 0, 0, 28, 170, 301, 162, 463
INVAR-14, Run: 009, F, 0, 0, 28, 23, 109, 15, 124
INVAR-14, Run: 010, F, 0, 0, 28, 37, 268, 29, 297
INVAR-14, Run: 011, F, 0, 0, 28, 170, 131, 162, 293
INVAR-14, Run: 012, F, 0, 0, 28, 37, 99, 29, 128
INVAR-14, Run: 013, F, 0, 0, 28, 46, 144, 38, 182
INVAR-14, Run: 014, F, 0, 0, 28, 105, 368, 97, 465
INVAR-14, Run: 015, F, 0, 0, 28, 38, 99, 30, 129
INVAR-14, Run: 016, F, 0, 0, 28, 12, 37, 4, 41
INVAR-14, Run: 017, F, 0, 0, 28, 15, 32, 7, 39
INVAR-14, Run: 018, F, 0, 28, 0, 122, 96, 142, 238
INVAR-14, Run: 019, F, 0, 0, 28, 17, 78, 9, 87
INVAR-14, Run: 020, F, 0, 0, 28, 14, 58, 6, 64
INVAR-14, Run: 021, F, 0, 28, 0, 81, 28, 101, 129
INVAR-14, Run: 022, F, 0, 0, 28, 47, 91, 39, 130
INVAR-14, Run: 023, F, 0, 28, 0, 39, 32, 59, 91
INVAR-14, Run: 024, F, 0, 28, 0, 63, 27, 83, 110
INVAR-14, Run: 025, F, 0, 0, 28, 53, 150, 45, 195
INVAR-14, Run: 026, F, 0, 0, 28, 84, 118, 76, 194
INVAR-14, Run: 027, F, 0, 0, 28, 98, 286, 90, 376
INVAR-14, Run: 028, F, 0, 0, 28, 17, 55, 9, 64
INVAR-14, Run: 029, F, 0, 0, 28, 115, 156, 107, 263
INVAR-14, Run: 030, F, 0, 28, 0, 28, 44, 48, 92
INVAR-14, Run: 031, F, 0, 0, 28, 19, 61, 11, 72
INVAR-14, Run: 032, F, 0, 0, 28, 92, 270, 84, 354
INVAR-14, Run: 033, F, 0, 0, 28, 80, 216, 72, 288
INVAR-14, Run: 034, F, 0, 28, 0, 30, 33, 50, 83
INVAR-14, Run: 035, F, 0, 0, 28, 58, 180, 50, 230
INVAR-14, Run: 036, F, 0, 0, 28, 33, 80, 25, 105
INVAR-14, Run: 037, F, 0, 0, 28, 87, 174, 79, 253
INVAR-14, Run: 038, F, 0, 0, 28, 93, 103, 85, 188
INVAR-14, Run: 039, F, 0, 0, 28, 40, 169, 32, 201
INVAR-14, Run: 040, F, 0, 28, 0, 150, 129, 170, 299
INVAR-14, Run: 041, F, 0, 0, 28, 35, 98, 27, 125
INVAR-14, Run: 042, F, 0, 28, 0, 139, 137, 159, 296
INVAR-14, Run: 043, F, 0, 0, 28, 12, 64, 4, 68
INVAR-14, Run: 044, F, 0, 0, 28, 51, 174, 43, 217
INVAR-14, Run: 045, F, 0, 0, 28, 64, 381, 56, 437
INVAR-14, Run: 046, F, 0, 0, 28, 101, 377, 93, 470
INVAR-14, Run: 047, F, 0, 28, 0, 138, 98, 158, 256
INVAR-14, Run: 048, F, 0, 0, 28, 16, 81, 8, 89
INVAR-14, Run: 049, F, 0, 0, 28, 12, 113, 4, 117
INVAR-14, Run: 050, F, 0, 0, 28, 24, 74, 16, 90
INVAR-14, Run: 051, F, 0, 28, 0, 78, 53, 98, 151
INVAR-14, Run: 052, F, 0, 0, 28, 35, 138, 27, 165
INVAR-14, Run: 053, F, 0, 28, 0, 125, 62, 145, 207
INVAR-14, Run: 054, F, 0, 0, 28, 25, 147, 17, 164
INVAR-14, Run: 055, F, 0, 0, 28, 41, 176, 33, 209
INVAR-14, Run: 056, F, 0, 0, 28, 120, 488, 112, 600
INVAR-14, Run: 057, F, 0, 0, 28, 137, 153, 129, 282
INVAR-14, Run: 058, F, 0, 0, 28, 89, 276, 81, 357
INVAR-14, Run: 059, F, 0, 0, 28, 24, 103, 16, 119
INVAR-14, Run: 060, F, 0, 0, 28, 29, 79, 21, 100
INVAR-14, Run: 061, F, 0, 28, 0, 159, 357, 179, 536
INVAR-14, Run: 062, F, 0, 0, 28, 168, 596, 160, 756
INVAR-14, Run: 063, F, 0, 28, 0, 57, 76, 77, 153
INVAR-14, Run: 064, F, 0, 0, 28, 40, 91, 32, 123
INVAR-14, Run: 065, F, 0, 0, 28, 15, 72, 7, 79
INVAR-14, Run: 066, F, 0, 28, 0, 224, 209, 244, 453
INVAR-14, Run: 067, F, 0, 28, 0, 73, 78, 93, 171
INVAR-14, Run: 068, F, 0, 28, 0, 26, 35, 46, 81
INVAR-14, Run: 069, F, 0, 0, 28, 9, 23, 1, 24
INVAR-14, Run: 070, F, 0, 0, 28, 29, 60, 21, 81
INVAR-14, Run: 071, F, 0, 0, 28, 18, 59, 10, 69
INVAR-14, Run: 072, F, 0, 0, 28, 17, 82, 9, 91
INVAR-14, Run: 073, F, 0, 28, 0, 333, 178, 353, 531
INVAR-14, Run: 074, F, 0, 0, 28, 31, 110, 23, 133
INVAR-14, Run: 075, F, 0, 0, 28, 154, 242, 146, 388
INVAR-14, Run: 076, F, 0, 0, 28, 46, 132, 38, 170
INVAR-14, Run: 077, F, 0, 28, 0, 57, 57, 77, 134
INVAR-14, Run: 078, F, 0, 0, 28, 56, 141, 48, 189
INVAR-14, Run: 079, F, 0, 0, 28, 24, 126, 16, 142
INVAR-14, Run: 080, F, 0, 28, 0, 52, 44, 72, 116
INVAR-14, Run: 081, F, 0, 28, 0, 249, 468, 269, 737
INVAR-14, Run: 082, F, 0, 0, 28, 93, 89, 85, 174
INVAR-14, Run: 083, F, 0, 0, 28, 57, 121, 49, 170
INVAR-14, Run: 084, F, 0, 0, 28, 26, 39, 18, 57
INVAR-14, Run: 085, F, 0, 0, 28, 17, 27, 9, 36
INVAR-14, Run: 086, F, 0, 0, 28, 10, 66, 2, 68
INVAR-14, Run: 087, F, 0, 0, 28, 24, 89, 16, 105
INVAR-14, Run: 088, F, 0, 28, 0, 60, 18, 80, 98
INVAR-14, Run: 089, F, 0, 28, 0, 93, 74, 113, 187
INVAR-14, Run: 090, F, 0, 28, 0, 52, 51, 72, 123
INVAR-14, Run: 091, F, 0, 0, 28, 73, 256, 65, 321
INVAR-14, Run: 092, F, 0, 0, 28, 37, 109, 29, 138
INVAR-14, Run: 093, F, 0, 28, 0, 68, 60, 88, 148
INVAR-14, Run: 094, F, 0, 28, 0, 164, 98, 184, 282
INVAR-14, Run: 095, F, 0, 28, 0, 195, 130, 215, 345
INVAR-14, Run: 096, F, 0, 28, 0, 402, 286, 422, 708
INVAR-14, Run: 097, F, 0, 0, 28, 36, 167, 28, 195
INVAR-14, Run: 098, F, 0, 28, 0, 135, 245, 155, 400
INVAR-14, Run: 099, F, 0, 0, 28, 20, 54, 12, 66
INVAR-14, Run: 100, F, 0, 0, 28, 27, 85, 19, 104
INVAR-15, Run: 001, F, 0, 0, 82, 86, 521, 62, 583
INVAR-15, Run: 002, F, 0, 0, 82, 312, 1327, 288, 1615
INVAR-15, Run: 003, F, 0, 0, 82, 1186, 1864, 1162, 3026
INVAR-15, Run: 004, F, 0, 0, 82, 620, 2468, 596, 3064
INVAR-15, Run: 005, F, 0, 0, 82, 431, 1335, 407, 1742
INVAR-15, Run: 006, F, 0, 0, 82, 275, 2021, 251, 2272
INVAR-15, Run: 007, F, 0, 0, 82, 201, 1137, 177, 1314
INVAR-15, Run: 008, F, 0, 82, 0, 780, 602, 838, 1440
INVAR-15, Run: 009, F, 0, 0, 82, 349, 947, 325, 1272
INVAR-15, Run: 010, F, 0, 82, 0, 1325, 3711, 1383, 5094
INVAR-15, Run: 011, F, 0, 0, 82, 88, 785, 64, 849
INVAR-15, Run: 012, F, 0, 82, 0, 805, 455, 863, 1318
INVAR-15, Run: 013, F, 0, 0, 82, 281, 1785, 257, 2042
INVAR-15, Run: 014, F, 0, 0, 82, 126, 595, 102, 697
INVAR-15, Run: 015, F, 0, 0, 82, 164, 1089, 140, 1229
INVAR-15, Run: 016, F, 0, 0, 82, 339, 1165, 315, 1480
INVAR-15, Run: 017, F, 0, 0, 82, 166, 475, 142, 617
INVAR-15, Run: 018, F, 0, 0, 82, 1265, 3483, 1241, 4724
INVAR-15, Run: 019, F, 0, 0, 82, 171, 772, 147, 919
INVAR-15, Run: 020, F, 0, 0, 82, 209, 693, 185, 878
INVAR-15, Run: 021, F, 0, 82, 0, 438, 273, 496, 769
INVAR-15, Run: 022, F, 0, 0, 82, 1508, 1389, 1484, 2873
INVAR-15, Run: 023, F, 0, 0, 82, 158, 837, 134, 971
INVAR-15, Run: 024, F, 0, 0, 82, 250, 756, 226, 982
INVAR-15, Run: 025, F, 0, 0, 82, 193, 476, 169, 645
INVAR-15, Run: 026, F, 0, 82, 0, 755, 353, 813, 1166
INVAR-15, Run: 027, F, 0, 0, 82, 2993, 4980, 2969, 7949
INVAR-15, Run: 028, F, 0, 0, 82, 1864, 2850, 1840, 4690
INVAR-15, Run: 029, F, 0, 82, 0, 709, 716, 767, 1483
INVAR-15, Run: 030, F, 0, 82, 0, 426, 294, 484, 778
INVAR-15, Run: 031, F, 0, 82, 0, 710, 860, 768, 1628
INVAR-15, Run: 032, F, 0, 0, 82, 280, 1330, 256, 1586
INVAR-15, Run: 033, F, 0, 0, 82, 324, 1724, 300, 2024
INVAR-15, Run: 034, F, 0, 0, 82, 561, 996, 537, 1533
INVAR-15, Run: 035, F, 0, 0, 82, 549, 1686, 525, 2211
INVAR-15, Run: 036, F, 0, 0, 82, 320, 1520, 296, 1816
INVAR-15, Run: 037, F, 0, 82, 0, 355, 270, 413, 683
INVAR-15, Run: 038, F, 0, 0, 82, 192, 795, 168, 963
INVAR-15, Run: 039, F, 0, 82, 0, 528, 305, 586, 891
INVAR-15, Run: 040, F, 0, 0, 82, 341, 1515, 317, 1832
INVAR-15, Run: 041, F, 0, 0, 82, 205, 811, 181, 992
INVAR-15, Run: 042, F, 0, 0, 82, 161, 1247, 137, 1384
INVAR-15, Run: 043, F, 0, 0, 82, 657, 2231, 633, 2864
INVAR-15, Run: 044, F, 0, 0, 82, 225, 1375, 201, 1576
INVAR-15, Run: 045, F, 0, 0, 82, 396, 955, 372, 1327
INVAR-15, Run: 046, F, 0, 0, 82, 138, 601, 114, 715
INVAR-15, Run: 047, F, 0, 82, 0, 431, 221, 489, 710
INVAR-15, Run: 048, F, 0, 82, 0, 1900, 2072, 1958, 4030
INVAR-15, Run: 049, F, 0, 0, 82, 1051, 1502, 1027, 2529
INVAR-15, Run: 050, F, 0, 0, 82, 243, 1043, 219, 1262
INVAR-15, Run: 051, F, 0, 0, 82, 1122, 2315, 1098, 3413
INVAR-15, Run: 052, F, 0, 0, 82, 196, 1997, 172, 2169
INVAR-15, Run: 053, F, 0, 0, 82, 393, 1345, 369, 1714
INVAR-15, Run: 054, F, 0, 0, 82, 283, 851, 259, 1110
INVAR-15, Run: 055, F, 0, 82, 0, 491, 302, 549, 851
INVAR-15, Run: 056, F, 0, 0, 82, 312, 1212, 288, 1500
INVAR-15, Run: 057, F, 0, 82, 0, 346, 149, 404, 553
INVAR-15, Run: 058, F, 0, 82, 0, 2734, 3420, 2792, 6212
INVAR-15, Run: 059, F, 0, 0, 82, 270, 1213, 246, 1459
INVAR-15, Run: 060, F, 0, 0, 82, 611, 2172, 587, 2759
INVAR-15, Run: 061, F, 0, 82, 0, 681, 489, 739, 1228
INVAR-15, Run: 062, F, 0, 82, 0, 1155, 676, 1213, 1889
INVAR-15, Run: 063, F, 0, 0, 82, 351, 1217, 327, 1544
INVAR-15, Run: 064, F, 0, 0, 82, 186, 793, 162, 955
INVAR-15, Run: 065, F, 0, 0, 82, 778, 1797, 754, 2551
INVAR-15, Run: 066, F, 0, 0, 82, 635, 1259, 611, 1870
INVAR-15, Run: 067, F, 0, 0, 82, 702, 1341, 678, 2019
INVAR-15, Run: 068, F, 0, 0, 82, 902, 670, 878, 1548
INVAR-15, Run: 069, F, 0, 82, 0, 650, 615, 708, 1323
INVAR-15, Run: 070, F, 0, 0, 82, 532, 1550, 508, 2058
INVAR-15, Run: 071, F, 0, 82, 0, 1808, 1526, 1866, 3392
INVAR-15, Run: 072, F, 0, 0, 82, 719, 1608, 695, 2303
INVAR-15, Run: 073, F, 0, 0, 82, 380, 1844, 356, 2200
INVAR-15, Run: 074, F, 0, 82, 0, 1075, 1427, 1133, 2560
INVAR-15, Run: 075, F, 0, 82, 0, 526, 189, 584, 773
INVAR-15, Run: 076, F, 0, 0, 82, 149, 883, 125, 1008
INVAR-15, Run: 077, F, 0, 0, 82, 331, 1486, 307, 1793
INVAR-15, Run: 078, F, 0, 0, 82, 218, 1430, 194, 1624
INVAR-15, Run: 079, F, 0, 0, 82, 615, 1318, 591, 1909
INVAR-15, Run: 080, F, 0, 0, 82, 330, 2204, 306, 2510
INVAR-15, Run: 081, F, 0, 82, 0, 1118, 847, 1176, 2023
INVAR-15, Run: 082, F, 0, 0, 82, 116, 1225, 92, 1317
INVAR-15, Run: 083, F, 0, 0, 82, 266, 1161, 242, 1403
INVAR-15, Run: 084, F, 0, 82, 0, 2243, 2633, 2301, 4934
INVAR-15, Run: 085, F, 0, 0, 82, 247, 1064, 223, 1287
INVAR-15, Run: 086, F, 0, 82, 0, 1664, 2340, 1722, 4062
INVAR-15, Run: 087, F, 0, 0, 82, 1128, 1318, 1104, 2422
INVAR-15, Run: 088, F, 0, 82, 0, 500, 722, 558, 1280
INVAR-15, Run: 089, F, 0, 0, 82, 415, 760, 391, 1151
INVAR-15, Run: 090, F, 0, 0, 82, 103, 597, 79, 676
INVAR-15, Run: 091, F, 0, 82, 0, 3025, 2882, 3083, 5965
INVAR-15, Run: 092, F, 0, 82, 0, 481, 272, 539, 811
INVAR-15, Run: 093, F, 0, 82, 0, 1372, 1682, 1430, 3112
INVAR-15, Run: 094, F, 0, 0, 82, 426, 998, 402, 1400
INVAR-15, Run: 095, F, 0, 0, 82, 130, 954, 106, 1060
INVAR-15, Run: 096, F, 0, 0, 82, 1266, 2917, 1242, 4159
INVAR-15, Run: 097, F, 0, 0, 82, 365, 1112, 341, 1453
INVAR-15, Run: 098, F, 0, 0, 82, 275, 1038, 251, 1289
INVAR-15, Run: 099, F, 0, 82, 0, 970, 911, 1028, 1939
INVAR-15, Run: 100, F, 0, 0, 82, 78, 381, 54, 435
INVAR-16, Run: 001, F, 0, 0, 80, 7, 126, 1, 127
INVAR-16, Run: 002, F, 0, 0, 80, 22, 427, 16, 443
INVAR-16, Run: 003, F, 0, 0, 80, 25, 379, 19, 398
INVAR-16, Run: 004, F, 0, 0, 80, 14, 269, 8, 277
INVAR-16, Run: 005, F, 0, 0, 80, 10, 207, 4, 211
INVAR-16, Run: 006, F, 0, 0, 80, 42, 487, 36, 523
INVAR-16, Run: 007, F, 0, 0, 80, 45, 391, 39, 430
INVAR-16, Run: 008, F, 0, 0, 80, 12, 231, 6, 237
INVAR-16, Run: 009, F, 0, 0, 80, 266, 1789, 260, 2049
INVAR-16, Run: 010, F, 0, 0, 80, 18, 450, 12, 462
INVAR-16, Run: 011, F, 0, 0, 80, 22, 259, 16, 275
INVAR-16, Run: 012, F, 0, 0, 80, 140, 898, 134, 1032
INVAR-16, Run: 013, F, 0, 80, 0, 465, 880, 539, 1419
INVAR-16, Run: 014, F, 0, 0, 80, 9, 128, 3, 131
INVAR-16, Run: 015, F, 0, 80, 0, 427, 869, 501, 1370
INVAR-16, Run: 016, F, 0, 0, 80, 7, 95, 1, 96
INVAR-16, Run: 017, F, 0, 80, 0, 1570, 1266, 1644, 2910
INVAR-16, Run: 018, F, 0, 0, 80, 81, 657, 75, 732
INVAR-16, Run: 019, F, 0, 0, 80, 49, 389, 43, 432
INVAR-16, Run: 020, F, 0, 0, 80, 12, 314, 6, 320
INVAR-16, Run: 021, F, 0, 0, 80, 429, 1730, 423, 2153
INVAR-16, Run: 022, F, 0, 0, 80, 32, 539, 26, 565
INVAR-16, Run: 023, F, 0, 0, 80, 56, 1072, 50, 1122
INVAR-16, Run: 024, F, 0, 0, 80, 124, 1175, 118, 1293
INVAR-16, Run: 025, F, 0, 0, 80, 66, 498, 60, 558
INVAR-16, Run: 026, F, 0, 80, 0, 818, 753, 892, 1645
INVAR-16, Run: 027, F, 0, 80, 0, 137, 487, 211, 698
INVAR-16, Run: 028, F, 0, 0, 80, 6, 104, 0, 104
INVAR-16, Run: 029, F, 0, 0, 80, 13, 205, 7, 212
INVAR-16, Run: 030, F, 0, 0, 80, 9, 90, 3, 93
INVAR-16, Run: 031, F, 0, 0, 80, 415, 2120, 409, 2529
INVAR-16, Run: 032, F, 0, 0, 80, 24, 318, 18, 336
INVAR-16, Run: 033, F, 0, 0, 80, 31, 486, 25, 511
INVAR-16, Run: 034, F, 0, 0, 80, 11, 90, 5, 95
INVAR-16, Run: 035, F, 0, 0, 80, 104, 807, 98, 905
INVAR-16, Run: 036, F, 0, 80, 0, 574, 836, 648, 1484
INVAR-16, Run: 037, F, 0, 0, 80, 24, 539, 18, 557
INVAR-16, Run: 038, F, 0, 0, 80, 309, 1970, 303, 2273
INVAR-16, Run: 039, F, 0, 0, 80, 24, 308, 18, 326
INVAR-16, Run: 040, F, 0, 0, 80, 22, 528, 16, 544
INVAR-16, Run: 041, F, 0, 0, 80, 7, 128, 1, 129
INVAR-16, Run: 042, F, 0, 0, 80, 75, 1023, 69, 1092
INVAR-16, Run: 043, F, 0, 0, 80, 15, 509, 9, 518
INVAR-16, Run: 044, F, 0, 0, 80, 139, 921, 133, 1054
INVAR-16, Run: 045, F, 0, 0, 80, 23, 283, 17, 300
INVAR-16, Run: 046, F, 0, 0, 80, 18, 355, 12, 367
INVAR-16, Run: 047, F, 0, 0, 80, 271, 1610, 265, 1875
INVAR-16, Run: 048, F, 0, 0, 80, 156, 1167, 150, 1317
INVAR-16, Run: 049, F, 0, 0, 80, 398, 2385, 392, 2777
INVAR-16, Run: 050, F, 0, 0, 80, 8, 194, 2, 196
INVAR-16, Run: 051, F, 0, 0, 80, 16, 261, 10, 271
INVAR-16, Run: 052, F, 0, 0, 80, 651, 1635, 645, 2280
INVAR-16, Run: 053, F, 0, 0, 80, 6, 75, 0, 75
INVAR-16, Run: 054, F, 0, 0, 80, 18, 265, 12, 277
INVAR-16, Run: 055, F, 0, 0, 80, 30, 419, 24, 443
INVAR-16, Run: 056, F, 0, 0, 80, 20, 253, 14, 267
INVAR-16, Run: 057, F, 0, 0, 80, 35, 380, 29, 409
INVAR-16, Run: 058, F, 0, 0, 80, 45, 425, 39, 464
INVAR-16, Run: 059, F, 0, 0, 80, 48, 451, 42, 493
INVAR-16, Run: 060, F, 0, 0, 80, 108, 1167, 102, 1269
INVAR-16, Run: 061, F, 0, 0, 80, 7, 117, 1, 118
INVAR-16, Run: 062, F, 0, 0, 80, 64, 956, 58, 1014
INVAR-16, Run: 063, F, 0, 0, 80, 10, 181, 4, 185
INVAR-16, Run: 064, F, 0, 0, 80, 55, 751, 49, 800
INVAR-16, Run: 065, F, 0, 0, 80, 14, 302, 8, 310
INVAR-16, Run: 066, F, 0, 0, 80, 23, 436, 17, 453
INVAR-16, Run: 067, F, 0, 0, 80, 14, 248, 8, 256
INVAR-16, Run: 068, F, 0, 0, 80, 193, 2308, 187, 2495
INVAR-16, Run: 069, F, 0, 0, 80, 133, 921, 127, 1048
INVAR-16, Run: 070, F, 0, 0, 80, 8, 119, 2, 121
INVAR-16, Run: 071, F, 0, 0, 80, 28, 332, 22, 354
INVAR-16, Run: 072, F, 0, 0, 80, 9, 74, 3, 77
INVAR-16, Run: 073, F, 0, 0, 80, 165, 1063, 159, 1222
INVAR-16, Run: 074, F, 0, 0, 80, 154, 1417, 148, 1565
INVAR-16, Run: 075, F, 0, 0, 80, 28, 668, 22, 690
INVAR-16, Run: 076, F, 0, 0, 80, 23, 246, 17, 263
INVAR-16, Run: 077, F, 0, 0, 80, 946, 2662, 940, 3602
INVAR-16, Run: 078, F, 0, 0, 80, 11, 267, 5, 272
INVAR-16, Run: 079, F, 0, 0, 80, 12, 327, 6, 333
INVAR-16, Run: 080, F, 0, 0, 80, 56, 514, 50, 564
INVAR-16, Run: 081, F, 0, 80, 0, 347, 715, 421, 1136
INVAR-16, Run: 082, F, 0, 0, 80, 22, 284, 16, 300
INVAR-16, Run: 083, F, 0, 0, 80, 41, 513, 35, 548
INVAR-16, Run: 084, F, 0, 0, 80, 49, 590, 43, 633
INVAR-16, Run: 085, F, 0, 0, 80, 37, 631, 31, 662
INVAR-16, Run: 086, F, 0, 0, 80, 83, 765, 77, 842
INVAR-16, Run: 087, F, 0, 0, 80, 1034, 3647, 1028, 4675
INVAR-16, Run: 088, F, 0, 0, 80, 10, 153, 4, 157
INVAR-16, Run: 089, F, 0, 80, 0, 758, 1469, 832, 2301
INVAR-16, Run: 090, F, 0, 0, 80, 7, 131, 1, 132
INVAR-16, Run: 091, F, 0, 0, 80, 16, 239, 10, 249
INVAR-16, Run: 092, F, 0, 0, 80, 7, 127, 1, 128
INVAR-16, Run: 093, F, 0, 0, 80, 18, 493, 12, 505
INVAR-16, Run: 094, F, 0, 0, 80, 2285, 4928, 2279, 7207
INVAR-16, Run: 095, F, 0, 0, 80, 10, 196, 4, 200
INVAR-16, Run: 096, F, 0, 0, 80, 7, 112, 1, 113
INVAR-16, Run: 097, F, 0, 0, 80, 19, 497, 13, 510
INVAR-16, Run: 098, F, 0, 0, 80, 494, 2262, 488, 2750
INVAR-16, Run: 099, F, 0, 0, 80, 46, 777, 40, 817
INVAR-16, Run: 100, F, 0, 0, 80, 49, 387, 43, 430
INVAR-17, Run: 001, F, 0, 0, 21, 31, 132, 28, 160
INVAR-17, Run: 002, F, 0, 0, 21, 25, 87, 22, 109
INVAR-17, Run: 003, F, 0, 0, 21, 41, 97, 38, 135
INVAR-17, Run: 004, F, 0, 0, 21, 4, 6, 1, 7
INVAR-17, Run: 005, F, 0, 0, 21, 4, 16, 1, 17
INVAR-17, Run: 006, F, 0, 0, 21, 4, 9, 1, 10
INVAR-17, Run: 007, F, 0, 0, 21, 18, 61, 15, 76
INVAR-17, Run: 008, F, 0, 0, 21, 3, 26, 0, 26
INVAR-17, Run: 009, F, 0, 0, 21, 26, 105, 23, 128
INVAR-17, Run: 010, F, 0, 0, 21, 3, 7, 0, 7
INVAR-17, Run: 011, F, 0, 0, 21, 26, 45, 23, 68
INVAR-17, Run: 012, F, 0, 0, 21, 3, 22, 0, 22
INVAR-17, Run: 013, F, 0, 0, 21, 20, 88, 17, 105
INVAR-17, Run: 014, F, 0, 0, 21, 5, 23, 2, 25
INVAR-17, Run: 015, F, 0, 0, 21, 8, 29, 5, 34
INVAR-17, Run: 016, F, 0, 0, 21, 4, 15, 1, 16
INVAR-17, Run: 017, F, 0, 0, 21, 3, 9, 0, 9
INVAR-17, Run: 018, F, 0, 0, 21, 3, 8, 0, 8
INVAR-17, Run: 019, F, 0, 0, 21, 6, 42, 3, 45
INVAR-17, Run: 020, F, 0, 0, 21, 3, 15, 0, 15
INVAR-17, Run: 021, F, 0, 0, 21, 32, 122, 29, 151
INVAR-17, Run: 022, F, 0, 0, 21, 9, 33, 6, 39
INVAR-17, Run: 023, F, 0, 0, 21, 3, 10, 0, 10
INVAR-17, Run: 024, F, 0, 21, 0, 50, 53, 68, 121
INVAR-17, Run: 025, F, 0, 21, 0, 50, 36, 68, 104
INVAR-17, Run: 026, F, 0, 0, 21, 3, 18, 0, 18
INVAR-17, Run: 027, F, 0, 0, 21, 4, 37, 1, 38
INVAR-17, Run: 028, F, 0, 21, 0, 19, 17, 37, 54
INVAR-17, Run: 029, F, 0, 21, 0, 28, 42, 46, 88
INVAR-17, Run: 030, F, 0, 0, 21, 3, 19, 0, 19
INVAR-17, Run: 031, F, 0, 0, 21, 7, 46, 4, 50
INVAR-17, Run: 032, F, 0, 0, 21, 5, 34, 2, 36
INVAR-17, Run: 033, F, 0, 0, 21, 3, 21, 0, 21
INVAR-17, Run: 034, F, 0, 0, 21, 10, 65, 7, 72
INVAR-17, Run: 035, F, 0, 0, 21, 6, 47, 3, 50
INVAR-17, Run: 036, F, 0, 0, 21, 5, 43, 2, 45
INVAR-17, Run: 037, F, 0, 0, 21, 6, 29, 3, 32
INVAR-17, Run: 038, F, 0, 0, 21, 11, 53, 8, 61
INVAR-17, Run: 039, F, 0, 0, 21, 6, 16, 3, 19
INVAR-17, Run: 040, F, 0, 21, 0, 9, 19, 27, 46
INVAR-17, Run: 041, F, 0, 0, 21, 51, 153, 48, 201
INVAR-17, Run: 042, F, 0, 0, 21, 169, 353, 166, 519
INVAR-17, Run: 043, F, 0, 0, 21, 3, 12, 0, 12
INVAR-17, Run: 044, F, 0, 0, 21, 35, 179, 32, 211
INVAR-17, Run: 045, F, 0, 0, 21, 4, 20, 1, 21
INVAR-17, Run: 046, F, 0, 0, 21, 6, 61, 3, 64
INVAR-17, Run: 047, F, 0, 0, 21, 47, 271, 44, 315
INVAR-17, Run: 048, F, 0, 0, 21, 4, 17, 1, 18
INVAR-17, Run: 049, F, 0, 0, 21, 3, 11, 0, 11
INVAR-17, Run: 050, F, 0, 0, 21, 24, 74, 21, 95
INVAR-17, Run: 051, F, 0, 0, 21, 3, 31, 0, 31
INVAR-17, Run: 052, F, 0, 21, 0, 19, 22, 37, 59
INVAR-17, Run: 053, F, 0, 0, 21, 7, 14, 4, 18
INVAR-17, Run: 054, F, 0, 0, 21, 3, 16, 0, 16
INVAR-17, Run: 055, F, 0, 0, 21, 5, 19, 2, 21
INVAR-17, Run: 056, F, 0, 0, 21, 22, 93, 19, 112
INVAR-17, Run: 057, F, 0, 0, 21, 6, 62, 3, 65
INVAR-17, Run: 058, F, 0, 0, 21, 3, 13, 0, 13
INVAR-17, Run: 059, F, 0, 0, 21, 8, 26, 5, 31
INVAR-17, Run: 060, F, 0, 0, 21, 9, 37, 6, 43
INVAR-17, Run: 061, F, 0, 21, 0, 57, 182, 75, 257
INVAR-17, Run: 062, F, 0, 21, 0, 188, 172, 206, 378
INVAR-17, Run: 063, F, 0, 0, 21, 6, 12, 3, 15
INVAR-17, Run: 064, F, 0, 0, 21, 11, 28, 8, 36
INVAR-17, Run: 065, F, 0, 21, 0, 56, 58, 74, 132
INVAR-17, Run: 066, F, 0, 0, 21, 48, 114, 45, 159
INVAR-17, Run: 067, F, 0, 0, 21, 4, 31, 1, 32
INVAR-17, Run: 068, F, 0, 0, 21, 4, 45, 1, 46
INVAR-17, Run: 069, F, 0, 0, 21, 23, 85, 20, 105
INVAR-17, Run: 070, F, 0, 0, 21, 5, 39, 2, 41
INVAR-17, Run: 071, F, 0, 0, 21, 5, 13, 2, 15
INVAR-17, Run: 072, F, 0, 0, 21, 3, 41, 0, 41
INVAR-17, Run: 073, F, 0, 0, 21, 6, 25, 3, 28
INVAR-17, Run: 074, F, 0, 0, 21, 98, 132, 95, 227
INVAR-17, Run: 075, F, 0, 0, 21, 8, 118, 5, 123
INVAR-17, Run: 076, F, 0, 0, 21, 12, 86, 9, 95
INVAR-17, Run: 077, F, 0, 21, 0, 40, 74, 58, 132
INVAR-17, Run: 078, F, 0, 0, 21, 5, 72, 2, 74
INVAR-17, Run: 079, F, 0, 0, 21, 15, 127, 12, 139
INVAR-17, Run: 080, F, 0, 0, 21, 21, 107, 18, 125
INVAR-17, Run: 081, F, 0, 0, 21, 8, 26, 5, 31
INVAR-17, Run: 082, F, 0, 21, 0, 31, 59, 49, 108
INVAR-17, Run: 083, F, 0, 0, 21, 7, 30, 4, 34
INVAR-17, Run: 084, F, 0, 0, 21, 92, 212, 89, 301
INVAR-17, Run: 085, F, 0, 21, 0, 13, 34, 31, 65
INVAR-17, Run: 086, F, 0, 0, 21, 6, 53, 3, 56
INVAR-17, Run: 087, F, 0, 0, 21, 40, 128, 37, 165
INVAR-17, Run: 088, F, 0, 21, 0, 35, 28, 53, 81
INVAR-17, Run: 089, F, 0, 0, 21, 19, 107, 16, 123
INVAR-17, Run: 090, F, 0, 0, 21, 18, 44, 15, 59
INVAR-17, Run: 091, F, 0, 21, 0, 41, 105, 59, 164
INVAR-17, Run: 092, F, 0, 0, 21, 11, 87, 8, 95
INVAR-17, Run: 093, F, 0, 0, 21, 3, 41, 0, 41
INVAR-17, Run: 094, F, 0, 0, 21, 82, 150, 79, 229
INVAR-17, Run: 095, F, 0, 0, 21, 34, 157, 31, 188
INVAR-17, Run: 096, F, 0, 0, 21, 4, 20, 1, 21
INVAR-17, Run: 097, F, 0, 0, 21, 46, 150, 43, 193
INVAR-17, Run: 098, F, 0, 0, 21, 8, 91, 5, 96
INVAR-17, Run: 099, F, 0, 0, 21, 6, 53, 3, 56
INVAR-17, Run: 100, F, 0, 0, 21, 3, 10, 0, 10
INVAR-18, Run: 001, F, 0, 0, 59, 180, 1037, 171, 1208
INVAR-18, Run: 002, F, 0, 0, 59, 48, 503, 39, 542
INVAR-18, Run: 003, F, 0, 0, 59, 98, 700, 89, 789
INVAR-18, Run: 004, F, 0, 0, 59, 49, 328, 40, 368
INVAR-18, Run: 005, F, 0, 0, 59, 102, 574, 93, 667
INVAR-18, Run: 006, F, 0, 0, 59, 494, 873, 485, 1358
INVAR-18, Run: 007, F, 0, 0, 59, 38, 410, 29, 439
INVAR-18, Run: 008, F, 0, 0, 59, 786, 953, 777, 1730
INVAR-18, Run: 009, F, 0, 59, 0, 769, 1366, 819, 2185
INVAR-18, Run: 010, F, 0, 59, 0, 1031, 954, 1081, 2035
INVAR-18, Run: 011, F, 0, 0, 59, 78, 585, 69, 654
INVAR-18, Run: 012, F, 0, 0, 59, 110, 486, 101, 587
INVAR-18, Run: 013, F, 0, 0, 59, 17, 273, 8, 281
INVAR-18, Run: 014, F, 0, 0, 59, 27, 139, 18, 157
INVAR-18, Run: 015, F, 0, 59, 0, 291, 1206, 341, 1547
INVAR-18, Run: 016, F, 0, 59, 0, 228, 260, 278, 538
INVAR-18, Run: 017, F, 0, 59, 0, 250, 418, 300, 718
INVAR-18, Run: 018, F, 0, 0, 59, 431, 1488, 422, 1910
INVAR-18, Run: 019, F, 0, 0, 59, 49, 481, 40, 521
INVAR-18, Run: 020, F, 0, 0, 59, 27, 361, 18, 379
INVAR-18, Run: 021, F, 0, 0, 59, 54, 333, 45, 378
INVAR-18, Run: 022, F, 0, 0, 59, 37, 153, 28, 181
INVAR-18, Run: 023, F, 0, 0, 59, 25, 219, 16, 235
INVAR-18, Run: 024, F, 0, 59, 0, 1071, 882, 1121, 2003
INVAR-18, Run: 025, F, 0, 0, 59, 168, 1298, 159, 1457
INVAR-18, Run: 026, F, 0, 0, 59, 23, 260, 14, 274
INVAR-18, Run: 027, F, 0, 0, 59, 400, 535, 391, 926
INVAR-18, Run: 028, F, 0, 0, 59, 77, 354, 68, 422
INVAR-18, Run: 029, F, 0, 0, 59, 63, 489, 54, 543
INVAR-18, Run: 030, F, 0, 0, 59, 89, 367, 80, 447
INVAR-18, Run: 031, F, 0, 0, 59, 91, 598, 82, 680
INVAR-18, Run: 032, F, 0, 59, 0, 905, 478, 955, 1433
INVAR-18, Run: 033, F, 0, 0, 59, 142, 621, 133, 754
INVAR-18, Run: 034, F, 0, 0, 59, 18, 117, 9, 126
INVAR-18, Run: 035, F, 0, 0, 59, 123, 556, 114, 670
INVAR-18, Run: 036, F, 0, 0, 59, 115, 509, 106, 615
INVAR-18, Run: 037, F, 0, 0, 59, 39, 294, 30, 324
INVAR-18, Run: 038, F, 0, 0, 59, 33, 365, 24, 389
INVAR-18, Run: 039, F, 0, 0, 59, 131, 596, 122, 718
INVAR-18, Run: 040, F, 0, 0, 59, 29, 364, 20, 384
INVAR-18, Run: 041, F, 0, 0, 59, 42, 385, 33, 418
INVAR-18, Run: 042, F, 0, 0, 59, 63, 708, 54, 762
INVAR-18, Run: 043, F, 0, 59, 0, 381, 246, 431, 677
INVAR-18, Run: 044, F, 0, 0, 59, 97, 539, 88, 627
INVAR-18, Run: 045, F, 0, 0, 59, 90, 466, 81, 547
INVAR-18, Run: 046, F, 0, 0, 59, 63, 458, 54, 512
INVAR-18, Run: 047, F, 0, 0, 59, 84, 692, 75, 767
INVAR-18, Run: 048, F, 0, 0, 59, 182, 576, 173, 749
INVAR-18, Run: 049, F, 0, 0, 59, 78, 476, 69, 545
INVAR-18, Run: 050, F, 0, 59, 0, 1059, 1737, 1109, 2846
INVAR-18, Run: 051, F, 0, 0, 59, 291, 1042, 282, 1324
INVAR-18, Run: 052, F, 0, 0, 59, 143, 614, 134, 748
INVAR-18, Run: 053, F, 0, 0, 59, 322, 719, 313, 1032
INVAR-18, Run: 054, F, 0, 0, 59, 51, 429, 42, 471
INVAR-18, Run: 055, F, 0, 0, 59, 44, 526, 35, 561
INVAR-18, Run: 056, F, 0, 0, 59, 101, 630, 92, 722
INVAR-18, Run: 057, F, 0, 0, 59, 350, 763, 341, 1104
INVAR-18, Run: 058, F, 0, 0, 59, 31, 235, 22, 257
INVAR-18, Run: 059, F, 0, 0, 59, 37, 316, 28, 344
INVAR-18, Run: 060, F, 0, 0, 59, 67, 266, 58, 324
INVAR-18, Run: 061, F, 0, 0, 59, 278, 987, 269, 1256
INVAR-18, Run: 062, F, 0, 0, 59, 42, 332, 33, 365
INVAR-18, Run: 063, F, 0, 0, 59, 51, 396, 42, 438
INVAR-18, Run: 064, F, 0, 0, 59, 1289, 1371, 1280, 2651
INVAR-18, Run: 065, F, 0, 59, 0, 627, 819, 677, 1496
INVAR-18, Run: 066, F, 0, 0, 59, 13, 110, 4, 114
INVAR-18, Run: 067, F, 0, 0, 59, 39, 471, 30, 501
INVAR-18, Run: 068, F, 0, 0, 59, 58, 292, 49, 341
INVAR-18, Run: 069, F, 0, 0, 59, 38, 323, 29, 352
INVAR-18, Run: 070, F, 0, 0, 59, 275, 1144, 266, 1410
INVAR-18, Run: 071, F, 0, 0, 59, 42, 369, 33, 402
INVAR-18, Run: 072, F, 0, 0, 59, 142, 362, 133, 495
INVAR-18, Run: 073, F, 0, 0, 59, 61, 529, 52, 581
INVAR-18, Run: 074, F, 0, 0, 59, 16, 136, 7, 143
INVAR-18, Run: 075, F, 0, 0, 59, 76, 413, 67, 480
INVAR-18, Run: 076, F, 0, 0, 59, 762, 1124, 753, 1877
INVAR-18, Run: 077, F, 0, 0, 59, 15, 116, 6, 122
INVAR-18, Run: 078, F, 0, 0, 59, 12, 325, 3, 328
INVAR-18, Run: 079, F, 0, 0, 59, 97, 429, 88, 517
INVAR-18, Run: 080, F, 0, 0, 59, 20, 357, 11, 368
INVAR-18, Run: 081, F, 0, 0, 59, 9, 25, 0, 25
INVAR-18, Run: 082, F, 0, 59, 0, 765, 611, 815, 1426
INVAR-18, Run: 083, F, 0, 0, 59, 34, 190, 25, 215
INVAR-18, Run: 084, F, 0, 0, 59, 116, 846, 107, 953
INVAR-18, Run: 085, F, 0, 0, 59, 51, 299, 42, 341
INVAR-18, Run: 086, F, 0, 0, 59, 542, 676, 533, 1209
INVAR-18, Run: 087, F, 0, 0, 59, 70, 327, 61, 388
INVAR-18, Run: 088, F, 0, 0, 59, 21, 218, 12, 230
INVAR-18, Run: 089, F, 0, 0, 59, 476, 1708, 467, 2175
INVAR-18, Run: 090, F, 0, 0, 59, 154, 987, 145, 1132
INVAR-18, Run: 091, F, 0, 0, 59, 87, 674, 78, 752
INVAR-18, Run: 092, F, 0, 59, 0, 329, 232, 379, 611
INVAR-18, Run: 093, F, 0, 0, 59, 109, 404, 100, 504
INVAR-18, Run: 094, F, 0, 0, 59, 461, 1368, 452, 1820
INVAR-18, Run: 095, F, 0, 0, 59, 124, 709, 115, 824
INVAR-18, Run: 096, F, 0, 59, 0, 492, 402, 542, 944
INVAR-18, Run: 097, F, 0, 0, 59, 53, 541, 44, 585
INVAR-18, Run: 098, F, 0, 0, 59, 104, 507, 95, 602
INVAR-18, Run: 099, F, 0, 0, 59, 146, 631, 137, 768
INVAR-18, Run: 100, F, 0, 0, 59, 529, 832, 520, 1352
INVAR-19, Run: 001, F, 0, 0, 181, 14308, 14079, 14253, 28332
INVAR-19, Run: 002, F, 0, 181, 0, 14818, 20024, 14944, 34968
INVAR-19, Run: 003, F, 0, 0, 181, 2413, 5542, 2358, 7900
INVAR-19, Run: 004, F, 0, 0, 181, 181, 1129, 126, 1255
INVAR-19, Run: 005, F, 0, 181, 0, 16648, 18993, 16774, 35767
INVAR-19, Run: 006, F, 0, 0, 181, 2443, 6868, 2388, 9256
INVAR-19, Run: 007, F, 0, 181, 0, 3692, 8184, 3818, 12002
INVAR-19, Run: 008, F, 0, 181, 0, 2388, 1482, 2514, 3996
INVAR-19, Run: 009, F, 0, 0, 181, 795, 7195, 740, 7935
INVAR-19, Run: 010, F, 0, 181, 0, 4739, 2281, 4865, 7146
INVAR-19, Run: 011, F, 0, 0, 181, 5583, 9322, 5528, 14850
INVAR-19, Run: 012, F, 0, 0, 181, 751, 3888, 696, 4584
INVAR-19, Run: 013, F, 0, 0, 181, 6184, 32522, 6129, 38651
INVAR-19, Run: 014, F, 0, 0, 181, 2278, 9755, 2223, 11978
INVAR-19, Run: 015, F, 0, 181, 0, 3521, 1272, 3647, 4919
INVAR-19, Run: 016, F, 0, 0, 181, 7605, 19670, 7550, 27220
INVAR-19, Run: 017, F, 0, 0, 181, 297, 1821, 242, 2063
INVAR-19, Run: 018, F, 0, 0, 181, 5605, 10411, 5550, 15961
INVAR-19, Run: 019, F, 0, 0, 181, 12452, 17960, 12397, 30357
INVAR-19, Run: 020, F, 0, 0, 181, 1407, 12034, 1352, 13386
INVAR-19, Run: 021, F, 0, 0, 181, 5978, 7216, 5923, 13139
INVAR-19, Run: 022, F, 0, 0, 181, 4336, 4579, 4281, 8860
INVAR-19, Run: 023, F, 0, 0, 181, 2255, 8348, 2200, 10548
INVAR-19, Run: 024, F, 0, 181, 0, 4978, 3981, 5104, 9085
INVAR-19, Run: 025, F, 0, 0, 181, 5498, 14937, 5443, 20380
INVAR-19, Run: 026, F, 0, 181, 0, 4607, 3819, 4733, 8552
INVAR-19, Run: 027, F, 0, 0, 181, 1512, 5892, 1457, 7349
INVAR-19, Run: 028, F, 0, 0, 181, 2884, 13853, 2829, 16682
INVAR-19, Run: 029, F, 0, 0, 181, 2312, 12063, 2257, 14320
INVAR-19, Run: 030, F, 0, 181, 0, 9188, 9260, 9314, 18574
INVAR-19, Run: 031, F, 0, 0, 181, 1777, 6784, 1722, 8506
INVAR-19, Run: 032, F, 0, 181, 0, 2657, 1910, 2783, 4693
INVAR-19, Run: 033, F, 0, 0, 181, 2095, 4985, 2040, 7025
INVAR-19, Run: 034, F, 0, 181, 0, 3333, 2947, 3459, 6406
INVAR-19, Run: 035, F, 0, 0, 181, 4119, 7579, 4064, 11643
INVAR-19, Run: 036, F, 0, 0, 181, 2374, 7343, 2319, 9662
INVAR-19, Run: 037, F, 0, 0, 181, 19237, 24390, 19182, 43572
INVAR-19, Run: 038, F, 0, 181, 0, 1845, 2168, 1971, 4139
INVAR-19, Run: 039, F, 0, 0, 181, 4300, 9843, 4245, 14088
INVAR-19, Run: 040, F, 0, 0, 181, 2805, 6013, 2750, 8763
INVAR-19, Run: 041, F, 0, 0, 181, 3341, 6768, 3286, 10054
INVAR-19, Run: 042, F, 0, 0, 181, 1396, 4464, 1341, 5805
INVAR-19, Run: 043, F, 0, 181, 0, 5806, 9177, 5932, 15109
INVAR-19, Run: 044, F, 0, 181, 0, 7107, 2740, 7233, 9973
INVAR-19, Run: 045, F, 0, 0, 181, 926, 2324, 871, 3195
INVAR-19, Run: 046, F, 0, 181, 0, 4955, 3061, 5081, 8142
INVAR-19, Run: 047, F, 0, 181, 0, 7494, 1893, 7620, 9513
INVAR-19, Run: 048, F, 0, 0, 181, 389, 1817, 334, 2151
INVAR-19, Run: 049, F, 0, 0, 181, 10113, 19570, 10058, 29628
INVAR-19, Run: 050, F, 0, 181, 0, 2417, 1637, 2543, 4180
INVAR-19, Run: 051, F, 0, 181, 0, 5418, 4553, 5544, 10097
INVAR-19, Run: 052, F, 0, 0, 181, 3292, 6751, 3237, 9988
INVAR-19, Run: 053, F, 0, 0, 181, 997, 2136, 942, 3078
INVAR-19, Run: 054, F, 0, 0, 181, 6365, 20361, 6310, 26671
INVAR-19, Run: 055, F, 0, 0, 181, 553, 2490, 498, 2988
INVAR-19, Run: 056, F, 0, 0, 181, 2796, 7938, 2741, 10679
INVAR-19, Run: 057, F, 0, 181, 0, 5197, 1404, 5323, 6727
INVAR-19, Run: 058, F, 0, 0, 181, 5027, 9262, 4972, 14234
INVAR-19, Run: 059, F, 0, 0, 181, 2607, 7570, 2552, 10122
INVAR-19, Run: 060, F, 0, 0, 181, 2915, 6051, 2860, 8911
INVAR-19, Run: 061, F, 0, 0, 181, 1607, 5029, 1552, 6581
INVAR-19, Run: 062, F, 0, 181, 0, 4891, 3254, 5017, 8271
INVAR-19, Run: 063, F, 0, 181, 0, 6648, 3792, 6774, 10566
INVAR-19, Run: 064, F, 0, 0, 181, 4980, 12113, 4925, 17038
INVAR-19, Run: 065, F, 0, 0, 181, 9097, 17980, 9042, 27022
INVAR-19, Run: 066, F, 0, 181, 0, 2642, 2396, 2768, 5164
INVAR-19, Run: 067, F, 0, 0, 181, 9490, 10230, 9435, 19665
INVAR-19, Run: 068, F, 0, 0, 181, 4460, 7611, 4405, 12016
INVAR-19, Run: 069, F, 0, 0, 181, 4199, 15636, 4144, 19780
INVAR-19, Run: 070, F, 0, 181, 0, 2402, 2323, 2528, 4851
INVAR-19, Run: 071, F, 0, 181, 0, 7723, 5931, 7849, 13780
INVAR-19, Run: 072, F, 0, 0, 181, 536, 2891, 481, 3372
INVAR-19, Run: 073, F, 0, 0, 181, 1299, 4418, 1244, 5662
INVAR-19, Run: 074, F, 0, 0, 181, 429, 3134, 374, 3508
INVAR-19, Run: 075, F, 0, 0, 181, 679, 5255, 624, 5879
INVAR-19, Run: 076, F, 0, 181, 0, 5217, 4924, 5343, 10267
INVAR-19, Run: 077, F, 0, 0, 181, 740, 4847, 685, 5532
INVAR-19, Run: 078, F, 0, 0, 181, 3000, 7112, 2945, 10057
INVAR-19, Run: 079, F, 0, 0, 181, 814, 4220, 759, 4979
INVAR-19, Run: 080, F, 0, 181, 0, 2518, 1604, 2644, 4248
INVAR-19, Run: 081, F, 0, 0, 181, 7492, 6645, 7437, 14082
INVAR-19, Run: 082, F, 0, 181, 0, 6803, 18550, 6929, 25479
INVAR-19, Run: 083, F, 0, 0, 181, 3306, 13520, 3251, 16771
INVAR-19, Run: 084, F, 0, 0, 181, 3504, 13747, 3449, 17196
INVAR-19, Run: 085, F, 0, 0, 181, 4377, 15496, 4322, 19818
INVAR-19, Run: 086, F, 0, 181, 0, 5944, 2382, 6070, 8452
INVAR-19, Run: 087, F, 0, 181, 0, 9218, 17133, 9344, 26477
INVAR-19, Run: 088, F, 0, 0, 181, 1598, 5385, 1543, 6928
INVAR-19, Run: 089, F, 0, 0, 181, 2619, 5717, 2564, 8281
INVAR-19, Run: 090, F, 0, 0, 181, 621, 4291, 566, 4857
INVAR-19, Run: 091, F, 0, 0, 181, 1689, 7029, 1634, 8663
INVAR-19, Run: 092, F, 0, 0, 181, 2217, 5701, 2162, 7863
INVAR-19, Run: 093, F, 0, 181, 0, 15135, 13596, 15261, 28857
INVAR-19, Run: 094, F, 0, 0, 181, 2030, 7305, 1975, 9280
INVAR-19, Run: 095, F, 0, 0, 181, 1153, 7275, 1098, 8373
INVAR-19, Run: 096, F, 0, 181, 0, 5245, 2672, 5371, 8043
INVAR-19, Run: 097, F, 0, 0, 181, 14007, 33680, 13952, 47632
INVAR-19, Run: 098, F, 0, 0, 181, 568, 3716, 513, 4229
INVAR-19, Run: 099, F, 0, 0, 181, 6404, 11682, 6349, 18031
INVAR-19, Run: 100, F, 0, 0, 181, 577, 3758, 522, 4280
INVAR-2, Run: 001, F, 0, 108, 0, 1063, 690, 1109, 1799
INVAR-2, Run: 002, F, 0, 0, 108, 3023, 3964, 2961, 6925
INVAR-2, Run: 003, F, 0, 108, 0, 566, 196, 612, 808
INVAR-2, Run: 004, F, 0, 108, 0, 494, 107, 540, 647
INVAR-2, Run: 005, F, 0, 0, 108, 3530, 5884, 3468, 9352
INVAR-2, Run: 006, F, 0, 108, 0, 1110, 489, 1156, 1645
INVAR-2, Run: 007, F, 0, 0, 108, 1989, 3059, 1927, 4986
INVAR-2, Run: 008, F, 0, 0, 108, 2721, 4076, 2659, 6735
INVAR-2, Run: 009, F, 0, 108, 0, 2528, 856, 2574, 3430
INVAR-2, Run: 010, F, 0, 108, 0, 108, 23, 154, 177
INVAR-2, Run: 011, F, 0, 108, 0, 3836, 2311, 3882, 6193
INVAR-2, Run: 012, F, 0, 0, 108, 2795, 2517, 2733, 5250
INVAR-2, Run: 013, F, 0, 108, 0, 916, 490, 962, 1452
INVAR-2, Run: 014, F, 0, 108, 0, 483, 158, 529, 687
INVAR-2, Run: 015, F, 0, 108, 0, 279, 38, 325, 363
INVAR-2, Run: 016, F, 0, 0, 108, 961, 2350, 899, 3249
INVAR-2, Run: 017, F, 0, 0, 108, 2890, 7175, 2828, 10003
INVAR-2, Run: 018, F, 0, 108, 0, 1556, 1807, 1602, 3409
INVAR-2, Run: 019, F, 0, 108, 0, 1767, 4060, 1813, 5873
INVAR-2, Run: 020, F, 0, 108, 0, 1291, 564, 1337, 1901
INVAR-2, Run: 021, F, 0, 108, 0, 537, 164, 583, 747
INVAR-2, Run: 022, F, 0, 108, 0, 475, 112, 521, 633
INVAR-2, Run: 023, F, 0, 108, 0, 138, 50, 184, 234
INVAR-2, Run: 024, F, 0, 108, 0, 907, 1429, 953, 2382
INVAR-2, Run: 025, F, 0, 108, 0, 1679, 1039, 1725, 2764
INVAR-2, Run: 026, F, 0, 108, 0, 746, 231, 792, 1023
INVAR-2, Run: 027, F, 0, 108, 0, 3173, 4265, 3219, 7484
INVAR-2, Run: 028, F, 0, 108, 0, 338, 87, 384, 471
INVAR-2, Run: 029, F, 0, 0, 108, 647, 1105, 585, 1690
INVAR-2, Run: 030, F, 0, 0, 108, 5375, 7710, 5313, 13023
INVAR-2, Run: 031, F, 0, 108, 0, 2173, 3737, 2219, 5956
INVAR-2, Run: 032, F, 0, 108, 0, 337, 120, 383, 503
INVAR-2, Run: 033, F, 0, 108, 0, 1296, 658, 1342, 2000
INVAR-2, Run: 034, F, 0, 108, 0, 484, 74, 530, 604
INVAR-2, Run: 035, F, 0, 108, 0, 1679, 555, 1725, 2280
INVAR-2, Run: 036, F, 0, 0, 108, 1357, 3848, 1295, 5143
INVAR-2, Run: 037, F, 0, 108, 0, 852, 256, 898, 1154
INVAR-2, Run: 038, F, 0, 108, 0, 819, 268, 865, 1133
INVAR-2, Run: 039, F, 0, 108, 0, 162, 28, 208, 236
INVAR-2, Run: 040, F, 0, 108, 0, 1218, 345, 1264, 1609
INVAR-2, Run: 041, F, 0, 108, 0, 306, 61, 352, 413
INVAR-2, Run: 042, F, 0, 0, 108, 285, 956, 223, 1179
INVAR-2, Run: 043, F, 0, 108, 0, 1035, 278, 1081, 1359
INVAR-2, Run: 044, F, 0, 0, 108, 704, 2114, 642, 2756
INVAR-2, Run: 045, F, 0, 108, 0, 1022, 677, 1068, 1745
INVAR-2, Run: 046, F, 0, 0, 108, 810, 1813, 748, 2561
INVAR-2, Run: 047, F, 0, 108, 0, 513, 277, 559, 836
INVAR-2, Run: 048, F, 0, 0, 108, 1091, 1233, 1029, 2262
INVAR-2, Run: 049, F, 0, 0, 108, 995, 2691, 933, 3624
INVAR-2, Run: 050, F, 0, 108, 0, 1612, 1140, 1658, 2798
INVAR-2, Run: 051, F, 0, 108, 0, 634, 140, 680, 820
INVAR-2, Run: 052, F, 0, 0, 108, 1602, 2043, 1540, 3583
INVAR-2, Run: 053, F, 0, 108, 0, 774, 97, 820, 917
INVAR-2, Run: 054, F, 0, 108, 0, 291, 53, 337, 390
INVAR-2, Run: 055, F, 0, 0, 108, 1498, 2412, 1436, 3848
INVAR-2, Run: 056, F, 0, 0, 108, 473, 1570, 411, 1981
INVAR-2, Run: 057, F, 0, 108, 0, 959, 387, 1005, 1392
INVAR-2, Run: 058, F, 0, 108, 0, 240, 75, 286, 361
INVAR-2, Run: 059, F, 0, 0, 108, 1059, 2274, 997, 3271
INVAR-2, Run: 060, F, 0, 0, 108, 2617, 2395, 2555, 4950
INVAR-2, Run: 061, F, 0, 108, 0, 1906, 1354, 1952, 3306
INVAR-2, Run: 062, F, 0, 108, 0, 1422, 704, 1468, 2172
INVAR-2, Run: 063, F, 0, 0, 108, 835, 2237, 773, 3010
INVAR-2, Run: 064, F, 0, 0, 108, 1153, 1892, 1091, 2983
INVAR-2, Run: 065, F, 0, 108, 0, 1381, 2089, 1427, 3516
INVAR-2, Run: 066, F, 0, 108, 0, 2058, 1311, 2104, 3415
INVAR-2, Run: 067, F, 0, 0, 108, 912, 2702, 850, 3552
INVAR-2, Run: 068, F, 0, 0, 108, 2400, 3042, 2338, 5380
INVAR-2, Run: 069, F, 0, 0, 108, 739, 1359, 677, 2036
INVAR-2, Run: 070, F, 0, 108, 0, 848, 161, 894, 1055
INVAR-2, Run: 071, F, 0, 0, 108, 883, 1111, 821, 1932
INVAR-2, Run: 072, F, 0, 0, 108, 1740, 3461, 1678, 5139
INVAR-2, Run: 073, F, 0, 108, 0, 600, 233, 646, 879
INVAR-2, Run: 074, F, 0, 108, 0, 1664, 663, 1710, 2373
INVAR-2, Run: 075, F, 0, 108, 0, 1012, 691, 1058, 1749
INVAR-2, Run: 076, F, 0, 108, 0, 868, 290, 914, 1204
INVAR-2, Run: 077, F, 0, 108, 0, 867, 184, 913, 1097
INVAR-2, Run: 078, F, 0, 108, 0, 1063, 423, 1109, 1532
INVAR-2, Run: 079, F, 0, 108, 0, 677, 184, 723, 907
INVAR-2, Run: 080, F, 0, 0, 108, 262, 1036, 200, 1236
INVAR-2, Run: 081, F, 0, 108, 0, 544, 198, 590, 788
INVAR-2, Run: 082, F, 0, 108, 0, 1822, 1202, 1868, 3070
INVAR-2, Run: 083, F, 0, 108, 0, 1448, 597, 1494, 2091
INVAR-2, Run: 084, F, 0, 108, 0, 1237, 775, 1283, 2058
INVAR-2, Run: 085, F, 0, 108, 0, 402, 73, 448, 521
INVAR-2, Run: 086, F, 0, 0, 108, 6218, 7026, 6156, 13182
INVAR-2, Run: 087, F, 0, 108, 0, 1374, 391, 1420, 1811
INVAR-2, Run: 088, F, 0, 0, 108, 759, 1628, 697, 2325
INVAR-2, Run: 089, F, 0, 108, 0, 1335, 990, 1381, 2371
INVAR-2, Run: 090, F, 0, 108, 0, 208, 66, 254, 320
INVAR-2, Run: 091, F, 0, 108, 0, 891, 257, 937, 1194
INVAR-2, Run: 092, F, 0, 0, 108, 419, 1394, 357, 1751
INVAR-2, Run: 093, F, 0, 0, 108, 448, 2122, 386, 2508
INVAR-2, Run: 094, F, 0, 0, 108, 530, 1313, 468, 1781
INVAR-2, Run: 095, F, 0, 108, 0, 637, 532, 683, 1215
INVAR-2, Run: 096, F, 0, 0, 108, 1341, 4082, 1279, 5361
INVAR-2, Run: 097, F, 0, 0, 108, 2144, 1433, 2082, 3515
INVAR-2, Run: 098, F, 0, 0, 108, 967, 2140, 905, 3045
INVAR-2, Run: 099, F, 0, 108, 0, 1168, 375, 1214, 1589
INVAR-2, Run: 100, F, 0, 108, 0, 1476, 1424, 1522, 2946
INVAR-20, Run: 001, F, 0, 0, 48, 669, 552, 653, 1205
INVAR-20, Run: 002, F, 0, 0, 48, 218, 426, 202, 628
INVAR-20, Run: 003, F, 0, 0, 48, 261, 628, 245, 873
INVAR-20, Run: 004, F, 0, 0, 48, 38, 177, 22, 199
INVAR-20, Run: 005, F, 0, 0, 48, 104, 374, 88, 462
INVAR-20, Run: 006, F, 0, 0, 48, 60, 275, 44, 319
INVAR-20, Run: 007, F, 0, 0, 48, 130, 372, 114, 486
INVAR-20, Run: 008, F, 0, 48, 0, 249, 247, 281, 528
INVAR-20, Run: 009, F, 0, 0, 48, 176, 468, 160, 628
INVAR-20, Run: 010, F, 0, 0, 48, 265, 267, 249, 516
INVAR-20, Run: 011, F, 0, 48, 0, 676, 587, 708, 1295
INVAR-20, Run: 012, F, 0, 0, 48, 63, 395, 47, 442
INVAR-20, Run: 013, F, 0, 0, 48, 734, 907, 718, 1625
INVAR-20, Run: 014, F, 0, 0, 48, 61, 230, 45, 275
INVAR-20, Run: 015, F, 0, 0, 48, 83, 448, 67, 515
INVAR-20, Run: 016, F, 0, 0, 48, 416, 425, 400, 825
INVAR-20, Run: 017, F, 0, 0, 48, 43, 157, 27, 184
INVAR-20, Run: 018, F, 0, 0, 48, 388, 368, 372, 740
INVAR-20, Run: 019, F, 0, 48, 0, 504, 677, 536, 1213
INVAR-20, Run: 020, F, 0, 0, 48, 66, 232, 50, 282
INVAR-20, Run: 021, F, 0, 48, 0, 543, 610, 575, 1185
INVAR-20, Run: 022, F, 0, 48, 0, 431, 297, 463, 760
INVAR-20, Run: 023, F, 0, 0, 48, 48, 208, 32, 240
INVAR-20, Run: 024, F, 0, 0, 48, 143, 431, 127, 558
INVAR-20, Run: 025, F, 0, 48, 0, 272, 250, 304, 554
INVAR-20, Run: 026, F, 0, 0, 48, 63, 120, 47, 167
INVAR-20, Run: 027, F, 0, 0, 48, 167, 265, 151, 416
INVAR-20, Run: 028, F, 0, 48, 0, 142, 72, 174, 246
INVAR-20, Run: 029, F, 0, 0, 48, 109, 258, 93, 351
INVAR-20, Run: 030, F, 0, 48, 0, 209, 200, 241, 441
INVAR-20, Run: 031, F, 0, 0, 48, 162, 265, 146, 411
INVAR-20, Run: 032, F, 0, 48, 0, 194, 268, 226, 494
INVAR-20, Run: 033, F, 0, 48, 0, 166, 166, 198, 364
INVAR-20, Run: 034, F, 0, 48, 0, 352, 265, 384, 649
INVAR-20, Run: 035, F, 0, 0, 48, 1223, 1747, 1207, 2954
INVAR-20, Run: 036, F, 0, 0, 48, 116, 266, 100, 366
INVAR-20, Run: 037, F, 0, 48, 0, 165, 199, 197, 396
INVAR-20, Run: 038, F, 0, 0, 48, 127, 964, 111, 1075
INVAR-20, Run: 039, F, 0, 0, 48, 112, 435, 96, 531
INVAR-20, Run: 040, F, 0, 48, 0, 170, 57, 202, 259
INVAR-20, Run: 041, F, 0, 0, 48, 143, 708, 127, 835
INVAR-20, Run: 042, F, 0, 0, 48, 60, 333, 44, 377
INVAR-20, Run: 043, F, 0, 48, 0, 375, 224, 407, 631
INVAR-20, Run: 044, F, 0, 0, 48, 298, 1102, 282, 1384
INVAR-20, Run: 045, F, 0, 0, 48, 76, 339, 60, 399
INVAR-20, Run: 046, F, 0, 0, 48, 501, 1059, 485, 1544
INVAR-20, Run: 047, F, 0, 0, 48, 623, 1033, 607, 1640
INVAR-20, Run: 048, F, 0, 0, 48, 493, 909, 477, 1386
INVAR-20, Run: 049, F, 0, 48, 0, 285, 167, 317, 484
INVAR-20, Run: 050, F, 0, 0, 48, 344, 357, 328, 685
INVAR-20, Run: 051, F, 0, 0, 48, 251, 362, 235, 597
INVAR-20, Run: 052, F, 0, 0, 48, 56, 225, 40, 265
INVAR-20, Run: 053, F, 0, 48, 0, 241, 135, 273, 408
INVAR-20, Run: 054, F, 0, 0, 48, 396, 831, 380, 1211
INVAR-20, Run: 055, F, 0, 0, 48, 46, 204, 30, 234
INVAR-20, Run: 056, F, 0, 0, 48, 230, 688, 214, 902
INVAR-20, Run: 057, F, 0, 0, 48, 263, 908, 247, 1155
INVAR-20, Run: 058, F, 0, 0, 48, 36, 178, 20, 198
INVAR-20, Run: 059, F, 0, 0, 48, 31, 226, 15, 241
INVAR-20, Run: 060, F, 0, 0, 48, 44, 247, 28, 275
INVAR-20, Run: 061, F, 0, 0, 48, 343, 1000, 327, 1327
INVAR-20, Run: 062, F, 0, 0, 48, 37, 249, 21, 270
INVAR-20, Run: 063, F, 0, 0, 48, 130, 293, 114, 407
INVAR-20, Run: 064, F, 0, 0, 48, 393, 796, 377, 1173
INVAR-20, Run: 065, F, 0, 0, 48, 29, 144, 13, 157
INVAR-20, Run: 066, F, 0, 0, 48, 120, 255, 104, 359
INVAR-20, Run: 067, F, 0, 48, 0, 252, 219, 284, 503
INVAR-20, Run: 068, F, 0, 0, 48, 206, 548, 190, 738
INVAR-20, Run: 069, F, 0, 0, 48, 66, 386, 50, 436
INVAR-20, Run: 070, F, 0, 0, 48, 228, 327, 212, 539
INVAR-20, Run: 071, F, 0, 48, 0, 116, 301, 148, 449
INVAR-20, Run: 072, F, 0, 0, 48, 218, 708, 202, 910
INVAR-20, Run: 073, F, 0, 0, 48, 41, 276, 25, 301
INVAR-20, Run: 074, F, 0, 0, 48, 79, 151, 63, 214
INVAR-20, Run: 075, F, 0, 0, 48, 73, 335, 57, 392
INVAR-20, Run: 076, F, 0, 0, 48, 1079, 1710, 1063, 2773
INVAR-20, Run: 077, F, 0, 48, 0, 218, 213, 250, 463
INVAR-20, Run: 078, F, 0, 0, 48, 52, 219, 36, 255
INVAR-20, Run: 079, F, 0, 0, 48, 128, 357, 112, 469
INVAR-20, Run: 080, F, 0, 48, 0, 304, 138, 336, 474
INVAR-20, Run: 081, F, 0, 0, 48, 481, 812, 465, 1277
INVAR-20, Run: 082, F, 0, 0, 48, 63, 210, 47, 257
INVAR-20, Run: 083, F, 0, 48, 0, 38, 24, 70, 94
INVAR-20, Run: 084, F, 0, 48, 0, 200, 141, 232, 373
INVAR-20, Run: 085, F, 0, 48, 0, 397, 309, 429, 738
INVAR-20, Run: 086, F, 0, 0, 48, 30, 162, 14, 176
INVAR-20, Run: 087, F, 0, 0, 48, 319, 805, 303, 1108
INVAR-20, Run: 088, F, 0, 0, 48, 41, 99, 25, 124
INVAR-20, Run: 089, F, 0, 0, 48, 25, 108, 9, 117
INVAR-20, Run: 090, F, 0, 48, 0, 581, 795, 613, 1408
INVAR-20, Run: 091, F, 0, 0, 48, 581, 1112, 565, 1677
INVAR-20, Run: 092, F, 0, 0, 48, 320, 941, 304, 1245
INVAR-20, Run: 093, F, 0, 48, 0, 215, 161, 247, 408
INVAR-20, Run: 094, F, 0, 0, 48, 224, 489, 208, 697
INVAR-20, Run: 095, F, 0, 0, 48, 55, 137, 39, 176
INVAR-20, Run: 096, F, 0, 0, 48, 60, 164, 44, 208
INVAR-20, Run: 097, F, 0, 48, 0, 495, 476, 527, 1003
INVAR-20, Run: 098, F, 0, 48, 0, 161, 119, 193, 312
INVAR-20, Run: 099, F, 0, 0, 48, 94, 212, 78, 290
INVAR-20, Run: 100, F, 0, 0, 48, 640, 983, 624, 1607
INVAR-21, Run: 001, F, 0, 218, 0, 2305, 1640, 2419, 4059
INVAR-21, Run: 002, F, 0, 218, 0, 582, 203, 696, 899
INVAR-21, Run: 003, F, 0, 0, 218, 14258, 15504, 14154, 29658
INVAR-21, Run: 004, F, 0, 218, 0, 15175, 14085, 15289, 29374
INVAR-21, Run: 005, F, 0, 218, 0, 557, 217, 671, 888
INVAR-21, Run: 006, F, 0, 218, 0, 5315, 3264, 5429, 8693
INVAR-21, Run: 007, F, 0, 0, 218, 21530, 46045, 21426, 67471
INVAR-21, Run: 008, F, 0, 0, 218, 7033, 13861, 6929, 20790
INVAR-21, Run: 009, F, 0, 0, 218, 3082, 7811, 2978, 10789
INVAR-21, Run: 010, F, 0, 0, 218, 16052, 28082, 15948, 44030
INVAR-21, Run: 011, F, 0, 218, 0, 1177, 436, 1291, 1727
INVAR-21, Run: 012, F, 0, 218, 0, 6641, 6420, 6755, 13175
INVAR-21, Run: 013, F, 0, 218, 0, 1499, 657, 1613, 2270
INVAR-21, Run: 014, F, 0, 218, 0, 1690, 374, 1804, 2178
INVAR-21, Run: 015, F, 0, 0, 218, 2383, 4763, 2279, 7042
INVAR-21, Run: 016, F, 0, 0, 218, 7470, 9393, 7366, 16759
INVAR-21, Run: 017, F, 0, 218, 0, 21774, 12497, 21888, 34385
INVAR-21, Run: 018, F, 0, 0, 218, 14293, 33817, 14189, 48006
INVAR-21, Run: 019, F, 0, 218, 0, 6631, 5422, 6745, 12167
INVAR-21, Run: 020, F, 0, 218, 0, 5494, 2343, 5608, 7951
INVAR-21, Run: 021, F, 0, 218, 0, 3672, 1109, 3786, 4895
INVAR-21, Run: 022, F, 0, 0, 218, 4187, 8393, 4083, 12476
INVAR-21, Run: 023, F, 0, 0, 218, 5655, 8127, 5551, 13678
INVAR-21, Run: 024, F, 0, 0, 218, 3134, 6541, 3030, 9571
INVAR-21, Run: 025, F, 0, 0, 218, 3814, 9459, 3710, 13169
INVAR-21, Run: 026, F, 0, 0, 218, 10449, 16656, 10345, 27001
INVAR-21, Run: 027, F, 0, 0, 218, 8007, 13767, 7903, 21670
INVAR-21, Run: 028, F, 0, 0, 218, 2442, 9510, 2338, 11848
INVAR-21, Run: 029, F, 0, 0, 218, 2720, 7625, 2616, 10241
INVAR-21, Run: 030, F, 0, 0, 218, 4112, 26744, 4008, 30752
INVAR-21, Run: 031, F, 0, 0, 218, 5510, 5347, 5406, 10753
INVAR-21, Run: 032, F, 0, 0, 218, 1689, 4500, 1585, 6085
INVAR-21, Run: 033, F, 0, 0, 218, 24927, 28889, 24823, 53712
INVAR-21, Run: 034, F, 0, 218, 0, 4400, 4432, 4514, 8946
INVAR-21, Run: 035, F, 0, 218, 0, 9799, 4369, 9913, 14282
INVAR-21, Run: 036, F, 0, 218, 0, 3946, 2525, 4060, 6585
INVAR-21, Run: 037, F, 0, 218, 0, 3826, 4643, 3940, 8583
INVAR-21, Run: 038, F, 0, 0, 218, 10765, 17248, 10661, 27909
INVAR-21, Run: 039, F, 0, 0, 218, 1210, 4356, 1106, 5462
INVAR-21, Run: 040, F, 0, 0, 218, 3965, 22348, 3861, 26209
INVAR-21, Run: 041, F, 0, 218, 0, 6984, 5316, 7098, 12414
INVAR-21, Run: 042, F, 0, 0, 218, 10618, 11371, 10514, 21885
INVAR-21, Run: 043, F, 0, 218, 0, 3935, 945, 4049, 4994
INVAR-21, Run: 044, F, 0, 0, 218, 6384, 15098, 6280, 21378
INVAR-21, Run: 045, F, 0, 0, 218, 13360, 23703, 13256, 36959
INVAR-21, Run: 046, F, 0, 218, 0, 10913, 3477, 11027, 14504
INVAR-21, Run: 047, F, 0, 0, 218, 6603, 11581, 6499, 18080
INVAR-21, Run: 048, F, 0, 0, 218, 4839, 9547, 4735, 14282
INVAR-21, Run: 049, F, 0, 218, 0, 5721, 2870, 5835, 8705
INVAR-21, Run: 050, F, 0, 0, 218, 1906, 6805, 1802, 8607
INVAR-21, Run: 051, F, 0, 218, 0, 13328, 20898, 13442, 34340
INVAR-21, Run: 052, F, 0, 218, 0, 4425, 3525, 4539, 8064
INVAR-21, Run: 053, F, 0, 0, 218, 3575, 7703, 3471, 11174
INVAR-21, Run: 054, F, 0, 0, 218, 13078, 15176, 12974, 28150
INVAR-21, Run: 055, F, 0, 0, 218, 2476, 6884, 2372, 9256
INVAR-21, Run: 056, F, 0, 218, 0, 11478, 7542, 11592, 19134
INVAR-21, Run: 057, F, 0, 218, 0, 2546, 1128, 2660, 3788
INVAR-21, Run: 058, F, 0, 0, 218, 4008, 8790, 3904, 12694
INVAR-21, Run: 059, F, 0, 218, 0, 4419, 1103, 4533, 5636
INVAR-21, Run: 060, F, 0, 0, 218, 16353, 17297, 16249, 33546
INVAR-21, Run: 061, F, 0, 0, 218, 5516, 5691, 5412, 11103
INVAR-21, Run: 062, F, 0, 0, 218, 6227, 12089, 6123, 18212
INVAR-21, Run: 063, F, 0, 218, 0, 2961, 950, 3075, 4025
INVAR-21, Run: 064, F, 0, 218, 0, 8906, 10718, 9020, 19738
INVAR-21, Run: 065, F, 0, 218, 0, 939, 394, 1053, 1447
INVAR-21, Run: 066, F, 0, 0, 218, 5493, 7190, 5389, 12579
INVAR-21, Run: 067, F, 0, 0, 218, 8738, 12744, 8634, 21378
INVAR-21, Run: 068, F, 0, 0, 218, 1641, 6564, 1537, 8101
INVAR-21, Run: 069, F, 0, 0, 218, 4378, 8426, 4274, 12700
INVAR-21, Run: 070, F, 0, 218, 0, 21607, 32080, 21721, 53801
INVAR-21, Run: 071, F, 0, 218, 0, 4539, 2337, 4653, 6990
INVAR-21, Run: 072, F, 0, 0, 218, 825, 5310, 721, 6031
INVAR-21, Run: 073, F, 0, 0, 218, 6702, 14845, 6598, 21443
INVAR-21, Run: 074, F, 0, 0, 218, 3566, 11476, 3462, 14938
INVAR-21, Run: 075, F, 0, 0, 218, 2550, 9875, 2446, 12321
INVAR-21, Run: 076, F, 0, 0, 218, 4949, 9086, 4845, 13931
INVAR-21, Run: 077, F, 0, 218, 0, 1376, 666, 1490, 2156
INVAR-21, Run: 078, F, 0, 0, 218, 2953, 13554, 2849, 16403
INVAR-21, Run: 079, F, 0, 218, 0, 5388, 2774, 5502, 8276
INVAR-21, Run: 080, F, 0, 218, 0, 8043, 3730, 8157, 11887
INVAR-21, Run: 081, F, 0, 0, 218, 7547, 8411, 7443, 15854
INVAR-21, Run: 082, F, 0, 218, 0, 8348, 5128, 8462, 13590
INVAR-21, Run: 083, F, 0, 218, 0, 5634, 6567, 5748, 12315
INVAR-21, Run: 084, F, 0, 0, 218, 1885, 7085, 1781, 8866
INVAR-21, Run: 085, F, 0, 0, 218, 9418, 9964, 9314, 19278
INVAR-21, Run: 086, F, 0, 0, 218, 2175, 9361, 2071, 11432
INVAR-21, Run: 087, F, 0, 218, 0, 5641, 4510, 5755, 10265
INVAR-21, Run: 088, F, 0, 218, 0, 2656, 1314, 2770, 4084
INVAR-21, Run: 089, F, 0, 218, 0, 2473, 955, 2587, 3542
INVAR-21, Run: 090, F, 0, 0, 218, 1617, 5924, 1513, 7437
INVAR-21, Run: 091, F, 0, 218, 0, 3157, 733, 3271, 4004
INVAR-21, Run: 092, F, 0, 0, 218, 2712, 4953, 2608, 7561
INVAR-21, Run: 093, F, 0, 218, 0, 3319, 1326, 3433, 4759
INVAR-21, Run: 094, F, 0, 0, 218, 2630, 7048, 2526, 9574
INVAR-21, Run: 095, F, 0, 0, 218, 14417, 23275, 14313, 37588
INVAR-21, Run: 096, F, 0, 218, 0, 1773, 442, 1887, 2329
INVAR-21, Run: 097, F, 0, 218, 0, 3451, 538, 3565, 4103
INVAR-21, Run: 098, F, 0, 218, 0, 10089, 13772, 10203, 23975
INVAR-21, Run: 099, F, 0, 218, 0, 2065, 675, 2179, 2854
INVAR-21, Run: 100, F, 0, 0, 218, 3069, 6923, 2965, 9888
INVAR-22, Run: 001, F, 0, 183, 0, 1186, 329, 1278, 1607
INVAR-22, Run: 002, F, 0, 183, 0, 2537, 750, 2629, 3379
INVAR-22, Run: 003, F, 0, 0, 183, 5820, 15036, 5729, 20765
INVAR-22, Run: 004, F, 0, 0, 183, 13730, 12621, 13639, 26260
INVAR-22, Run: 005, F, 0, 0, 183, 4710, 5560, 4619, 10179
INVAR-22, Run: 006, F, 0, 0, 183, 1208, 4777, 1117, 5894
INVAR-22, Run: 007, F, 0, 0, 183, 8903, 13153, 8812, 21965
INVAR-22, Run: 008, F, 0, 183, 0, 5302, 5178, 5394, 10572
INVAR-22, Run: 009, F, 0, 183, 0, 5541, 2217, 5633, 7850
INVAR-22, Run: 010, F, 0, 0, 183, 1468, 6116, 1377, 7493
INVAR-22, Run: 011, F, 0, 183, 0, 7231, 3532, 7323, 10855
INVAR-22, Run: 012, F, 0, 0, 183, 4660, 11186, 4569, 15755
INVAR-22, Run: 013, F, 0, 0, 183, 7159, 14308, 7068, 21376
INVAR-22, Run: 014, F, 0, 0, 183, 3412, 8474, 3321, 11795
INVAR-22, Run: 015, F, 0, 0, 183, 1455, 4621, 1364, 5985
INVAR-22, Run: 016, F, 0, 183, 0, 713, 132, 805, 937
INVAR-22, Run: 017, F, 0, 0, 183, 6069, 7702, 5978, 13680
INVAR-22, Run: 018, F, 0, 0, 183, 1060, 4001, 969, 4970
INVAR-22, Run: 019, F, 0, 0, 183, 10086, 13876, 9995, 23871
INVAR-22, Run: 020, F, 0, 0, 183, 712, 4157, 621, 4778
INVAR-22, Run: 021, F, 0, 0, 183, 6118, 14234, 6027, 20261
INVAR-22, Run: 022, F, 0, 0, 183, 1390, 4054, 1299, 5353
INVAR-22, Run: 023, F, 0, 0, 183, 3914, 7643, 3823, 11466
INVAR-22, Run: 024, F, 0, 0, 183, 1185, 2914, 1094, 4008
INVAR-22, Run: 025, F, 0, 0, 183, 6571, 8500, 6480, 14980
INVAR-22, Run: 026, F, 0, 0, 183, 1760, 6906, 1669, 8575
INVAR-22, Run: 027, F, 0, 183, 0, 3591, 1087, 3683, 4770
INVAR-22, Run: 028, F, 0, 183, 0, 10274, 6560, 10366, 16926
INVAR-22, Run: 029, F, 0, 0, 183, 1943, 3872, 1852, 5724
INVAR-22, Run: 030, F, 0, 183, 0, 3847, 1358, 3939, 5297
INVAR-22, Run: 031, F, 0, 183, 0, 1953, 724, 2045, 2769
INVAR-22, Run: 032, F, 0, 0, 183, 1997, 6154, 1906, 8060
INVAR-22, Run: 033, F, 0, 0, 183, 11027, 7894, 10936, 18830
INVAR-22, Run: 034, F, 0, 0, 183, 6349, 12427, 6258, 18685
INVAR-22, Run: 035, F, 0, 0, 183, 2989, 5458, 2898, 8356
INVAR-22, Run: 036, F, 0, 183, 0, 7580, 2356, 7672, 10028
INVAR-22, Run: 037, F, 0, 0, 183, 1661, 3175, 1570, 4745
INVAR-22, Run: 038, F, 0, 0, 183, 5398, 10379, 5307, 15686
INVAR-22, Run: 039, F, 0, 183, 0, 2818, 3784, 2910, 6694
INVAR-22, Run: 040, F, 0, 0, 183, 4703, 5134, 4612, 9746
INVAR-22, Run: 041, F, 0, 183, 0, 3390, 1580, 3482, 5062
INVAR-22, Run: 042, F, 0, 183, 0, 1968, 590, 2060, 2650
INVAR-22, Run: 043, F, 0, 183, 0, 2836, 1541, 2928, 4469
INVAR-22, Run: 044, F, 0, 183, 0, 1326, 584, 1418, 2002
INVAR-22, Run: 045, F, 0, 0, 183, 4512, 6154, 4421, 10575
INVAR-22, Run: 046, F, 0, 183, 0, 3417, 2325, 3509, 5834
INVAR-22, Run: 047, F, 0, 183, 0, 2338, 1157, 2430, 3587
INVAR-22, Run: 048, F, 0, 183, 0, 2055, 901, 2147, 3048
INVAR-22, Run: 049, F, 0, 183, 0, 11892, 10349, 11984, 22333
INVAR-22, Run: 050, F, 0, 183, 0, 6472, 4391, 6564, 10955
INVAR-22, Run: 051, F, 0, 0, 183, 2707, 10595, 2616, 13211
INVAR-22, Run: 052, F, 0, 0, 183, 6942, 7344, 6851, 14195
INVAR-22, Run: 053, F, 0, 183, 0, 2253, 1262, 2345, 3607
INVAR-22, Run: 054, F, 0, 183, 0, 1979, 1413, 2071, 3484
INVAR-22, Run: 055, F, 0, 0, 183, 1332, 6860, 1241, 8101
INVAR-22, Run: 056, F, 0, 0, 183, 1162, 3700, 1071, 4771
INVAR-22, Run: 057, F, 0, 0, 183, 7209, 7995, 7118, 15113
INVAR-22, Run: 058, F, 0, 0, 183, 1760, 4528, 1669, 6197
INVAR-22, Run: 059, F, 0, 0, 183, 4164, 11371, 4073, 15444
INVAR-22, Run: 060, F, 0, 0, 183, 1121, 3610, 1030, 4640
INVAR-22, Run: 061, F, 0, 0, 183, 1781, 4950, 1690, 6640
INVAR-22, Run: 062, F, 0, 183, 0, 4708, 1489, 4800, 6289
INVAR-22, Run: 063, F, 0, 183, 0, 2660, 1293, 2752, 4045
INVAR-22, Run: 064, F, 0, 183, 0, 8463, 3816, 8555, 12371
INVAR-22, Run: 065, F, 0, 183, 0, 4212, 1828, 4304, 6132
INVAR-22, Run: 066, F, 0, 0, 183, 6807, 9938, 6716, 16654
INVAR-22, Run: 067, F, 0, 183, 0, 707, 152, 799, 951
INVAR-22, Run: 068, F, 0, 183, 0, 3273, 1441, 3365, 4806
INVAR-22, Run: 069, F, 0, 183, 0, 1419, 345, 1511, 1856
INVAR-22, Run: 070, F, 0, 0, 183, 1290, 5760, 1199, 6959
INVAR-22, Run: 071, F, 0, 0, 183, 1609, 5073, 1518, 6591
INVAR-22, Run: 072, F, 0, 183, 0, 3177, 1220, 3269, 4489
INVAR-22, Run: 073, F, 0, 0, 183, 1337, 4472, 1246, 5718
INVAR-22, Run: 074, F, 0, 183, 0, 1024, 435, 1116, 1551
INVAR-22, Run: 075, F, 0, 183, 0, 1249, 481, 1341, 1822
INVAR-22, Run: 076, F, 0, 0, 183, 1667, 3707, 1576, 5283
INVAR-22, Run: 077, F, 0, 183, 0, 4961, 8258, 5053, 13311
INVAR-22, Run: 078, F, 0, 183, 0, 1278, 345, 1370, 1715
INVAR-22, Run: 079, F, 0, 0, 183, 5434, 6508, 5343, 11851
INVAR-22, Run: 080, F, 0, 183, 0, 4373, 1753, 4465, 6218
INVAR-22, Run: 081, F, 0, 183, 0, 7004, 4773, 7096, 11869
INVAR-22, Run: 082, F, 0, 183, 0, 2164, 594, 2256, 2850
INVAR-22, Run: 083, F, 0, 183, 0, 1295, 495, 1387, 1882
INVAR-22, Run: 084, F, 0, 183, 0, 365, 67, 457, 524
INVAR-22, Run: 085, F, 0, 183, 0, 5421, 6162, 5513, 11675
INVAR-22, Run: 086, F, 0, 183, 0, 3515, 691, 3607, 4298
INVAR-22, Run: 087, F, 0, 0, 183, 1852, 7147, 1761, 8908
INVAR-22, Run: 088, F, 0, 183, 0, 2659, 1320, 2751, 4071
INVAR-22, Run: 089, F, 0, 183, 0, 1631, 617, 1723, 2340
INVAR-22, Run: 090, F, 0, 183, 0, 1521, 553, 1613, 2166
INVAR-22, Run: 091, F, 0, 0, 183, 749, 2994, 658, 3652
INVAR-22, Run: 092, F, 0, 183, 0, 4256, 1696, 4348, 6044
INVAR-22, Run: 093, F, 0, 183, 0, 409, 104, 501, 605
INVAR-22, Run: 094, F, 0, 0, 183, 2783, 10212, 2692, 12904
INVAR-22, Run: 095, F, 0, 183, 0, 25985, 22203, 26077, 48280
INVAR-22, Run: 096, F, 0, 0, 183, 7492, 12292, 7401, 19693
INVAR-22, Run: 097, F, 0, 183, 0, 2008, 894, 2100, 2994
INVAR-22, Run: 098, F, 0, 0, 183, 711, 3939, 620, 4559
INVAR-22, Run: 099, F, 0, 0, 183, 6991, 6721, 6900, 13621
INVAR-22, Run: 100, F, 0, 0, 183, 2397, 5834, 2306, 8140
INVAR-23, Run: 001, P, 0, 0, 28, 0, 0, 0, 0
INVAR-23, Run: 002, P, 0, 0, 28, 0, 0, 0, 0
INVAR-23, Run: 003, P, 0, 0, 28, 0, 0, 0, 0
INVAR-23, Run: 004, P, 0, 0, 28, 0, 0, 0, 0
INVAR-23, Run: 005, P, 0, 0, 28, 0, 0, 0, 0
INVAR-23, Run: 006, P, 0, 0, 28, 0, 0, 0, 0
INVAR-23, Run: 007, P, 0, 0, 28, 0, 0, 0, 0
INVAR-23, Run: 008, P, 0, 0, 28, 0, 0, 0, 0
INVAR-23, Run: 009, P, 0, 0, 28, 0, 0, 0, 0
INVAR-23, Run: 010, P, 0, 0, 28, 0, 0, 0, 0
INVAR-23, Run: 011, P, 0, 0, 28, 0, 0, 0, 0
INVAR-23, Run: 012, P, 0, 0, 28, 0, 0, 0, 0
INVAR-23, Run: 013, P, 0, 0, 28, 0, 0, 0, 0
INVAR-23, Run: 014, P, 0, 0, 28, 0, 0, 0, 0
INVAR-23, Run: 015, P, 0, 0, 28, 0, 0, 0, 0
INVAR-23, Run: 016, P, 0, 0, 28, 0, 0, 0, 0
INVAR-23, Run: 017, P, 0, 0, 28, 0, 0, 0, 0
INVAR-23, Run: 018, P, 0, 0, 28, 0, 0, 0, 0
INVAR-23, Run: 019, P, 0, 0, 28, 0, 0, 0, 0
INVAR-23, Run: 020, P, 0, 0, 28, 0, 0, 0, 0
INVAR-23, Run: 021, P, 0, 0, 28, 0, 0, 0, 0
INVAR-23, Run: 022, P, 0, 0, 28, 0, 0, 0, 0
INVAR-23, Run: 023, P, 0, 0, 28, 0, 0, 0, 0
INVAR-23, Run: 024, P, 0, 0, 28, 0, 0, 0, 0
INVAR-23, Run: 025, P, 0, 0, 28, 0, 0, 0, 0
INVAR-23, Run: 026, P, 0, 0, 28, 0, 0, 0, 0
INVAR-23, Run: 027, P, 0, 0, 28, 0, 0, 0, 0
INVAR-23, Run: 028, P, 0, 0, 28, 0, 0, 0, 0
INVAR-23, Run: 029, P, 0, 0, 28, 0, 0, 0, 0
INVAR-23, Run: 030, P, 0, 0, 28, 0, 0, 0, 0
INVAR-23, Run: 031, P, 0, 0, 28, 0, 0, 0, 0
INVAR-23, Run: 032, P, 0, 0, 28, 0, 0, 0, 0
INVAR-23, Run: 033, P, 0, 0, 28, 0, 0, 0, 0
INVAR-23, Run: 034, P, 0, 0, 28, 0, 0, 0, 0
INVAR-23, Run: 035, P, 0, 0, 28, 0, 0, 0, 0
INVAR-23, Run: 036, P, 0, 0, 28, 0, 0, 0, 0
INVAR-23, Run: 037, P, 0, 0, 28, 0, 0, 0, 0
INVAR-23, Run: 038, P, 0, 0, 28, 0, 0, 0, 0
INVAR-23, Run: 039, P, 0, 0, 28, 0, 0, 0, 0
INVAR-23, Run: 040, P, 0, 0, 28, 0, 0, 0, 0
INVAR-23, Run: 041, P, 0, 0, 28, 0, 0, 0, 0
INVAR-23, Run: 042, P, 0, 0, 28, 0, 0, 0, 0
INVAR-23, Run: 043, P, 0, 0, 28, 0, 0, 0, 0
INVAR-23, Run: 044, P, 0, 0, 28, 0, 0, 0, 0
INVAR-23, Run: 045, P, 0, 0, 28, 0, 0, 0, 0
INVAR-23, Run: 046, P, 0, 0, 28, 0, 0, 0, 0
INVAR-23, Run: 047, P, 0, 0, 28, 0, 0, 0, 0
INVAR-23, Run: 048, P, 0, 0, 28, 0, 0, 0, 0
INVAR-23, Run: 049, P, 0, 0, 28, 0, 0, 0, 0
INVAR-23, Run: 050, P, 0, 0, 28, 0, 0, 0, 0
INVAR-23, Run: 051, P, 0, 0, 28, 0, 0, 0, 0
INVAR-23, Run: 052, P, 0, 0, 28, 0, 0, 0, 0
INVAR-23, Run: 053, P, 0, 0, 28, 0, 0, 0, 0
INVAR-23, Run: 054, P, 0, 0, 28, 0, 0, 0, 0
INVAR-23, Run: 055, P, 0, 0, 28, 0, 0, 0, 0
INVAR-23, Run: 056, P, 0, 0, 28, 0, 0, 0, 0
INVAR-23, Run: 057, P, 0, 0, 28, 0, 0, 0, 0
INVAR-23, Run: 058, P, 0, 0, 28, 0, 0, 0, 0
INVAR-23, Run: 059, P, 0, 0, 28, 0, 0, 0, 0
INVAR-23, Run: 060, P, 0, 0, 28, 0, 0, 0, 0
INVAR-23, Run: 061, P, 0, 0, 28, 0, 0, 0, 0
INVAR-23, Run: 062, P, 0, 0, 28, 0, 0, 0, 0
INVAR-23, Run: 063, P, 0, 0, 28, 0, 0, 0, 0
INVAR-23, Run: 064, P, 0, 0, 28, 0, 0, 0, 0
INVAR-23, Run: 065, P, 0, 0, 28, 0, 0, 0, 0
INVAR-23, Run: 066, P, 0, 0, 28, 0, 0, 0, 0
INVAR-23, Run: 067, P, 0, 0, 28, 0, 0, 0, 0
INVAR-23, Run: 068, P, 0, 0, 28, 0, 0, 0, 0
INVAR-23, Run: 069, P, 0, 0, 28, 0, 0, 0, 0
INVAR-23, Run: 070, P, 0, 0, 28, 0, 0, 0, 0
INVAR-23, Run: 071, P, 0, 0, 28, 0, 0, 0, 0
INVAR-23, Run: 072, P, 0, 0, 28, 0, 0, 0, 0
INVAR-23, Run: 073, P, 0, 0, 28, 0, 0, 0, 0
INVAR-23, Run: 074, P, 0, 0, 28, 0, 0, 0, 0
INVAR-23, Run: 075, P, 0, 0, 28, 0, 0, 0, 0
INVAR-23, Run: 076, P, 0, 0, 28, 0, 0, 0, 0
INVAR-23, Run: 077, P, 0, 0, 28, 0, 0, 0, 0
INVAR-23, Run: 078, P, 0, 0, 28, 0, 0, 0, 0
INVAR-23, Run: 079, P, 0, 0, 28, 0, 0, 0, 0
INVAR-23, Run: 080, P, 0, 0, 28, 0, 0, 0, 0
INVAR-23, Run: 081, P, 0, 0, 28, 0, 0, 0, 0
INVAR-23, Run: 082, P, 0, 0, 28, 0, 0, 0, 0
INVAR-23, Run: 083, P, 0, 0, 28, 0, 0, 0, 0
INVAR-23, Run: 084, P, 0, 0, 28, 0, 0, 0, 0
INVAR-23, Run: 085, P, 0, 0, 28, 0, 0, 0, 0
INVAR-23, Run: 086, P, 0, 0, 28, 0, 0, 0, 0
INVAR-23, Run: 087, P, 0, 0, 28, 0, 0, 0, 0
INVAR-23, Run: 088, P, 0, 0, 28, 0, 0, 0, 0
INVAR-23, Run: 089, P, 0, 0, 28, 0, 0, 0, 0
INVAR-23, Run: 090, P, 0, 0, 28, 0, 0, 0, 0
INVAR-23, Run: 091, P, 0, 0, 28, 0, 0, 0, 0
INVAR-23, Run: 092, P, 0, 0, 28, 0, 0, 0, 0
INVAR-23, Run: 093, P, 0, 0, 28, 0, 0, 0, 0
INVAR-23, Run: 094, P, 0, 0, 28, 0, 0, 0, 0
INVAR-23, Run: 095, P, 0, 0, 28, 0, 0, 0, 0
INVAR-23, Run: 096, P, 0, 0, 28, 0, 0, 0, 0
INVAR-23, Run: 097, P, 0, 0, 28, 0, 0, 0, 0
INVAR-23, Run: 098, P, 0, 0, 28, 0, 0, 0, 0
INVAR-23, Run: 099, P, 0, 0, 28, 0, 0, 0, 0
INVAR-23, Run: 100, P, 0, 0, 28, 0, 0, 0, 0
INVAR-24, Run: 001, P, 0, 0, 40, 0, 0, 0, 0
INVAR-24, Run: 002, P, 0, 0, 40, 0, 0, 0, 0
INVAR-24, Run: 003, P, 0, 0, 40, 0, 0, 0, 0
INVAR-24, Run: 004, P, 0, 0, 40, 0, 0, 0, 0
INVAR-24, Run: 005, P, 0, 0, 40, 0, 0, 0, 0
INVAR-24, Run: 006, P, 0, 0, 40, 0, 0, 0, 0
INVAR-24, Run: 007, P, 0, 0, 40, 0, 0, 0, 0
INVAR-24, Run: 008, P, 0, 0, 40, 0, 0, 0, 0
INVAR-24, Run: 009, P, 0, 0, 40, 0, 0, 0, 0
INVAR-24, Run: 010, P, 0, 0, 40, 0, 0, 0, 0
INVAR-24, Run: 011, P, 0, 0, 40, 0, 0, 0, 0
INVAR-24, Run: 012, P, 0, 0, 40, 0, 0, 0, 0
INVAR-24, Run: 013, P, 0, 0, 40, 0, 0, 0, 0
INVAR-24, Run: 014, P, 0, 0, 40, 0, 0, 0, 0
INVAR-24, Run: 015, P, 0, 0, 40, 0, 0, 0, 0
INVAR-24, Run: 016, P, 0, 0, 40, 0, 0, 0, 0
INVAR-24, Run: 017, P, 0, 0, 40, 0, 0, 0, 0
INVAR-24, Run: 018, P, 0, 0, 40, 0, 0, 0, 0
INVAR-24, Run: 019, P, 0, 0, 40, 0, 0, 0, 0
INVAR-24, Run: 020, P, 0, 0, 40, 0, 0, 0, 0
INVAR-24, Run: 021, P, 0, 0, 40, 0, 0, 0, 0
INVAR-24, Run: 022, P, 0, 0, 40, 0, 0, 0, 0
INVAR-24, Run: 023, P, 0, 0, 40, 0, 0, 0, 0
INVAR-24, Run: 024, P, 0, 0, 40, 0, 0, 0, 0
INVAR-24, Run: 025, P, 0, 0, 40, 0, 0, 0, 0
INVAR-24, Run: 026, P, 0, 0, 40, 0, 0, 0, 0
INVAR-24, Run: 027, P, 0, 0, 40, 0, 0, 0, 0
INVAR-24, Run: 028, P, 0, 0, 40, 0, 0, 0, 0
INVAR-24, Run: 029, P, 0, 0, 40, 0, 0, 0, 0
INVAR-24, Run: 030, P, 0, 0, 40, 0, 0, 0, 0
INVAR-24, Run: 031, P, 0, 0, 40, 0, 0, 0, 0
INVAR-24, Run: 032, P, 0, 0, 40, 0, 0, 0, 0
INVAR-24, Run: 033, P, 0, 0, 40, 0, 0, 0, 0
INVAR-24, Run: 034, P, 0, 0, 40, 0, 0, 0, 0
INVAR-24, Run: 035, P, 0, 0, 40, 0, 0, 0, 0
INVAR-24, Run: 036, P, 0, 0, 40, 0, 0, 0, 0
INVAR-24, Run: 037, P, 0, 0, 40, 0, 0, 0, 0
INVAR-24, Run: 038, P, 0, 0, 40, 0, 0, 0, 0
INVAR-24, Run: 039, P, 0, 0, 40, 0, 0, 0, 0
INVAR-24, Run: 040, P, 0, 0, 40, 0, 0, 0, 0
INVAR-24, Run: 041, P, 0, 0, 40, 0, 0, 0, 0
INVAR-24, Run: 042, P, 0, 0, 40, 0, 0, 0, 0
INVAR-24, Run: 043, P, 0, 0, 40, 0, 0, 0, 0
INVAR-24, Run: 044, P, 0, 0, 40, 0, 0, 0, 0
INVAR-24, Run: 045, P, 0, 0, 40, 0, 0, 0, 0
INVAR-24, Run: 046, P, 0, 0, 40, 0, 0, 0, 0
INVAR-24, Run: 047, P, 0, 0, 40, 0, 0, 0, 0
INVAR-24, Run: 048, P, 0, 0, 40, 0, 0, 0, 0
INVAR-24, Run: 049, P, 0, 0, 40, 0, 0, 0, 0
INVAR-24, Run: 050, P, 0, 0, 40, 0, 0, 0, 0
INVAR-24, Run: 051, P, 0, 0, 40, 0, 0, 0, 0
INVAR-24, Run: 052, P, 0, 0, 40, 0, 0, 0, 0
INVAR-24, Run: 053, P, 0, 0, 40, 0, 0, 0, 0
INVAR-24, Run: 054, P, 0, 0, 40, 0, 0, 0, 0
INVAR-24, Run: 055, P, 0, 0, 40, 0, 0, 0, 0
INVAR-24, Run: 056, P, 0, 0, 40, 0, 0, 0, 0
INVAR-24, Run: 057, P, 0, 0, 40, 0, 0, 0, 0
INVAR-24, Run: 058, P, 0, 0, 40, 0, 0, 0, 0
INVAR-24, Run: 059, P, 0, 0, 40, 0, 0, 0, 0
INVAR-24, Run: 060, P, 0, 0, 40, 0, 0, 0, 0
INVAR-24, Run: 061, P, 0, 0, 40, 0, 0, 0, 0
INVAR-24, Run: 062, P, 0, 0, 40, 0, 0, 0, 0
INVAR-24, Run: 063, P, 0, 0, 40, 0, 0, 0, 0
INVAR-24, Run: 064, P, 0, 0, 40, 0, 0, 0, 0
INVAR-24, Run: 065, P, 0, 0, 40, 0, 0, 0, 0
INVAR-24, Run: 066, P, 0, 0, 40, 0, 0, 0, 0
INVAR-24, Run: 067, P, 0, 0, 40, 0, 0, 0, 0
INVAR-24, Run: 068, P, 0, 0, 40, 0, 0, 0, 0
INVAR-24, Run: 069, P, 0, 0, 40, 0, 0, 0, 0
INVAR-24, Run: 070, P, 0, 0, 40, 0, 0, 0, 0
INVAR-24, Run: 071, P, 0, 0, 40, 0, 0, 0, 0
INVAR-24, Run: 072, P, 0, 0, 40, 0, 0, 0, 0
INVAR-24, Run: 073, P, 0, 0, 40, 0, 0, 0, 0
INVAR-24, Run: 074, P, 0, 0, 40, 0, 0, 0, 0
INVAR-24, Run: 075, P, 0, 0, 40, 0, 0, 0, 0
INVAR-24, Run: 076, P, 0, 0, 40, 0, 0, 0, 0
INVAR-24, Run: 077, P, 0, 0, 40, 0, 0, 0, 0
INVAR-24, Run: 078, P, 0, 0, 40, 0, 0, 0, 0
INVAR-24, Run: 079, P, 0, 0, 40, 0, 0, 0, 0
INVAR-24, Run: 080, P, 0, 0, 40, 0, 0, 0, 0
INVAR-24, Run: 081, P, 0, 0, 40, 0, 0, 0, 0
INVAR-24, Run: 082, P, 0, 0, 40, 0, 0, 0, 0
INVAR-24, Run: 083, P, 0, 0, 40, 0, 0, 0, 0
INVAR-24, Run: 084, P, 0, 0, 40, 0, 0, 0, 0
INVAR-24, Run: 085, P, 0, 0, 40, 0, 0, 0, 0
INVAR-24, Run: 086, P, 0, 0, 40, 0, 0, 0, 0
INVAR-24, Run: 087, P, 0, 0, 40, 0, 0, 0, 0
INVAR-24, Run: 088, P, 0, 0, 40, 0, 0, 0, 0
INVAR-24, Run: 089, P, 0, 0, 40, 0, 0, 0, 0
INVAR-24, Run: 090, P, 0, 0, 40, 0, 0, 0, 0
INVAR-24, Run: 091, P, 0, 0, 40, 0, 0, 0, 0
INVAR-24, Run: 092, P, 0, 0, 40, 0, 0, 0, 0
INVAR-24, Run: 093, P, 0, 0, 40, 0, 0, 0, 0
INVAR-24, Run: 094, P, 0, 0, 40, 0, 0, 0, 0
INVAR-24, Run: 095, P, 0, 0, 40, 0, 0, 0, 0
INVAR-24, Run: 096, P, 0, 0, 40, 0, 0, 0, 0
INVAR-24, Run: 097, P, 0, 0, 40, 0, 0, 0, 0
INVAR-24, Run: 098, P, 0, 0, 40, 0, 0, 0, 0
INVAR-24, Run: 099, P, 0, 0, 40, 0, 0, 0, 0
INVAR-24, Run: 100, P, 0, 0, 40, 0, 0, 0, 0
INVAR-25, Run: 001, P, 0, 0, 130, 0, 0, 0, 0
INVAR-25, Run: 002, P, 0, 0, 130, 0, 0, 0, 0
INVAR-25, Run: 003, P, 0, 0, 130, 0, 0, 0, 0
INVAR-25, Run: 004, P, 0, 0, 130, 0, 0, 0, 0
INVAR-25, Run: 005, P, 0, 0, 130, 0, 0, 0, 0
INVAR-25, Run: 006, P, 0, 0, 130, 0, 0, 0, 0
INVAR-25, Run: 007, P, 0, 0, 130, 0, 0, 0, 0
INVAR-25, Run: 008, P, 0, 0, 130, 0, 0, 0, 0
INVAR-25, Run: 009, P, 0, 0, 130, 0, 0, 0, 0
INVAR-25, Run: 010, P, 0, 0, 130, 0, 0, 0, 0
INVAR-25, Run: 011, P, 0, 0, 130, 0, 0, 0, 0
INVAR-25, Run: 012, P, 0, 0, 130, 0, 0, 0, 0
INVAR-25, Run: 013, P, 0, 0, 130, 0, 0, 0, 0
INVAR-25, Run: 014, P, 0, 0, 130, 0, 0, 0, 0
INVAR-25, Run: 015, P, 0, 0, 130, 0, 0, 0, 0
INVAR-25, Run: 016, P, 0, 0, 130, 0, 0, 0, 0
INVAR-25, Run: 017, P, 0, 0, 130, 0, 0, 0, 0
INVAR-25, Run: 018, P, 0, 0, 130, 0, 0, 0, 0
INVAR-25, Run: 019, P, 0, 0, 130, 0, 0, 0, 0
INVAR-25, Run: 020, P, 0, 0, 130, 0, 0, 0, 0
INVAR-25, Run: 021, P, 0, 0, 130, 0, 0, 0, 0
INVAR-25, Run: 022, P, 0, 0, 130, 0, 0, 0, 0
INVAR-25, Run: 023, P, 0, 0, 130, 0, 0, 0, 0
INVAR-25, Run: 024, P, 0, 0, 130, 0, 0, 0, 0
INVAR-25, Run: 025, P, 0, 0, 130, 0, 0, 0, 0
INVAR-25, Run: 026, P, 0, 0, 130, 0, 0, 0, 0
INVAR-25, Run: 027, P, 0, 0, 130, 0, 0, 0, 0
INVAR-25, Run: 028, P, 0, 0, 130, 0, 0, 0, 0
INVAR-25, Run: 029, P, 0, 0, 130, 0, 0, 0, 0
INVAR-25, Run: 030, P, 0, 0, 130, 0, 0, 0, 0
INVAR-25, Run: 031, P, 0, 0, 130, 0, 0, 0, 0
INVAR-25, Run: 032, P, 0, 0, 130, 0, 0, 0, 0
INVAR-25, Run: 033, P, 0, 0, 130, 0, 0, 0, 0
INVAR-25, Run: 034, P, 0, 0, 130, 0, 0, 0, 0
INVAR-25, Run: 035, P, 0, 0, 130, 0, 0, 0, 0
INVAR-25, Run: 036, P, 0, 0, 130, 0, 0, 0, 0
INVAR-25, Run: 037, P, 0, 0, 130, 0, 0, 0, 0
INVAR-25, Run: 038, P, 0, 0, 130, 0, 0, 0, 0
INVAR-25, Run: 039, P, 0, 0, 130, 0, 0, 0, 0
INVAR-25, Run: 040, P, 0, 0, 130, 0, 0, 0, 0
INVAR-25, Run: 041, P, 0, 0, 130, 0, 0, 0, 0
INVAR-25, Run: 042, P, 0, 0, 130, 0, 0, 0, 0
INVAR-25, Run: 043, P, 0, 0, 130, 0, 0, 0, 0
INVAR-25, Run: 044, P, 0, 0, 130, 0, 0, 0, 0
INVAR-25, Run: 045, P, 0, 0, 130, 0, 0, 0, 0
INVAR-25, Run: 046, P, 0, 0, 130, 0, 0, 0, 0
INVAR-25, Run: 047, P, 0, 0, 130, 0, 0, 0, 0
INVAR-25, Run: 048, P, 0, 0, 130, 0, 0, 0, 0
INVAR-25, Run: 049, P, 0, 0, 130, 0, 0, 0, 0
INVAR-25, Run: 050, P, 0, 0, 130, 0, 0, 0, 0
INVAR-25, Run: 051, P, 0, 0, 130, 0, 0, 0, 0
INVAR-25, Run: 052, P, 0, 0, 130, 0, 0, 0, 0
INVAR-25, Run: 053, P, 0, 0, 130, 0, 0, 0, 0
INVAR-25, Run: 054, P, 0, 0, 130, 0, 0, 0, 0
INVAR-25, Run: 055, P, 0, 0, 130, 0, 0, 0, 0
INVAR-25, Run: 056, P, 0, 0, 130, 0, 0, 0, 0
INVAR-25, Run: 057, P, 0, 0, 130, 0, 0, 0, 0
INVAR-25, Run: 058, P, 0, 0, 130, 0, 0, 0, 0
INVAR-25, Run: 059, P, 0, 0, 130, 0, 0, 0, 0
INVAR-25, Run: 060, P, 0, 0, 130, 0, 0, 0, 0
INVAR-25, Run: 061, P, 0, 0, 130, 0, 0, 0, 0
INVAR-25, Run: 062, P, 0, 0, 130, 0, 0, 0, 0
INVAR-25, Run: 063, P, 0, 0, 130, 0, 0, 0, 0
INVAR-25, Run: 064, P, 0, 0, 130, 0, 0, 0, 0
INVAR-25, Run: 065, P, 0, 0, 130, 0, 0, 0, 0
INVAR-25, Run: 066, P, 0, 0, 130, 0, 0, 0, 0
INVAR-25, Run: 067, P, 0, 0, 130, 0, 0, 0, 0
INVAR-25, Run: 068, P, 0, 0, 130, 0, 0, 0, 0
INVAR-25, Run: 069, P, 0, 0, 130, 0, 0, 0, 0
INVAR-25, Run: 070, P, 0, 0, 130, 0, 0, 0, 0
INVAR-25, Run: 071, P, 0, 0, 130, 0, 0, 0, 0
INVAR-25, Run: 072, P, 0, 0, 130, 0, 0, 0, 0
INVAR-25, Run: 073, P, 0, 0, 130, 0, 0, 0, 0
INVAR-25, Run: 074, P, 0, 0, 130, 0, 0, 0, 0
INVAR-25, Run: 075, P, 0, 0, 130, 0, 0, 0, 0
INVAR-25, Run: 076, P, 0, 0, 130, 0, 0, 0, 0
INVAR-25, Run: 077, P, 0, 0, 130, 0, 0, 0, 0
INVAR-25, Run: 078, P, 0, 0, 130, 0, 0, 0, 0
INVAR-25, Run: 079, P, 0, 0, 130, 0, 0, 0, 0
INVAR-25, Run: 080, P, 0, 0, 130, 0, 0, 0, 0
INVAR-25, Run: 081, P, 0, 0, 130, 0, 0, 0, 0
INVAR-25, Run: 082, P, 0, 0, 130, 0, 0, 0, 0
INVAR-25, Run: 083, P, 0, 0, 130, 0, 0, 0, 0
INVAR-25, Run: 084, P, 0, 0, 130, 0, 0, 0, 0
INVAR-25, Run: 085, P, 0, 0, 130, 0, 0, 0, 0
INVAR-25, Run: 086, P, 0, 0, 130, 0, 0, 0, 0
INVAR-25, Run: 087, P, 0, 0, 130, 0, 0, 0, 0
INVAR-25, Run: 088, P, 0, 0, 130, 0, 0, 0, 0
INVAR-25, Run: 089, P, 0, 0, 130, 0, 0, 0, 0
INVAR-25, Run: 090, P, 0, 0, 130, 0, 0, 0, 0
INVAR-25, Run: 091, P, 0, 0, 130, 0, 0, 0, 0
INVAR-25, Run: 092, P, 0, 0, 130, 0, 0, 0, 0
INVAR-25, Run: 093, P, 0, 0, 130, 0, 0, 0, 0
INVAR-25, Run: 094, P, 0, 0, 130, 0, 0, 0, 0
INVAR-25, Run: 095, P, 0, 0, 130, 0, 0, 0, 0
INVAR-25, Run: 096, P, 0, 0, 130, 0, 0, 0, 0
INVAR-25, Run: 097, P, 0, 0, 130, 0, 0, 0, 0
INVAR-25, Run: 098, P, 0, 0, 130, 0, 0, 0, 0
INVAR-25, Run: 099, P, 0, 0, 130, 0, 0, 0, 0
INVAR-25, Run: 100, P, 0, 0, 130, 0, 0, 0, 0
INVAR-26, Run: 001, F, 0, 35, 0, 298, 599, 329, 928
INVAR-26, Run: 002, F, 0, 0, 35, 25, 185, 21, 206
INVAR-26, Run: 003, F, 0, 0, 35, 32, 162, 28, 190
INVAR-26, Run: 004, F, 0, 35, 0, 51, 32, 82, 114
INVAR-26, Run: 005, F, 0, 0, 35, 373, 610, 369, 979
INVAR-26, Run: 006, F, 0, 0, 35, 30, 165, 26, 191
INVAR-26, Run: 007, F, 0, 0, 35, 25, 191, 21, 212
INVAR-26, Run: 008, F, 0, 0, 35, 10, 76, 6, 82
INVAR-26, Run: 009, F, 0, 0, 35, 5, 25, 1, 26
INVAR-26, Run: 010, F, 0, 0, 35, 32, 286, 28, 314
INVAR-26, Run: 011, F, 0, 0, 35, 129, 271, 125, 396
INVAR-26, Run: 012, F, 0, 0, 35, 6, 50, 2, 52
INVAR-26, Run: 013, F, 0, 0, 35, 22, 108, 18, 126
INVAR-26, Run: 014, F, 0, 0, 35, 24, 227, 20, 247
INVAR-26, Run: 015, F, 0, 0, 35, 6, 79, 2, 81
INVAR-26, Run: 016, F, 0, 0, 35, 9, 60, 5, 65
INVAR-26, Run: 017, F, 0, 0, 35, 27, 167, 23, 190
INVAR-26, Run: 018, F, 0, 0, 35, 14, 242, 10, 252
INVAR-26, Run: 019, F, 0, 0, 35, 12, 34, 8, 42
INVAR-26, Run: 020, F, 0, 0, 35, 478, 303, 474, 777
INVAR-26, Run: 021, F, 0, 0, 35, 21, 183, 17, 200
INVAR-26, Run: 022, F, 0, 35, 0, 210, 380, 241, 621
INVAR-26, Run: 023, F, 0, 35, 0, 477, 549, 508, 1057
INVAR-26, Run: 024, F, 0, 0, 35, 5, 61, 1, 62
INVAR-26, Run: 025, F, 0, 0, 35, 5, 36, 1, 37
INVAR-26, Run: 026, F, 0, 0, 35, 28, 85, 24, 109
INVAR-26, Run: 027, F, 0, 0, 35, 12, 70, 8, 78
INVAR-26, Run: 028, F, 0, 0, 35, 407, 473, 403, 876
INVAR-26, Run: 029, F, 0, 0, 35, 153, 300, 149, 449
INVAR-26, Run: 030, F, 0, 0, 35, 7, 159, 3, 162
INVAR-26, Run: 031, F, 0, 0, 35, 47, 197, 43, 240
INVAR-26, Run: 032, F, 0, 0, 35, 5, 28, 1, 29
INVAR-26, Run: 033, F, 0, 0, 35, 10, 49, 6, 55
INVAR-26, Run: 034, F, 0, 0, 35, 10, 94, 6, 100
INVAR-26, Run: 035, F, 0, 0, 35, 62, 326, 58, 384
INVAR-26, Run: 036, F, 0, 0, 35, 25, 156, 21, 177
INVAR-26, Run: 037, F, 0, 0, 35, 23, 323, 19, 342
INVAR-26, Run: 038, F, 0, 0, 35, 472, 1097, 468, 1565
INVAR-26, Run: 039, F, 0, 0, 35, 7, 54, 3, 57
INVAR-26, Run: 040, F, 0, 0, 35, 12, 186, 8, 194
INVAR-26, Run: 041, F, 0, 0, 35, 53, 194, 49, 243
INVAR-26, Run: 042, F, 0, 0, 35, 15, 106, 11, 117
INVAR-26, Run: 043, F, 0, 0, 35, 4, 27, 0, 27
INVAR-26, Run: 044, F, 0, 0, 35, 16, 156, 12, 168
INVAR-26, Run: 045, F, 0, 0, 35, 176, 375, 172, 547
INVAR-26, Run: 046, F, 0, 0, 35, 15, 82, 11, 93
INVAR-26, Run: 047, F, 0, 0, 35, 5, 44, 1, 45
INVAR-26, Run: 048, F, 0, 35, 0, 102, 204, 133, 337
INVAR-26, Run: 049, F, 0, 0, 35, 35, 196, 31, 227
INVAR-26, Run: 050, F, 0, 0, 35, 4, 10, 0, 10
INVAR-26, Run: 051, F, 0, 0, 35, 18, 87, 14, 101
INVAR-26, Run: 052, F, 0, 35, 0, 174, 277, 205, 482
INVAR-26, Run: 053, F, 0, 0, 35, 5, 71, 1, 72
INVAR-26, Run: 054, F, 0, 0, 35, 51, 248, 47, 295
INVAR-26, Run: 055, F, 0, 0, 35, 4, 121, 0, 121
INVAR-26, Run: 056, F, 0, 0, 35, 21, 182, 17, 199
INVAR-26, Run: 057, F, 0, 0, 35, 118, 328, 114, 442
INVAR-26, Run: 058, F, 0, 0, 35, 4, 32, 0, 32
INVAR-26, Run: 059, F, 0, 0, 35, 21, 147, 17, 164
INVAR-26, Run: 060, F, 0, 0, 35, 6, 38, 2, 40
INVAR-26, Run: 061, F, 0, 0, 35, 58, 208, 54, 262
INVAR-26, Run: 062, F, 0, 35, 0, 201, 173, 232, 405
INVAR-26, Run: 063, F, 0, 0, 35, 179, 399, 175, 574
INVAR-26, Run: 064, F, 0, 0, 35, 9, 74, 5, 79
INVAR-26, Run: 065, F, 0, 0, 35, 8, 88, 4, 92
INVAR-26, Run: 066, F, 0, 0, 35, 179, 270, 175, 445
INVAR-26, Run: 067, F, 0, 0, 35, 4, 48, 0, 48
INVAR-26, Run: 068, F, 0, 0, 35, 32, 174, 28, 202
INVAR-26, Run: 069, F, 0, 35, 0, 493, 282, 524, 806
INVAR-26, Run: 070, F, 0, 0, 35, 5, 40, 1, 41
INVAR-26, Run: 071, F, 0, 0, 35, 19, 134, 15, 149
INVAR-26, Run: 072, F, 0, 0, 35, 39, 208, 35, 243
INVAR-26, Run: 073, F, 0, 0, 35, 4, 12, 0, 12
INVAR-26, Run: 074, F, 0, 0, 35, 184, 299, 180, 479
INVAR-26, Run: 075, F, 0, 0, 35, 10, 47, 6, 53
INVAR-26, Run: 076, F, 0, 0, 35, 21, 257, 17, 274
INVAR-26, Run: 077, F, 0, 0, 35, 175, 364, 171, 535
INVAR-26, Run: 078, F, 0, 0, 35, 9, 111, 5, 116
INVAR-26, Run: 079, F, 0, 0, 35, 9, 155, 5, 160
INVAR-26, Run: 080, F, 0, 0, 35, 22, 211, 18, 229
INVAR-26, Run: 081, F, 0, 35, 0, 196, 365, 227, 592
INVAR-26, Run: 082, F, 0, 0, 35, 4, 33, 0, 33
INVAR-26, Run: 083, F, 0, 0, 35, 16, 120, 12, 132
INVAR-26, Run: 084, F, 0, 0, 35, 21, 135, 17, 152
INVAR-26, Run: 085, F, 0, 35, 0, 210, 180, 241, 421
INVAR-26, Run: 086, F, 0, 0, 35, 5, 62, 1, 63
INVAR-26, Run: 087, F, 0, 0, 35, 58, 216, 54, 270
INVAR-26, Run: 088, F, 0, 0, 35, 25, 114, 21, 135
INVAR-26, Run: 089, F, 0, 35, 0, 80, 316, 111, 427
INVAR-26, Run: 090, F, 0, 0, 35, 10, 60, 6, 66
INVAR-26, Run: 091, F, 0, 0, 35, 7, 32, 3, 35
INVAR-26, Run: 092, F, 0, 0, 35, 4, 7, 0, 7
INVAR-26, Run: 093, F, 0, 0, 35, 57, 406, 53, 459
INVAR-26, Run: 094, F, 0, 0, 35, 31, 175, 27, 202
INVAR-26, Run: 095, F, 0, 0, 35, 30, 233, 26, 259
INVAR-26, Run: 096, F, 0, 35, 0, 195, 323, 226, 549
INVAR-26, Run: 097, F, 0, 0, 35, 23, 234, 19, 253
INVAR-26, Run: 098, F, 0, 0, 35, 18, 124, 14, 138
INVAR-26, Run: 099, F, 0, 0, 35, 23, 204, 19, 223
INVAR-26, Run: 100, F, 0, 0, 35, 12, 73, 8, 81
INVAR-27, Run: 001, F, 0, 0, 91, 411, 2262, 379, 2641
INVAR-27, Run: 002, F, 0, 91, 0, 393, 163, 452, 615
INVAR-27, Run: 003, F, 0, 91, 0, 464, 158, 523, 681
INVAR-27, Run: 004, F, 0, 0, 91, 88, 515, 56, 571
INVAR-27, Run: 005, F, 0, 91, 0, 523, 1023, 582, 1605
INVAR-27, Run: 006, F, 0, 0, 91, 707, 1561, 675, 2236
INVAR-27, Run: 007, F, 0, 91, 0, 280, 99, 339, 438
INVAR-27, Run: 008, F, 0, 0, 91, 125, 524, 93, 617
INVAR-27, Run: 009, F, 0, 0, 91, 98, 865, 66, 931
INVAR-27, Run: 010, F, 0, 91, 0, 634, 736, 693, 1429
INVAR-27, Run: 011, F, 0, 0, 91, 1032, 5054, 1000, 6054
INVAR-27, Run: 012, F, 0, 0, 91, 237, 1298, 205, 1503
INVAR-27, Run: 013, F, 0, 0, 91, 488, 2617, 456, 3073
INVAR-27, Run: 014, F, 0, 91, 0, 581, 441, 640, 1081
INVAR-27, Run: 015, F, 0, 0, 91, 3219, 5739, 3187, 8926
INVAR-27, Run: 016, F, 0, 91, 0, 5070, 2942, 5129, 8071
INVAR-27, Run: 017, F, 0, 0, 91, 150, 683, 118, 801
INVAR-27, Run: 018, F, 0, 91, 0, 834, 906, 893, 1799
INVAR-27, Run: 019, F, 0, 0, 91, 880, 2918, 848, 3766
INVAR-27, Run: 020, F, 0, 0, 91, 1815, 4609, 1783, 6392
INVAR-27, Run: 021, F, 0, 91, 0, 3078, 1776, 3137, 4913
INVAR-27, Run: 022, F, 0, 0, 91, 157, 1010, 125, 1135
INVAR-27, Run: 023, F, 0, 91, 0, 751, 462, 810, 1272
INVAR-27, Run: 024, F, 0, 0, 91, 292, 944, 260, 1204
INVAR-27, Run: 025, F, 0, 91, 0, 268, 239, 327, 566
INVAR-27, Run: 026, F, 0, 91, 0, 1768, 2579, 1827, 4406
INVAR-27, Run: 027, F, 0, 91, 0, 618, 219, 677, 896
INVAR-27, Run: 028, F, 0, 0, 91, 1145, 2811, 1113, 3924
INVAR-27, Run: 029, F, 0, 0, 91, 261, 786, 229, 1015
INVAR-27, Run: 030, F, 0, 0, 91, 1818, 3220, 1786, 5006
INVAR-27, Run: 031, F, 0, 0, 91, 482, 1158, 450, 1608
INVAR-27, Run: 032, F, 0, 0, 91, 666, 1922, 634, 2556
INVAR-27, Run: 033, F, 0, 0, 91, 553, 2819, 521, 3340
INVAR-27, Run: 034, F, 0, 91, 0, 891, 350, 950, 1300
INVAR-27, Run: 035, F, 0, 0, 91, 1417, 3244, 1385, 4629
INVAR-27, Run: 036, F, 0, 91, 0, 835, 237, 894, 1131
INVAR-27, Run: 037, F, 0, 0, 91, 1639, 4208, 1607, 5815
INVAR-27, Run: 038, F, 0, 91, 0, 1501, 1033, 1560, 2593
INVAR-27, Run: 039, F, 0, 0, 91, 521, 1208, 489, 1697
INVAR-27, Run: 040, F, 0, 0, 91, 175, 666, 143, 809
INVAR-27, Run: 041, F, 0, 0, 91, 1794, 2072, 1762, 3834
INVAR-27, Run: 042, F, 0, 91, 0, 2489, 1652, 2548, 4200
INVAR-27, Run: 043, F, 0, 0, 91, 974, 3838, 942, 4780
INVAR-27, Run: 044, F, 0, 91, 0, 979, 2139, 1038, 3177
INVAR-27, Run: 045, F, 0, 0, 91, 1355, 1389, 1323, 2712
INVAR-27, Run: 046, F, 0, 0, 91, 613, 2416, 581, 2997
INVAR-27, Run: 047, F, 0, 91, 0, 850, 479, 909, 1388
INVAR-27, Run: 048, F, 0, 0, 91, 1711, 3921, 1679, 5600
INVAR-27, Run: 049, F, 0, 0, 91, 959, 3452, 927, 4379
INVAR-27, Run: 050, F, 0, 91, 0, 943, 163, 1002, 1165
INVAR-27, Run: 051, F, 0, 0, 91, 712, 1414, 680, 2094
INVAR-27, Run: 052, F, 0, 91, 0, 953, 502, 1012, 1514
INVAR-27, Run: 053, F, 0, 0, 91, 137, 542, 105, 647
INVAR-27, Run: 054, F, 0, 0, 91, 179, 1199, 147, 1346
INVAR-27, Run: 055, F, 0, 0, 91, 2708, 2226, 2676, 4902
INVAR-27, Run: 056, F, 0, 0, 91, 217, 1497, 185, 1682
INVAR-27, Run: 057, F, 0, 0, 91, 2493, 2645, 2461, 5106
INVAR-27, Run: 058, F, 0, 0, 91, 201, 919, 169, 1088
INVAR-27, Run: 059, F, 0, 0, 91, 1315, 1845, 1283, 3128
INVAR-27, Run: 060, F, 0, 91, 0, 801, 343, 860, 1203
INVAR-27, Run: 061, F, 0, 0, 91, 996, 2123, 964, 3087
INVAR-27, Run: 062, F, 0, 91, 0, 1862, 1647, 1921, 3568
INVAR-27, Run: 063, F, 0, 0, 91, 351, 2502, 319, 2821
INVAR-27, Run: 064, F, 0, 0, 91, 531, 1551, 499, 2050
INVAR-27, Run: 065, F, 0, 0, 91, 339, 1061, 307, 1368
INVAR-27, Run: 066, F, 0, 0, 91, 1058, 2717, 1026, 3743
INVAR-27, Run: 067, F, 0, 0, 91, 460, 1229, 428, 1657
INVAR-27, Run: 068, F, 0, 0, 91, 1714, 3350, 1682, 5032
INVAR-27, Run: 069, F, 0, 0, 91, 619, 2440, 587, 3027
INVAR-27, Run: 070, F, 0, 0, 91, 134, 826, 102, 928
INVAR-27, Run: 071, F, 0, 91, 0, 3304, 2171, 3363, 5534
INVAR-27, Run: 072, F, 0, 0, 91, 560, 1163, 528, 1691
INVAR-27, Run: 073, F, 0, 91, 0, 653, 255, 712, 967
INVAR-27, Run: 074, F, 0, 0, 91, 1207, 1444, 1175, 2619
INVAR-27, Run: 075, F, 0, 0, 91, 226, 916, 194, 1110
INVAR-27, Run: 076, F, 0, 91, 0, 766, 290, 825, 1115
INVAR-27, Run: 077, F, 0, 0, 91, 2236, 4251, 2204, 6455
INVAR-27, Run: 078, F, 0, 91, 0, 193, 111, 252, 363
INVAR-27, Run: 079, F, 0, 91, 0, 1112, 517, 1171, 1688
INVAR-27, Run: 080, F, 0, 0, 91, 4297, 5243, 4265, 9508
INVAR-27, Run: 081, F, 0, 91, 0, 1820, 1665, 1879, 3544
INVAR-27, Run: 082, F, 0, 91, 0, 512, 427, 571, 998
INVAR-27, Run: 083, F, 0, 0, 91, 337, 1129, 305, 1434
INVAR-27, Run: 084, F, 0, 0, 91, 284, 1121, 252, 1373
INVAR-27, Run: 085, F, 0, 0, 91, 284, 1323, 252, 1575
INVAR-27, Run: 086, F, 0, 0, 91, 511, 2113, 479, 2592
INVAR-27, Run: 087, F, 0, 91, 0, 1250, 703, 1309, 2012
INVAR-27, Run: 088, F, 0, 0, 91, 552, 1124, 520, 1644
INVAR-27, Run: 089, F, 0, 91, 0, 392, 173, 451, 624
INVAR-27, Run: 090, F, 0, 0, 91, 1141, 1821, 1109, 2930
INVAR-27, Run: 091, F, 0, 0, 91, 686, 2354, 654, 3008
INVAR-27, Run: 092, F, 0, 91, 0, 4728, 3002, 4787, 7789
INVAR-27, Run: 093, F, 0, 91, 0, 435, 208, 494, 702
INVAR-27, Run: 094, F, 0, 91, 0, 117, 101, 176, 277
INVAR-27, Run: 095, F, 0, 0, 91, 203, 762, 171, 933
INVAR-27, Run: 096, F, 0, 0, 91, 1037, 1497, 1005, 2502
INVAR-27, Run: 097, F, 0, 0, 91, 1484, 2570, 1452, 4022
INVAR-27, Run: 098, F, 0, 0, 91, 495, 1255, 463, 1718
INVAR-27, Run: 099, F, 0, 0, 91, 362, 1369, 330, 1699
INVAR-27, Run: 100, F, 0, 0, 91, 928, 2751, 896, 3647
INVAR-28, Run: 001, F, 0, 0, 121, 124, 835, 90, 925
INVAR-28, Run: 002, F, 0, 0, 121, 1381, 3583, 1347, 4930
INVAR-28, Run: 003, F, 0, 0, 121, 262, 1367, 228, 1595
INVAR-28, Run: 004, F, 0, 0, 121, 533, 2312, 499, 2811
INVAR-28, Run: 005, F, 0, 121, 0, 1626, 1090, 1713, 2803
INVAR-28, Run: 006, F, 0, 0, 121, 803, 3072, 769, 3841
INVAR-28, Run: 007, F, 0, 0, 121, 578, 2911, 544, 3455
INVAR-28, Run: 008, F, 0, 0, 121, 133, 1078, 99, 1177
INVAR-28, Run: 009, F, 0, 0, 121, 135, 712, 101, 813
INVAR-28, Run: 010, F, 0, 121, 0, 2302, 1820, 2389, 4209
INVAR-28, Run: 011, F, 0, 121, 0, 3713, 5301, 3800, 9101
INVAR-28, Run: 012, F, 0, 0, 121, 2362, 8111, 2328, 10439
INVAR-28, Run: 013, F, 0, 121, 0, 562, 419, 649, 1068
INVAR-28, Run: 014, F, 0, 0, 121, 237, 1893, 203, 2096
INVAR-28, Run: 015, F, 0, 0, 121, 680, 4000, 646, 4646
INVAR-28, Run: 016, F, 0, 121, 0, 1707, 2023, 1794, 3817
INVAR-28, Run: 017, F, 0, 0, 121, 192, 1114, 158, 1272
INVAR-28, Run: 018, F, 0, 0, 121, 288, 718, 254, 972
INVAR-28, Run: 019, F, 0, 0, 121, 403, 968, 369, 1337
INVAR-28, Run: 020, F, 0, 0, 121, 2738, 3538, 2704, 6242
INVAR-28, Run: 021, F, 0, 0, 121, 256, 2340, 222, 2562
INVAR-28, Run: 022, F, 0, 0, 121, 650, 2645, 616, 3261
INVAR-28, Run: 023, F, 0, 0, 121, 465, 2487, 431, 2918
INVAR-28, Run: 024, F, 0, 121, 0, 1551, 1533, 1638, 3171
INVAR-28, Run: 025, F, 0, 0, 121, 365, 1401, 331, 1732
INVAR-28, Run: 026, F, 0, 121, 0, 6707, 5089, 6794, 11883
INVAR-28, Run: 027, F, 0, 0, 121, 4892, 4910, 4858, 9768
INVAR-28, Run: 028, F, 0, 0, 121, 185, 949, 151, 1100
INVAR-28, Run: 029, F, 0, 121, 0, 1155, 1032, 1242, 2274
INVAR-28, Run: 030, F, 0, 121, 0, 6670, 3435, 6757, 10192
INVAR-28, Run: 031, F, 0, 0, 121, 286, 955, 252, 1207
INVAR-28, Run: 032, F, 0, 0, 121, 1137, 1940, 1103, 3043
INVAR-28, Run: 033, F, 0, 0, 121, 335, 2206, 301, 2507
INVAR-28, Run: 034, F, 0, 0, 121, 204, 845, 170, 1015
INVAR-28, Run: 035, F, 0, 0, 121, 997, 1724, 963, 2687
INVAR-28, Run: 036, F, 0, 0, 121, 438, 1807, 404, 2211
INVAR-28, Run: 037, F, 0, 0, 121, 608, 3387, 574, 3961
INVAR-28, Run: 038, F, 0, 121, 0, 1002, 496, 1089, 1585
INVAR-28, Run: 039, F, 0, 121, 0, 1513, 1272, 1600, 2872
INVAR-28, Run: 040, F, 0, 0, 121, 415, 3564, 381, 3945
INVAR-28, Run: 041, F, 0, 0, 121, 2098, 3597, 2064, 5661
INVAR-28, Run: 042, F, 0, 0, 121, 743, 2594, 709, 3303
INVAR-28, Run: 043, F, 0, 121, 0, 4592, 4068, 4679, 8747
INVAR-28, Run: 044, F, 0, 121, 0, 1768, 759, 1855, 2614
INVAR-28, Run: 045, F, 0, 0, 121, 1095, 2601, 1061, 3662
INVAR-28, Run: 046, F, 0, 121, 0, 1099, 645, 1186, 1831
INVAR-28, Run: 047, F, 0, 0, 121, 677, 2094, 643, 2737
INVAR-28, Run: 048, F, 0, 121, 0, 1504, 2885, 1591, 4476
INVAR-28, Run: 049, F, 0, 121, 0, 5160, 6192, 5247, 11439
INVAR-28, Run: 050, F, 0, 0, 121, 156, 1289, 122, 1411
INVAR-28, Run: 051, F, 0, 0, 121, 675, 1453, 641, 2094
INVAR-28, Run: 052, F, 0, 0, 121, 1188, 6012, 1154, 7166
INVAR-28, Run: 053, F, 0, 121, 0, 4163, 5358, 4250, 9608
INVAR-28, Run: 054, F, 0, 0, 121, 437, 3006, 403, 3409
INVAR-28, Run: 055, F, 0, 0, 121, 771, 1408, 737, 2145
INVAR-28, Run: 056, F, 0, 0, 121, 407, 1763, 373, 2136
INVAR-28, Run: 057, F, 0, 0, 121, 2812, 6443, 2778, 9221
INVAR-28, Run: 058, F, 0, 0, 121, 253, 841, 219, 1060
INVAR-28, Run: 059, F, 0, 0, 121, 650, 2386, 616, 3002
INVAR-28, Run: 060, F, 0, 0, 121, 798, 2808, 764, 3572
INVAR-28, Run: 061, F, 0, 121, 0, 823, 451, 910, 1361
INVAR-28, Run: 062, F, 0, 121, 0, 860, 1138, 947, 2085
INVAR-28, Run: 063, F, 0, 0, 121, 317, 1892, 283, 2175
INVAR-28, Run: 064, F, 0, 0, 121, 477, 2724, 443, 3167
INVAR-28, Run: 065, F, 0, 0, 121, 389, 2170, 355, 2525
INVAR-28, Run: 066, F, 0, 0, 121, 186, 1273, 152, 1425
INVAR-28, Run: 067, F, 0, 0, 121, 2368, 7296, 2334, 9630
INVAR-28, Run: 068, F, 0, 121, 0, 964, 761, 1051, 1812
INVAR-28, Run: 069, F, 0, 121, 0, 1860, 1510, 1947, 3457
INVAR-28, Run: 070, F, 0, 0, 121, 1880, 6534, 1846, 8380
INVAR-28, Run: 071, F, 0, 0, 121, 1306, 2668, 1272, 3940
INVAR-28, Run: 072, F, 0, 121, 0, 3958, 3571, 4045, 7616
INVAR-28, Run: 073, F, 0, 0, 121, 579, 4339, 545, 4884
INVAR-28, Run: 074, F, 0, 0, 121, 429, 2502, 395, 2897
INVAR-28, Run: 075, F, 0, 0, 121, 3018, 3049, 2984, 6033
INVAR-28, Run: 076, F, 0, 0, 121, 1539, 2360, 1505, 3865
INVAR-28, Run: 077, F, 0, 121, 0, 825, 640, 912, 1552
INVAR-28, Run: 078, F, 0, 0, 121, 194, 1519, 160, 1679
INVAR-28, Run: 079, F, 0, 121, 0, 992, 871, 1079, 1950
INVAR-28, Run: 080, F, 0, 0, 121, 1790, 3787, 1756, 5543
INVAR-28, Run: 081, F, 0, 0, 121, 199, 1908, 165, 2073
INVAR-28, Run: 082, F, 0, 0, 121, 276, 1902, 242, 2144
INVAR-28, Run: 083, F, 0, 121, 0, 554, 683, 641, 1324
INVAR-28, Run: 084, F, 0, 0, 121, 856, 4444, 822, 5266
INVAR-28, Run: 085, F, 0, 0, 121, 350, 941, 316, 1257
INVAR-28, Run: 086, F, 0, 121, 0, 4643, 3245, 4730, 7975
INVAR-28, Run: 087, F, 0, 121, 0, 7158, 8129, 7245, 15374
INVAR-28, Run: 088, F, 0, 0, 121, 1202, 3670, 1168, 4838
INVAR-28, Run: 089, F, 0, 0, 121, 467, 2282, 433, 2715
INVAR-28, Run: 090, F, 0, 0, 121, 1036, 1911, 1002, 2913
INVAR-28, Run: 091, F, 0, 0, 121, 618, 1831, 584, 2415
INVAR-28, Run: 092, F, 0, 0, 121, 678, 2102, 644, 2746
INVAR-28, Run: 093, F, 0, 0, 121, 413, 2520, 379, 2899
INVAR-28, Run: 094, F, 0, 121, 0, 2172, 1269, 2259, 3528
INVAR-28, Run: 095, F, 0, 121, 0, 892, 423, 979, 1402
INVAR-28, Run: 096, F, 0, 0, 121, 603, 1506, 569, 2075
INVAR-28, Run: 097, F, 0, 0, 121, 1346, 4110, 1312, 5422
INVAR-28, Run: 098, F, 0, 121, 0, 1675, 3542, 1762, 5304
INVAR-28, Run: 099, F, 0, 0, 121, 484, 2425, 450, 2875
INVAR-28, Run: 100, F, 0, 0, 121, 1532, 6277, 1498, 7775
INVAR-29, Run: 001, F, 0, 0, 28, 125, 135, 114, 249
INVAR-29, Run: 002, F, 0, 0, 28, 82, 250, 71, 321
INVAR-29, Run: 003, F, 0, 0, 28, 81, 174, 70, 244
INVAR-29, Run: 004, F, 0, 28, 0, 53, 24, 70, 94
INVAR-29, Run: 005, F, 0, 0, 28, 30, 146, 19, 165
INVAR-29, Run: 006, F, 0, 0, 28, 49, 52, 38, 90
INVAR-29, Run: 007, F, 0, 0, 28, 140, 147, 129, 276
INVAR-29, Run: 008, F, 0, 28, 0, 101, 50, 118, 168
INVAR-29, Run: 009, F, 0, 28, 0, 274, 131, 291, 422
INVAR-29, Run: 010, F, 0, 0, 28, 20, 113, 9, 122
INVAR-29, Run: 011, F, 0, 0, 28, 69, 156, 58, 214
INVAR-29, Run: 012, F, 0, 0, 28, 235, 266, 224, 490
INVAR-29, Run: 013, F, 0, 0, 28, 46, 128, 35, 163
INVAR-29, Run: 014, F, 0, 0, 28, 14, 65, 3, 68
INVAR-29, Run: 015, F, 0, 0, 28, 20, 37, 9, 46
INVAR-29, Run: 016, F, 0, 0, 28, 28, 155, 17, 172
INVAR-29, Run: 017, F, 0, 0, 28, 119, 173, 108, 281
INVAR-29, Run: 018, F, 0, 0, 28, 175, 207, 164, 371
INVAR-29, Run: 019, F, 0, 0, 28, 61, 218, 50, 268
INVAR-29, Run: 020, F, 0, 28, 0, 210, 232, 227, 459
INVAR-29, Run: 021, F, 0, 28, 0, 63, 29, 80, 109
INVAR-29, Run: 022, F, 0, 28, 0, 53, 20, 70, 90
INVAR-29, Run: 023, F, 0, 0, 28, 79, 356, 68, 424
INVAR-29, Run: 024, F, 0, 0, 28, 36, 125, 25, 150
INVAR-29, Run: 025, F, 0, 28, 0, 21, 10, 38, 48
INVAR-29, Run: 026, F, 0, 0, 28, 181, 287, 170, 457
INVAR-29, Run: 027, F, 0, 28, 0, 56, 48, 73, 121
INVAR-29, Run: 028, F, 0, 28, 0, 101, 132, 118, 250
INVAR-29, Run: 029, F, 0, 0, 28, 125, 189, 114, 303
INVAR-29, Run: 030, F, 0, 0, 28, 77, 227, 66, 293
INVAR-29, Run: 031, F, 0, 0, 28, 40, 98, 29, 127
INVAR-29, Run: 032, F, 0, 0, 28, 17, 41, 6, 47
INVAR-29, Run: 033, F, 0, 28, 0, 86, 78, 103, 181
INVAR-29, Run: 034, F, 0, 28, 0, 50, 13, 67, 80
INVAR-29, Run: 035, F, 0, 0, 28, 222, 388, 211, 599
INVAR-29, Run: 036, F, 0, 0, 28, 33, 157, 22, 179
INVAR-29, Run: 037, F, 0, 28, 0, 109, 52, 126, 178
INVAR-29, Run: 038, F, 0, 28, 0, 105, 80, 122, 202
INVAR-29, Run: 039, F, 0, 0, 28, 22, 49, 11, 60
INVAR-29, Run: 040, F, 0, 0, 28, 40, 73, 29, 102
INVAR-29, Run: 041, F, 0, 28, 0, 52, 37, 69, 106
INVAR-29, Run: 042, F, 0, 0, 28, 54, 147, 43, 190
INVAR-29, Run: 043, F, 0, 0, 28, 35, 127, 24, 151
INVAR-29, Run: 044, F, 0, 0, 28, 33, 112, 22, 134
INVAR-29, Run: 045, F, 0, 0, 28, 229, 301, 218, 519
INVAR-29, Run: 046, F, 0, 0, 28, 197, 230, 186, 416
INVAR-29, Run: 047, F, 0, 28, 0, 45, 18, 62, 80
INVAR-29, Run: 048, F, 0, 0, 28, 17, 69, 6, 75
INVAR-29, Run: 049, F, 0, 0, 28, 108, 285, 97, 382
INVAR-29, Run: 050, F, 0, 0, 28, 63, 91, 52, 143
INVAR-29, Run: 051, F, 0, 28, 0, 151, 58, 168, 226
INVAR-29, Run: 052, F, 0, 28, 0, 163, 72, 180, 252
INVAR-29, Run: 053, F, 0, 0, 28, 37, 107, 26, 133
INVAR-29, Run: 054, F, 0, 28, 0, 129, 172, 146, 318
INVAR-29, Run: 055, F, 0, 28, 0, 29, 16, 46, 62
INVAR-29, Run: 056, F, 0, 0, 28, 22, 60, 11, 71
INVAR-29, Run: 057, F, 0, 0, 28, 18, 89, 7, 96
INVAR-29, Run: 058, F, 0, 28, 0, 108, 64, 125, 189
INVAR-29, Run: 059, F, 0, 28, 0, 81, 23, 98, 121
INVAR-29, Run: 060, F, 0, 0, 28, 61, 89, 50, 139
INVAR-29, Run: 061, F, 0, 28, 0, 258, 249, 275, 524
INVAR-29, Run: 062, F, 0, 0, 28, 91, 147, 80, 227
INVAR-29, Run: 063, F, 0, 28, 0, 64, 60, 81, 141
INVAR-29, Run: 064, F, 0, 28, 0, 135, 57, 152, 209
INVAR-29, Run: 065, F, 0, 0, 28, 87, 128, 76, 204
INVAR-29, Run: 066, F, 0, 28, 0, 113, 103, 130, 233
INVAR-29, Run: 067, F, 0, 0, 28, 69, 101, 58, 159
INVAR-29, Run: 068, F, 0, 0, 28, 190, 181, 179, 360
INVAR-29, Run: 069, F, 0, 28, 0, 53, 55, 70, 125
INVAR-29, Run: 070, F, 0, 0, 28, 94, 150, 83, 233
INVAR-29, Run: 071, F, 0, 0, 28, 307, 586, 296, 882
INVAR-29, Run: 072, F, 0, 28, 0, 174, 142, 191, 333
INVAR-29, Run: 073, F, 0, 0, 28, 85, 114, 74, 188
INVAR-29, Run: 074, F, 0, 0, 28, 43, 108, 32, 140
INVAR-29, Run: 075, F, 0, 0, 28, 17, 33, 6, 39
INVAR-29, Run: 076, F, 0, 0, 28, 80, 212, 69, 281
INVAR-29, Run: 077, F, 0, 0, 28, 106, 279, 95, 374
INVAR-29, Run: 078, F, 0, 0, 28, 44, 182, 33, 215
INVAR-29, Run: 079, F, 0, 28, 0, 177, 96, 194, 290
INVAR-29, Run: 080, F, 0, 0, 28, 165, 193, 154, 347
INVAR-29, Run: 081, F, 0, 0, 28, 202, 191, 191, 382
INVAR-29, Run: 082, F, 0, 0, 28, 18, 61, 7, 68
INVAR-29, Run: 083, F, 0, 28, 0, 45, 20, 62, 82
INVAR-29, Run: 084, F, 0, 28, 0, 17, 5, 34, 39
INVAR-29, Run: 085, F, 0, 0, 28, 90, 217, 79, 296
INVAR-29, Run: 086, F, 0, 0, 28, 181, 268, 170, 438
INVAR-29, Run: 087, F, 0, 28, 0, 97, 54, 114, 168
INVAR-29, Run: 088, F, 0, 28, 0, 162, 144, 179, 323
INVAR-29, Run: 089, F, 0, 0, 28, 83, 327, 72, 399
INVAR-29, Run: 090, F, 0, 28, 0, 81, 49, 98, 147
INVAR-29, Run: 091, F, 0, 0, 28, 154, 293, 143, 436
INVAR-29, Run: 092, F, 0, 0, 28, 33, 81, 22, 103
INVAR-29, Run: 093, F, 0, 28, 0, 104, 103, 121, 224
INVAR-29, Run: 094, F, 0, 28, 0, 115, 71, 132, 203
INVAR-29, Run: 095, F, 0, 28, 0, 96, 97, 113, 210
INVAR-29, Run: 096, F, 0, 0, 28, 58, 114, 47, 161
INVAR-29, Run: 097, F, 0, 0, 28, 52, 94, 41, 135
INVAR-29, Run: 098, F, 0, 0, 28, 141, 276, 130, 406
INVAR-29, Run: 099, F, 0, 28, 0, 96, 160, 113, 273
INVAR-29, Run: 100, F, 0, 28, 0, 65, 28, 82, 110
INVAR-3, Run: 001, F, 0, 0, 23, 206, 175, 195, 370
INVAR-3, Run: 002, F, 0, 23, 0, 46, 14, 58, 72
INVAR-3, Run: 003, F, 0, 23, 0, 171, 133, 183, 316
INVAR-3, Run: 004, F, 0, 0, 23, 56, 88, 45, 133
INVAR-3, Run: 005, F, 0, 0, 23, 176, 134, 165, 299
INVAR-3, Run: 006, F, 0, 0, 23, 53, 68, 42, 110
INVAR-3, Run: 007, F, 0, 0, 23, 30, 58, 19, 77
INVAR-3, Run: 008, F, 0, 0, 23, 256, 468, 245, 713
INVAR-3, Run: 009, F, 0, 23, 0, 11, 10, 23, 33
INVAR-3, Run: 010, F, 0, 23, 0, 21, 2, 33, 35
INVAR-3, Run: 011, F, 0, 23, 0, 16, 4, 28, 32
INVAR-3, Run: 012, F, 0, 23, 0, 25, 27, 37, 64
INVAR-3, Run: 013, F, 0, 0, 23, 91, 199, 80, 279
INVAR-3, Run: 014, F, 0, 23, 0, 7, 2, 19, 21
INVAR-3, Run: 015, F, 0, 23, 0, 113, 90, 125, 215
INVAR-3, Run: 016, F, 0, 0, 23, 59, 148, 48, 196
INVAR-3, Run: 017, F, 0, 23, 0, 80, 38, 92, 130
INVAR-3, Run: 018, F, 0, 23, 0, 119, 53, 131, 184
INVAR-3, Run: 019, F, 0, 23, 0, 114, 26, 126, 152
INVAR-3, Run: 020, F, 0, 0, 23, 22, 40, 11, 51
INVAR-3, Run: 021, F, 0, 23, 0, 50, 77, 62, 139
INVAR-3, Run: 022, F, 0, 0, 23, 29, 46, 18, 64
INVAR-3, Run: 023, F, 0, 23, 0, 38, 16, 50, 66
INVAR-3, Run: 024, F, 0, 23, 0, 45, 17, 57, 74
INVAR-3, Run: 025, F, 0, 0, 23, 76, 86, 65, 151
INVAR-3, Run: 026, F, 0, 0, 23, 71, 85, 60, 145
INVAR-3, Run: 027, F, 0, 0, 23, 102, 339, 91, 430
INVAR-3, Run: 028, F, 0, 23, 0, 99, 43, 111, 154
INVAR-3, Run: 029, F, 0, 0, 23, 36, 115, 25, 140
INVAR-3, Run: 030, F, 0, 23, 0, 162, 149, 174, 323
INVAR-3, Run: 031, F, 0, 0, 23, 64, 120, 53, 173
INVAR-3, Run: 032, F, 0, 23, 0, 66, 20, 78, 98
INVAR-3, Run: 033, F, 0, 0, 23, 79, 207, 68, 275
INVAR-3, Run: 034, F, 0, 0, 23, 29, 58, 18, 76
INVAR-3, Run: 035, F, 0, 0, 23, 46, 145, 35, 180
INVAR-3, Run: 036, F, 0, 0, 23, 53, 123, 42, 165
INVAR-3, Run: 037, F, 0, 23, 0, 62, 47, 74, 121
INVAR-3, Run: 038, F, 0, 23, 0, 55, 17, 67, 84
INVAR-3, Run: 039, F, 0, 23, 0, 20, 14, 32, 46
INVAR-3, Run: 040, F, 0, 0, 23, 139, 295, 128, 423
INVAR-3, Run: 041, F, 0, 23, 0, 38, 29, 50, 79
INVAR-3, Run: 042, F, 0, 23, 0, 42, 37, 54, 91
INVAR-3, Run: 043, F, 0, 0, 23, 47, 43, 36, 79
INVAR-3, Run: 044, F, 0, 23, 0, 82, 59, 94, 153
INVAR-3, Run: 045, F, 0, 23, 0, 210, 69, 222, 291
INVAR-3, Run: 046, F, 0, 0, 23, 30, 75, 19, 94
INVAR-3, Run: 047, F, 0, 0, 23, 42, 83, 31, 114
INVAR-3, Run: 048, F, 0, 0, 23, 16, 20, 5, 25
INVAR-3, Run: 049, F, 0, 0, 23, 56, 150, 45, 195
INVAR-3, Run: 050, F, 0, 23, 0, 44, 34, 56, 90
INVAR-3, Run: 051, F, 0, 0, 23, 54, 83, 43, 126
INVAR-3, Run: 052, F, 0, 23, 0, 82, 46, 94, 140
INVAR-3, Run: 053, F, 0, 23, 0, 52, 24, 64, 88
INVAR-3, Run: 054, F, 0, 0, 23, 74, 73, 63, 136
INVAR-3, Run: 055, F, 0, 0, 23, 35, 160, 24, 184
INVAR-3, Run: 056, F, 0, 0, 23, 49, 63, 38, 101
INVAR-3, Run: 057, F, 0, 23, 0, 126, 72, 138, 210
INVAR-3, Run: 058, F, 0, 23, 0, 85, 45, 97, 142
INVAR-3, Run: 059, F, 0, 23, 0, 113, 36, 125, 161
INVAR-3, Run: 060, F, 0, 23, 0, 24, 6, 36, 42
INVAR-3, Run: 061, F, 0, 23, 0, 16, 2, 28, 30
INVAR-3, Run: 062, F, 0, 0, 23, 61, 98, 50, 148
INVAR-3, Run: 063, F, 0, 0, 23, 106, 150, 95, 245
INVAR-3, Run: 064, F, 0, 0, 23, 28, 65, 17, 82
INVAR-3, Run: 065, F, 0, 23, 0, 29, 8, 41, 49
INVAR-3, Run: 066, F, 0, 0, 23, 49, 59, 38, 97
INVAR-3, Run: 067, F, 0, 0, 23, 107, 166, 96, 262
INVAR-3, Run: 068, F, 0, 23, 0, 28, 5, 40, 45
INVAR-3, Run: 069, F, 0, 0, 23, 53, 206, 42, 248
INVAR-3, Run: 070, F, 0, 23, 0, 18, 5, 30, 35
INVAR-3, Run: 071, F, 0, 0, 23, 37, 79, 26, 105
INVAR-3, Run: 072, F, 0, 0, 23, 52, 161, 41, 202
INVAR-3, Run: 073, F, 0, 23, 0, 32, 15, 44, 59
INVAR-3, Run: 074, F, 0, 0, 23, 153, 404, 142, 546
INVAR-3, Run: 075, F, 0, 23, 0, 107, 47, 119, 166
INVAR-3, Run: 076, F, 0, 0, 23, 162, 119, 151, 270
INVAR-3, Run: 077, F, 0, 23, 0, 38, 38, 50, 88
INVAR-3, Run: 078, F, 0, 23, 0, 12, 8, 24, 32
INVAR-3, Run: 079, F, 0, 23, 0, 114, 98, 126, 224
INVAR-3, Run: 080, F, 0, 23, 0, 57, 9, 69, 78
INVAR-3, Run: 081, F, 0, 23, 0, 36, 7, 48, 55
INVAR-3, Run: 082, F, 0, 23, 0, 174, 90, 186, 276
INVAR-3, Run: 083, F, 0, 0, 23, 163, 187, 152, 339
INVAR-3, Run: 084, F, 0, 23, 0, 87, 28, 99, 127
INVAR-3, Run: 085, F, 0, 23, 0, 50, 36, 62, 98
INVAR-3, Run: 086, F, 0, 0, 23, 168, 150, 157, 307
INVAR-3, Run: 087, F, 0, 0, 23, 30, 142, 19, 161
INVAR-3, Run: 088, F, 0, 23, 0, 250, 288, 262, 550
INVAR-3, Run: 089, F, 0, 0, 23, 148, 294, 137, 431
INVAR-3, Run: 090, F, 0, 23, 0, 53, 32, 65, 97
INVAR-3, Run: 091, F, 0, 0, 23, 23, 77, 12, 89
INVAR-3, Run: 092, F, 0, 0, 23, 293, 142, 282, 424
INVAR-3, Run: 093, F, 0, 23, 0, 71, 86, 83, 169
INVAR-3, Run: 094, F, 0, 23, 0, 6, 1, 18, 19
INVAR-3, Run: 095, F, 0, 23, 0, 12, 8, 24, 32
INVAR-3, Run: 096, F, 0, 0, 23, 37, 66, 26, 92
INVAR-3, Run: 097, F, 0, 23, 0, 13, 7, 25, 32
INVAR-3, Run: 098, F, 0, 0, 23, 67, 87, 56, 143
INVAR-3, Run: 099, F, 0, 23, 0, 79, 23, 91, 114
INVAR-3, Run: 100, F, 0, 0, 23, 110, 80, 99, 179
INVAR-30, Run: 001, F, 0, 0, 68, 460, 1375, 443, 1818
INVAR-30, Run: 002, F, 0, 0, 68, 146, 766, 129, 895
INVAR-30, Run: 003, F, 0, 0, 68, 41, 254, 24, 278
INVAR-30, Run: 004, F, 0, 68, 0, 311, 349, 362, 711
INVAR-30, Run: 005, F, 0, 0, 68, 295, 1083, 278, 1361
INVAR-30, Run: 006, F, 0, 0, 68, 195, 734, 178, 912
INVAR-30, Run: 007, F, 0, 0, 68, 73, 409, 56, 465
INVAR-30, Run: 008, F, 0, 0, 68, 118, 1015, 101, 1116
INVAR-30, Run: 009, F, 0, 0, 68, 750, 2340, 733, 3073
INVAR-30, Run: 010, F, 0, 0, 68, 188, 676, 171, 847
INVAR-30, Run: 011, F, 0, 68, 0, 213, 194, 264, 458
INVAR-30, Run: 012, F, 0, 68, 0, 2526, 4409, 2577, 6986
INVAR-30, Run: 013, F, 0, 0, 68, 395, 1753, 378, 2131
INVAR-30, Run: 014, F, 0, 0, 68, 110, 666, 93, 759
INVAR-30, Run: 015, F, 0, 0, 68, 215, 1140, 198, 1338
INVAR-30, Run: 016, F, 0, 0, 68, 346, 1327, 329, 1656
INVAR-30, Run: 017, F, 0, 0, 68, 137, 801, 120, 921
INVAR-30, Run: 018, F, 0, 0, 68, 35, 93, 18, 111
INVAR-30, Run: 019, F, 0, 0, 68, 173, 523, 156, 679
INVAR-30, Run: 020, F, 0, 68, 0, 1001, 1550, 1052, 2602
INVAR-30, Run: 021, F, 0, 68, 0, 1301, 2026, 1352, 3378
INVAR-30, Run: 022, F, 0, 0, 68, 880, 1594, 863, 2457
INVAR-30, Run: 023, F, 0, 68, 0, 871, 589, 922, 1511
INVAR-30, Run: 024, F, 0, 0, 68, 64, 559, 47, 606
INVAR-30, Run: 025, F, 0, 0, 68, 145, 785, 128, 913
INVAR-30, Run: 026, F, 0, 68, 0, 634, 522, 685, 1207
INVAR-30, Run: 027, F, 0, 0, 68, 294, 637, 277, 914
INVAR-30, Run: 028, F, 0, 68, 0, 358, 155, 409, 564
INVAR-30, Run: 029, F, 0, 0, 68, 254, 404, 237, 641
INVAR-30, Run: 030, F, 0, 0, 68, 40, 217, 23, 240
INVAR-30, Run: 031, F, 0, 0, 68, 781, 1850, 764, 2614
INVAR-30, Run: 032, F, 0, 68, 0, 756, 506, 807, 1313
INVAR-30, Run: 033, F, 0, 68, 0, 560, 235, 611, 846
INVAR-30, Run: 034, F, 0, 0, 68, 88, 371, 71, 442
INVAR-30, Run: 035, F, 0, 68, 0, 1042, 550, 1093, 1643
INVAR-30, Run: 036, F, 0, 68, 0, 539, 254, 590, 844
INVAR-30, Run: 037, F, 0, 68, 0, 670, 499, 721, 1220
INVAR-30, Run: 038, F, 0, 0, 68, 288, 961, 271, 1232
INVAR-30, Run: 039, F, 0, 0, 68, 916, 1088, 899, 1987
INVAR-30, Run: 040, F, 0, 0, 68, 236, 735, 219, 954
INVAR-30, Run: 041, F, 0, 0, 68, 645, 1448, 628, 2076
INVAR-30, Run: 042, F, 0, 0, 68, 749, 2424, 732, 3156
INVAR-30, Run: 043, F, 0, 0, 68, 109, 928, 92, 1020
INVAR-30, Run: 044, F, 0, 0, 68, 52, 265, 35, 300
INVAR-30, Run: 045, F, 0, 0, 68, 65, 262, 48, 310
INVAR-30, Run: 046, F, 0, 68, 0, 365, 155, 416, 571
INVAR-30, Run: 047, F, 0, 68, 0, 356, 599, 407, 1006
INVAR-30, Run: 048, F, 0, 68, 0, 270, 165, 321, 486
INVAR-30, Run: 049, F, 0, 0, 68, 112, 554, 95, 649
INVAR-30, Run: 050, F, 0, 68, 0, 352, 410, 403, 813
INVAR-30, Run: 051, F, 0, 0, 68, 215, 1261, 198, 1459
INVAR-30, Run: 052, F, 0, 68, 0, 1027, 1249, 1078, 2327
INVAR-30, Run: 053, F, 0, 0, 68, 205, 599, 188, 787
INVAR-30, Run: 054, F, 0, 0, 68, 357, 770, 340, 1110
INVAR-30, Run: 055, F, 0, 68, 0, 624, 379, 675, 1054
INVAR-30, Run: 056, F, 0, 68, 0, 607, 235, 658, 893
INVAR-30, Run: 057, F, 0, 0, 68, 167, 579, 150, 729
INVAR-30, Run: 058, F, 0, 0, 68, 1117, 2894, 1100, 3994
INVAR-30, Run: 059, F, 0, 0, 68, 321, 697, 304, 1001
INVAR-30, Run: 060, F, 0, 68, 0, 427, 301, 478, 779
INVAR-30, Run: 061, F, 0, 0, 68, 71, 594, 54, 648
INVAR-30, Run: 062, F, 0, 0, 68, 68, 193, 51, 244
INVAR-30, Run: 063, F, 0, 0, 68, 159, 645, 142, 787
INVAR-30, Run: 064, F, 0, 0, 68, 117, 451, 100, 551
INVAR-30, Run: 065, F, 0, 68, 0, 1662, 907, 1713, 2620
INVAR-30, Run: 066, F, 0, 0, 68, 1495, 4170, 1478, 5648
INVAR-30, Run: 067, F, 0, 68, 0, 539, 325, 590, 915
INVAR-30, Run: 068, F, 0, 0, 68, 53, 275, 36, 311
INVAR-30, Run: 069, F, 0, 68, 0, 712, 707, 763, 1470
INVAR-30, Run: 070, F, 0, 0, 68, 121, 793, 104, 897
INVAR-30, Run: 071, F, 0, 0, 68, 567, 940, 550, 1490
INVAR-30, Run: 072, F, 0, 68, 0, 433, 217, 484, 701
INVAR-30, Run: 073, F, 0, 68, 0, 967, 1337, 1018, 2355
INVAR-30, Run: 074, F, 0, 68, 0, 475, 208, 526, 734
INVAR-30, Run: 075, F, 0, 0, 68, 177, 929, 160, 1089
INVAR-30, Run: 076, F, 0, 0, 68, 91, 1136, 74, 1210
INVAR-30, Run: 077, F, 0, 0, 68, 642, 963, 625, 1588
INVAR-30, Run: 078, F, 0, 0, 68, 1113, 1161, 1096, 2257
INVAR-30, Run: 079, F, 0, 0, 68, 258, 820, 241, 1061
INVAR-30, Run: 080, F, 0, 0, 68, 283, 619, 266, 885
INVAR-30, Run: 081, F, 0, 0, 68, 76, 869, 59, 928
INVAR-30, Run: 082, F, 0, 0, 68, 68, 906, 51, 957
INVAR-30, Run: 083, F, 0, 0, 68, 446, 712, 429, 1141
INVAR-30, Run: 084, F, 0, 0, 68, 218, 767, 201, 968
INVAR-30, Run: 085, F, 0, 0, 68, 1241, 1710, 1224, 2934
INVAR-30, Run: 086, F, 0, 68, 0, 1102, 2547, 1153, 3700
INVAR-30, Run: 087, F, 0, 0, 68, 27, 274, 10, 284
INVAR-30, Run: 088, F, 0, 0, 68, 1227, 1013, 1210, 2223
INVAR-30, Run: 089, F, 0, 0, 68, 521, 898, 504, 1402
INVAR-30, Run: 090, F, 0, 0, 68, 604, 1272, 587, 1859
INVAR-30, Run: 091, F, 0, 0, 68, 486, 1986, 469, 2455
INVAR-30, Run: 092, F, 0, 0, 68, 35, 228, 18, 246
INVAR-30, Run: 093, F, 0, 0, 68, 32, 182, 15, 197
INVAR-30, Run: 094, F, 0, 0, 68, 186, 1521, 169, 1690
INVAR-30, Run: 095, F, 0, 0, 68, 61, 432, 44, 476
INVAR-30, Run: 096, F, 0, 0, 68, 197, 1053, 180, 1233
INVAR-30, Run: 097, F, 0, 0, 68, 310, 1105, 293, 1398
INVAR-30, Run: 098, F, 0, 0, 68, 177, 562, 160, 722
INVAR-30, Run: 099, F, 0, 0, 68, 761, 862, 744, 1606
INVAR-30, Run: 100, F, 0, 0, 68, 229, 528, 212, 740
INVAR-31, Run: 001, F, 0, 0, 142, 668, 2862, 647, 3509
INVAR-31, Run: 002, F, 0, 0, 142, 981, 4160, 960, 5120
INVAR-31, Run: 003, F, 0, 0, 142, 5864, 9501, 5843, 15344
INVAR-31, Run: 004, F, 0, 0, 142, 116, 1259, 95, 1354
INVAR-31, Run: 005, F, 0, 0, 142, 455, 1706, 434, 2140
INVAR-31, Run: 006, F, 0, 0, 142, 393, 1426, 372, 1798
INVAR-31, Run: 007, F, 0, 0, 142, 137, 2649, 116, 2765
INVAR-31, Run: 008, F, 0, 142, 0, 3127, 5982, 3248, 9230
INVAR-31, Run: 009, F, 0, 142, 0, 1329, 1241, 1450, 2691
INVAR-31, Run: 010, F, 0, 142, 0, 832, 842, 953, 1795
INVAR-31, Run: 011, F, 0, 0, 142, 165, 1939, 144, 2083
INVAR-31, Run: 012, F, 0, 0, 142, 1077, 2751, 1056, 3807
INVAR-31, Run: 013, F, 0, 0, 142, 1040, 6548, 1019, 7567
INVAR-31, Run: 014, F, 0, 0, 142, 4587, 14342, 4566, 18908
INVAR-31, Run: 015, F, 0, 0, 142, 97, 983, 76, 1059
INVAR-31, Run: 016, F, 0, 142, 0, 1841, 1100, 1962, 3062
INVAR-31, Run: 017, F, 0, 0, 142, 87, 783, 66, 849
INVAR-31, Run: 018, F, 0, 0, 142, 903, 3659, 882, 4541
INVAR-31, Run: 019, F, 0, 0, 142, 155, 1739, 134, 1873
INVAR-31, Run: 020, F, 0, 0, 142, 206, 1966, 185, 2151
INVAR-31, Run: 021, F, 0, 0, 142, 296, 1617, 275, 1892
INVAR-31, Run: 022, F, 0, 0, 142, 1824, 4275, 1803, 6078
INVAR-31, Run: 023, F, 0, 0, 142, 60, 1066, 39, 1105
INVAR-31, Run: 024, F, 0, 0, 142, 55, 585, 34, 619
INVAR-31, Run: 025, F, 0, 0, 142, 226, 2288, 205, 2493
INVAR-31, Run: 026, F, 0, 0, 142, 195, 3386, 174, 3560
INVAR-31, Run: 027, F, 0, 0, 142, 891, 3947, 870, 4817
INVAR-31, Run: 028, F, 0, 0, 142, 65, 572, 44, 616
INVAR-31, Run: 029, F, 0, 0, 142, 4208, 13219, 4187, 17406
INVAR-31, Run: 030, F, 0, 0, 142, 298, 3559, 277, 3836
INVAR-31, Run: 031, F, 0, 0, 142, 809, 5544, 788, 6332
INVAR-31, Run: 032, F, 0, 142, 0, 5728, 6280, 5849, 12129
INVAR-31, Run: 033, F, 0, 0, 142, 64, 1028, 43, 1071
INVAR-31, Run: 034, F, 0, 142, 0, 3079, 1941, 3200, 5141
INVAR-31, Run: 035, F, 0, 0, 142, 365, 1599, 344, 1943
INVAR-31, Run: 036, F, 0, 142, 0, 3887, 3002, 4008, 7010
INVAR-31, Run: 037, F, 0, 142, 0, 4128, 3155, 4249, 7404
INVAR-31, Run: 038, F, 0, 0, 142, 1323, 4426, 1302, 5728
INVAR-31, Run: 039, F, 0, 0, 142, 483, 4707, 462, 5169
INVAR-31, Run: 040, F, 0, 0, 142, 357, 2866, 336, 3202
INVAR-31, Run: 041, F, 0, 0, 142, 788, 5901, 767, 6668
INVAR-31, Run: 042, F, 0, 0, 142, 366, 4092, 345, 4437
INVAR-31, Run: 043, F, 0, 0, 142, 239, 1997, 218, 2215
INVAR-31, Run: 044, F, 0, 0, 142, 2487, 4973, 2466, 7439
INVAR-31, Run: 045, F, 0, 0, 142, 409, 2101, 388, 2489
INVAR-31, Run: 046, F, 0, 0, 142, 894, 3103, 873, 3976
INVAR-31, Run: 047, F, 0, 142, 0, 2177, 2791, 2298, 5089
INVAR-31, Run: 048, F, 0, 0, 142, 678, 3713, 657, 4370
INVAR-31, Run: 049, F, 0, 0, 142, 98, 1892, 77, 1969
INVAR-31, Run: 050, F, 0, 0, 142, 479, 2709, 458, 3167
INVAR-31, Run: 051, F, 0, 142, 0, 4499, 7957, 4620, 12577
INVAR-31, Run: 052, F, 0, 0, 142, 298, 3573, 277, 3850
INVAR-31, Run: 053, F, 0, 0, 142, 301, 1323, 280, 1603
INVAR-31, Run: 054, F, 0, 0, 142, 5444, 8424, 5423, 13847
INVAR-31, Run: 055, F, 0, 0, 142, 486, 2601, 465, 3066
INVAR-31, Run: 056, F, 0, 0, 142, 1423, 3730, 1402, 5132
INVAR-31, Run: 057, F, 0, 0, 142, 240, 1787, 219, 2006
INVAR-31, Run: 058, F, 0, 0, 142, 271, 1998, 250, 2248
INVAR-31, Run: 059, F, 0, 0, 142, 43, 527, 22, 549
INVAR-31, Run: 060, F, 0, 0, 142, 1784, 3735, 1763, 5498
INVAR-31, Run: 061, F, 0, 0, 142, 889, 3129, 868, 3997
INVAR-31, Run: 062, F, 0, 0, 142, 262, 4044, 241, 4285
INVAR-31, Run: 063, F, 0, 0, 142, 75, 962, 54, 1016
INVAR-31, Run: 064, F, 0, 0, 142, 244, 1473, 223, 1696
INVAR-31, Run: 065, F, 0, 0, 142, 1591, 4310, 1570, 5880
INVAR-31, Run: 066, F, 0, 0, 142, 1748, 4452, 1727, 6179
INVAR-31, Run: 067, F, 0, 0, 142, 6527, 8790, 6506, 15296
INVAR-31, Run: 068, F, 0, 0, 142, 152, 2728, 131, 2859
INVAR-31, Run: 069, F, 0, 0, 142, 644, 2565, 623, 3188
INVAR-31, Run: 070, F, 0, 0, 142, 271, 2214, 250, 2464
INVAR-31, Run: 071, F, 0, 0, 142, 492, 3142, 471, 3613
INVAR-31, Run: 072, F, 0, 0, 142, 279, 4948, 258, 5206
INVAR-31, Run: 073, F, 0, 0, 142, 111, 976, 90, 1066
INVAR-31, Run: 074, F, 0, 0, 142, 1123, 5867, 1102, 6969
INVAR-31, Run: 075, F, 0, 0, 142, 2210, 6431, 2189, 8620
INVAR-31, Run: 076, F, 0, 0, 142, 210, 1512, 189, 1701
INVAR-31, Run: 077, F, 0, 142, 0, 2623, 3898, 2744, 6642
INVAR-31, Run: 078, F, 0, 0, 142, 1409, 7469, 1388, 8857
INVAR-31, Run: 079, F, 0, 142, 0, 768, 620, 889, 1509
INVAR-31, Run: 080, F, 0, 0, 142, 147, 2884, 126, 3010
INVAR-31, Run: 081, F, 0, 142, 0, 2165, 3591, 2286, 5877
INVAR-31, Run: 082, F, 0, 0, 142, 1392, 5777, 1371, 7148
INVAR-31, Run: 083, F, 0, 0, 142, 2234, 3323, 2213, 5536
INVAR-31, Run: 084, F, 0, 0, 142, 227, 1970, 206, 2176
INVAR-31, Run: 085, F, 0, 142, 0, 1348, 2382, 1469, 3851
INVAR-31, Run: 086, F, 0, 0, 142, 387, 3641, 366, 4007
INVAR-31, Run: 087, F, 0, 0, 142, 579, 2960, 558, 3518
INVAR-31, Run: 088, F, 0, 0, 142, 97, 1309, 76, 1385
INVAR-31, Run: 089, F, 0, 0, 142, 4940, 11195, 4919, 16114
INVAR-31, Run: 090, F, 0, 0, 142, 287, 2018, 266, 2284
INVAR-31, Run: 091, F, 0, 0, 142, 3576, 12742, 3555, 16297
INVAR-31, Run: 092, F, 0, 0, 142, 346, 4404, 325, 4729
INVAR-31, Run: 093, F, 0, 0, 142, 996, 3059, 975, 4034
INVAR-31, Run: 094, F, 0, 142, 0, 2604, 3559, 2725, 6284
INVAR-31, Run: 095, F, 0, 0, 142, 9377, 14799, 9356, 24155
INVAR-31, Run: 096, F, 0, 0, 142, 351, 3199, 330, 3529
INVAR-31, Run: 097, F, 0, 0, 142, 1495, 3778, 1474, 5252
INVAR-31, Run: 098, F, 0, 0, 142, 225, 2421, 204, 2625
INVAR-31, Run: 099, F, 0, 142, 0, 3289, 1625, 3410, 5035
INVAR-31, Run: 100, F, 0, 0, 142, 61, 858, 40, 898
INVAR-32, Run: 001, F, 0, 217, 0, 3926, 3062, 4057, 7119
INVAR-32, Run: 002, F, 0, 0, 217, 6417, 5727, 6331, 12058
INVAR-32, Run: 003, F, 0, 217, 0, 4805, 3627, 4936, 8563
INVAR-32, Run: 004, F, 0, 217, 0, 1881, 1047, 2012, 3059
INVAR-32, Run: 005, F, 0, 0, 217, 9277, 14172, 9191, 23363
INVAR-32, Run: 006, F, 0, 0, 217, 5359, 12202, 5273, 17475
INVAR-32, Run: 007, F, 0, 0, 217, 2845, 16005, 2759, 18764
INVAR-32, Run: 008, F, 0, 217, 0, 1772, 875, 1903, 2778
INVAR-32, Run: 009, F, 0, 217, 0, 6750, 4978, 6881, 11859
INVAR-32, Run: 010, F, 0, 0, 217, 1474, 3633, 1388, 5021
INVAR-32, Run: 011, F, 0, 0, 217, 8924, 23485, 8838, 32323
INVAR-32, Run: 012, F, 0, 0, 217, 2194, 4286, 2108, 6394
INVAR-32, Run: 013, F, 0, 217, 0, 4497, 865, 4628, 5493
INVAR-32, Run: 014, F, 0, 0, 217, 1658, 15294, 1572, 16866
INVAR-32, Run: 015, F, 0, 217, 0, 3638, 2302, 3769, 6071
INVAR-32, Run: 016, F, 0, 217, 0, 940, 434, 1071, 1505
INVAR-32, Run: 017, F, 0, 0, 217, 6118, 7612, 6032, 13644
INVAR-32, Run: 018, F, 0, 217, 0, 2571, 703, 2702, 3405
INVAR-32, Run: 019, F, 0, 0, 217, 2132, 6158, 2046, 8204
INVAR-32, Run: 020, F, 0, 0, 217, 6886, 19512, 6800, 26312
INVAR-32, Run: 021, F, 0, 217, 0, 3299, 3536, 3430, 6966
INVAR-32, Run: 022, F, 0, 0, 217, 1098, 2865, 1012, 3877
INVAR-32, Run: 023, F, 0, 0, 217, 11124, 27903, 11038, 38941
INVAR-32, Run: 024, F, 0, 0, 217, 3216, 6468, 3130, 9598
INVAR-32, Run: 025, F, 0, 217, 0, 2053, 636, 2184, 2820
INVAR-32, Run: 026, F, 0, 0, 217, 6673, 22265, 6587, 28852
INVAR-32, Run: 027, F, 0, 0, 217, 2729, 7551, 2643, 10194
INVAR-32, Run: 028, F, 0, 217, 0, 2134, 529, 2265, 2794
INVAR-32, Run: 029, F, 0, 0, 217, 12797, 20676, 12711, 33387
INVAR-32, Run: 030, F, 0, 217, 0, 14031, 13282, 14162, 27444
INVAR-32, Run: 031, F, 0, 217, 0, 4178, 2528, 4309, 6837
INVAR-32, Run: 032, F, 0, 0, 217, 913, 2688, 827, 3515
INVAR-32, Run: 033, F, 0, 217, 0, 3175, 1215, 3306, 4521
INVAR-32, Run: 034, F, 0, 217, 0, 4862, 2302, 4993, 7295
INVAR-32, Run: 035, F, 0, 0, 217, 4150, 9156, 4064, 13220
INVAR-32, Run: 036, F, 0, 0, 217, 1996, 5841, 1910, 7751
INVAR-32, Run: 037, F, 0, 0, 217, 1587, 8747, 1501, 10248
INVAR-32, Run: 038, F, 0, 0, 217, 5268, 10056, 5182, 15238
INVAR-32, Run: 039, F, 0, 0, 217, 3811, 8912, 3725, 12637
INVAR-32, Run: 040, F, 0, 217, 0, 5864, 1348, 5995, 7343
INVAR-32, Run: 041, F, 0, 217, 0, 15109, 17873, 15240, 33113
INVAR-32, Run: 042, F, 0, 0, 217, 1496, 6399, 1410, 7809
INVAR-32, Run: 043, F, 0, 0, 217, 15782, 28001, 15696, 43697
INVAR-32, Run: 044, F, 0, 0, 217, 696, 4458, 610, 5068
INVAR-32, Run: 045, F, 0, 217, 0, 7084, 3729, 7215, 10944
INVAR-32, Run: 046, F, 0, 0, 217, 10796, 24266, 10710, 34976
INVAR-32, Run: 047, F, 0, 217, 0, 14638, 10729, 14769, 25498
INVAR-32, Run: 048, F, 0, 217, 0, 1607, 593, 1738, 2331
INVAR-32, Run: 049, F, 0, 217, 0, 2746, 1971, 2877, 4848
INVAR-32, Run: 050, F, 0, 0, 217, 9191, 19592, 9105, 28697
INVAR-32, Run: 051, F, 0, 217, 0, 11748, 4631, 11879, 16510
INVAR-32, Run: 052, F, 0, 0, 217, 2963, 11273, 2877, 14150
INVAR-32, Run: 053, F, 0, 0, 217, 7995, 8834, 7909, 16743
INVAR-32, Run: 054, F, 0, 0, 217, 7488, 12246, 7402, 19648
INVAR-32, Run: 055, F, 0, 0, 217, 6907, 12140, 6821, 18961
INVAR-32, Run: 056, F, 0, 0, 217, 2142, 11013, 2056, 13069
INVAR-32, Run: 057, F, 0, 0, 217, 1383, 6556, 1297, 7853
INVAR-32, Run: 058, F, 0, 217, 0, 2436, 1784, 2567, 4351
INVAR-32, Run: 059, F, 0, 217, 0, 1212, 520, 1343, 1863
INVAR-32, Run: 060, F, 0, 0, 217, 1643, 8968, 1557, 10525
INVAR-32, Run: 061, F, 0, 217, 0, 1574, 572, 1705, 2277
INVAR-32, Run: 062, F, 0, 0, 217, 3607, 8470, 3521, 11991
INVAR-32, Run: 063, F, 0, 217, 0, 7870, 5241, 8001, 13242
INVAR-32, Run: 064, F, 0, 0, 217, 2227, 7295, 2141, 9436
INVAR-32, Run: 065, F, 0, 0, 217, 3361, 16214, 3275, 19489
INVAR-32, Run: 066, F, 0, 0, 217, 1126, 2618, 1040, 3658
INVAR-32, Run: 067, F, 0, 0, 217, 4329, 9641, 4243, 13884
INVAR-32, Run: 068, F, 0, 0, 217, 1172, 5020, 1086, 6106
INVAR-32, Run: 069, F, 0, 0, 217, 5970, 9593, 5884, 15477
INVAR-32, Run: 070, F, 0, 217, 0, 13375, 7870, 13506, 21376
INVAR-32, Run: 071, F, 0, 217, 0, 12910, 5520, 13041, 18561
INVAR-32, Run: 072, F, 0, 0, 217, 3531, 12277, 3445, 15722
INVAR-32, Run: 073, F, 0, 217, 0, 5033, 1925, 5164, 7089
INVAR-32, Run: 074, F, 0, 0, 217, 3874, 4780, 3788, 8568
INVAR-32, Run: 075, F, 0, 0, 217, 2736, 5912, 2650, 8562
INVAR-32, Run: 076, F, 0, 217, 0, 3702, 1146, 3833, 4979
INVAR-32, Run: 077, F, 0, 0, 217, 6949, 12461, 6863, 19324
INVAR-32, Run: 078, F, 0, 0, 217, 3411, 19754, 3325, 23079
INVAR-32, Run: 079, F, 0, 0, 217, 1531, 8120, 1445, 9565
INVAR-32, Run: 080, F, 0, 0, 217, 9465, 13688, 9379, 23067
INVAR-32, Run: 081, F, 0, 0, 217, 1078, 4023, 992, 5015
INVAR-32, Run: 082, F, 0, 0, 217, 1372, 3686, 1286, 4972
INVAR-32, Run: 083, F, 0, 217, 0, 3522, 1498, 3653, 5151
INVAR-32, Run: 084, F, 0, 0, 217, 808, 2930, 722, 3652
INVAR-32, Run: 085, F, 0, 0, 217, 2950, 9408, 2864, 12272
INVAR-32, Run: 086, F, 0, 217, 0, 1366, 397, 1497, 1894
INVAR-32, Run: 087, F, 0, 217, 0, 5026, 4327, 5157, 9484
INVAR-32, Run: 088, F, 0, 0, 217, 16876, 19777, 16790, 36567
INVAR-32, Run: 089, F, 0, 0, 217, 2915, 7797, 2829, 10626
INVAR-32, Run: 090, F, 0, 217, 0, 7831, 2091, 7962, 10053
INVAR-32, Run: 091, F, 0, 0, 217, 1847, 4359, 1761, 6120
INVAR-32, Run: 092, F, 0, 0, 217, 15991, 17066, 15905, 32971
INVAR-32, Run: 093, F, 0, 0, 217, 9198, 23419, 9112, 32531
INVAR-32, Run: 094, F, 0, 0, 217, 1169, 5319, 1083, 6402
INVAR-32, Run: 095, F, 0, 0, 217, 4798, 11716, 4712, 16428
INVAR-32, Run: 096, F, 0, 0, 217, 1753, 8295, 1667, 9962
INVAR-32, Run: 097, F, 0, 0, 217, 4207, 14245, 4121, 18366
INVAR-32, Run: 098, F, 0, 0, 217, 7189, 9567, 7103, 16670
INVAR-32, Run: 099, F, 0, 217, 0, 3214, 2249, 3345, 5594
INVAR-32, Run: 100, F, 0, 217, 0, 2934, 870, 3065, 3935
INVAR-33, Run: 001, F, 0, 0, 48, 613, 1529, 596, 2125
INVAR-33, Run: 002, F, 0, 48, 0, 1236, 1073, 1267, 2340
INVAR-33, Run: 003, F, 0, 0, 48, 54, 105, 37, 142
INVAR-33, Run: 004, F, 0, 48, 0, 517, 440, 548, 988
INVAR-33, Run: 005, F, 0, 0, 48, 243, 650, 226, 876
INVAR-33, Run: 006, F, 0, 0, 48, 391, 999, 374, 1373
INVAR-33, Run: 007, F, 0, 0, 48, 88, 611, 71, 682
INVAR-33, Run: 008, F, 0, 0, 48, 53, 213, 36, 249
INVAR-33, Run: 009, F, 0, 48, 0, 285, 60, 316, 376
INVAR-33, Run: 010, F, 0, 0, 48, 36, 154, 19, 173
INVAR-33, Run: 011, F, 0, 0, 48, 233, 1095, 216, 1311
INVAR-33, Run: 012, F, 0, 0, 48, 186, 366, 169, 535
INVAR-33, Run: 013, F, 0, 48, 0, 566, 149, 597, 746
INVAR-33, Run: 014, F, 0, 48, 0, 258, 101, 289, 390
INVAR-33, Run: 015, F, 0, 0, 48, 151, 622, 134, 756
INVAR-33, Run: 016, F, 0, 48, 0, 538, 224, 569, 793
INVAR-33, Run: 017, F, 0, 48, 0, 316, 161, 347, 508
INVAR-33, Run: 018, F, 0, 0, 48, 629, 951, 612, 1563
INVAR-33, Run: 019, F, 0, 48, 0, 255, 196, 286, 482
INVAR-33, Run: 020, F, 0, 0, 48, 73, 283, 56, 339
INVAR-33, Run: 021, F, 0, 0, 48, 241, 598, 224, 822
INVAR-33, Run: 022, F, 0, 48, 0, 198, 88, 229, 317
INVAR-33, Run: 023, F, 0, 48, 0, 61, 62, 92, 154
INVAR-33, Run: 024, F, 0, 0, 48, 355, 568, 338, 906
INVAR-33, Run: 025, F, 0, 0, 48, 85, 135, 68, 203
INVAR-33, Run: 026, F, 0, 0, 48, 204, 349, 187, 536
INVAR-33, Run: 027, F, 0, 0, 48, 109, 259, 92, 351
INVAR-33, Run: 028, F, 0, 0, 48, 589, 419, 572, 991
INVAR-33, Run: 029, F, 0, 0, 48, 330, 671, 313, 984
INVAR-33, Run: 030, F, 0, 0, 48, 99, 379, 82, 461
INVAR-33, Run: 031, F, 0, 48, 0, 121, 139, 152, 291
INVAR-33, Run: 032, F, 0, 48, 0, 558, 936, 589, 1525
INVAR-33, Run: 033, F, 0, 48, 0, 499, 417, 530, 947
INVAR-33, Run: 034, F, 0, 48, 0, 619, 507, 650, 1157
INVAR-33, Run: 035, F, 0, 48, 0, 28, 23, 59, 82
INVAR-33, Run: 036, F, 0, 0, 48, 94, 727, 77, 804
INVAR-33, Run: 037, F, 0, 0, 48, 247, 543, 230, 773
INVAR-33, Run: 038, F, 0, 48, 0, 977, 973, 1008, 1981
INVAR-33, Run: 039, F, 0, 0, 48, 51, 277, 34, 311
INVAR-33, Run: 040, F, 0, 0, 48, 96, 263, 79, 342
INVAR-33, Run: 041, F, 0, 48, 0, 708, 344, 739, 1083
INVAR-33, Run: 042, F, 0, 48, 0, 617, 542, 648, 1190
INVAR-33, Run: 043, F, 0, 0, 48, 56, 184, 39, 223
INVAR-33, Run: 044, F, 0, 0, 48, 75, 322, 58, 380
INVAR-33, Run: 045, F, 0, 0, 48, 314, 676, 297, 973
INVAR-33, Run: 046, F, 0, 0, 48, 199, 760, 182, 942
INVAR-33, Run: 047, F, 0, 48, 0, 184, 81, 215, 296
INVAR-33, Run: 048, F, 0, 0, 48, 506, 552, 489, 1041
INVAR-33, Run: 049, F, 0, 0, 48, 203, 638, 186, 824
INVAR-33, Run: 050, F, 0, 48, 0, 162, 571, 193, 764
INVAR-33, Run: 051, F, 0, 0, 48, 131, 286, 114, 400
INVAR-33, Run: 052, F, 0, 0, 48, 163, 546, 146, 692
INVAR-33, Run: 053, F, 0, 48, 0, 296, 282, 327, 609
INVAR-33, Run: 054, F, 0, 0, 48, 108, 502, 91, 593
INVAR-33, Run: 055, F, 0, 48, 0, 86, 177, 117, 294
INVAR-33, Run: 056, F, 0, 0, 48, 504, 728, 487, 1215
INVAR-33, Run: 057, F, 0, 0, 48, 101, 242, 84, 326
INVAR-33, Run: 058, F, 0, 0, 48, 66, 213, 49, 262
INVAR-33, Run: 059, F, 0, 0, 48, 343, 657, 326, 983
INVAR-33, Run: 060, F, 0, 0, 48, 426, 922, 409, 1331
INVAR-33, Run: 061, F, 0, 0, 48, 62, 306, 45, 351
INVAR-33, Run: 062, F, 0, 0, 48, 86, 210, 69, 279
INVAR-33, Run: 063, F, 0, 48, 0, 309, 419, 340, 759
INVAR-33, Run: 064, F, 0, 0, 48, 178, 436, 161, 597
INVAR-33, Run: 065, F, 0, 0, 48, 383, 481, 366, 847
INVAR-33, Run: 066, F, 0, 0, 48, 325, 801, 308, 1109
INVAR-33, Run: 067, F, 0, 0, 48, 393, 1118, 376, 1494
INVAR-33, Run: 068, F, 0, 0, 48, 494, 2243, 477, 2720
INVAR-33, Run: 069, F, 0, 0, 48, 229, 654, 212, 866
INVAR-33, Run: 070, F, 0, 0, 48, 209, 577, 192, 769
INVAR-33, Run: 071, F, 0, 48, 0, 359, 170, 390, 560
INVAR-33, Run: 072, F, 0, 0, 48, 279, 456, 262, 718
INVAR-33, Run: 073, F, 0, 0, 48, 94, 293, 77, 370
INVAR-33, Run: 074, F, 0, 0, 48, 55, 305, 38, 343
INVAR-33, Run: 075, F, 0, 0, 48, 171, 482, 154, 636
INVAR-33, Run: 076, F, 0, 48, 0, 601, 505, 632, 1137
INVAR-33, Run: 077, F, 0, 0, 48, 531, 885, 514, 1399
INVAR-33, Run: 078, F, 0, 0, 48, 88, 313, 71, 384
INVAR-33, Run: 079, F, 0, 0, 48, 47, 196, 30, 226
INVAR-33, Run: 080, F, 0, 0, 48, 30, 108, 13, 121
INVAR-33, Run: 081, F, 0, 0, 48, 38, 66, 21, 87
INVAR-33, Run: 082, F, 0, 0, 48, 205, 378, 188, 566
INVAR-33, Run: 083, F, 0, 0, 48, 84, 385, 67, 452
INVAR-33, Run: 084, F, 0, 0, 48, 123, 279, 106, 385
INVAR-33, Run: 085, F, 0, 48, 0, 553, 296, 584, 880
INVAR-33, Run: 086, F, 0, 0, 48, 285, 1301, 268, 1569
INVAR-33, Run: 087, F, 0, 0, 48, 52, 130, 35, 165
INVAR-33, Run: 088, F, 0, 0, 48, 89, 164, 72, 236
INVAR-33, Run: 089, F, 0, 48, 0, 325, 438, 356, 794
INVAR-33, Run: 090, F, 0, 48, 0, 577, 443, 608, 1051
INVAR-33, Run: 091, F, 0, 48, 0, 149, 39, 180, 219
INVAR-33, Run: 092, F, 0, 0, 48, 91, 300, 74, 374
INVAR-33, Run: 093, F, 0, 0, 48, 36, 168, 19, 187
INVAR-33, Run: 094, F, 0, 48, 0, 227, 154, 258, 412
INVAR-33, Run: 095, F, 0, 48, 0, 381, 672, 412, 1084
INVAR-33, Run: 096, F, 0, 0, 48, 104, 530, 87, 617
INVAR-33, Run: 097, F, 0, 48, 0, 179, 211, 210, 421
INVAR-33, Run: 098, F, 0, 0, 48, 144, 492, 127, 619
INVAR-33, Run: 099, F, 0, 0, 48, 759, 727, 742, 1469
INVAR-33, Run: 100, F, 0, 0, 48, 108, 222, 91, 313
INVAR-34, Run: 001, P, 0, 0, 25, 0, 0, 0, 0
INVAR-34, Run: 002, P, 0, 0, 25, 0, 0, 0, 0
INVAR-34, Run: 003, P, 0, 0, 25, 0, 0, 0, 0
INVAR-34, Run: 004, P, 0, 0, 25, 0, 0, 0, 0
INVAR-34, Run: 005, P, 0, 0, 25, 0, 0, 0, 0
INVAR-34, Run: 006, P, 0, 0, 25, 0, 0, 0, 0
INVAR-34, Run: 007, P, 0, 0, 25, 0, 0, 0, 0
INVAR-34, Run: 008, P, 0, 0, 25, 0, 0, 0, 0
INVAR-34, Run: 009, P, 0, 0, 25, 0, 0, 0, 0
INVAR-34, Run: 010, P, 0, 0, 25, 0, 0, 0, 0
INVAR-34, Run: 011, P, 0, 0, 25, 0, 0, 0, 0
INVAR-34, Run: 012, P, 0, 0, 25, 0, 0, 0, 0
INVAR-34, Run: 013, P, 0, 0, 25, 0, 0, 0, 0
INVAR-34, Run: 014, P, 0, 0, 25, 0, 0, 0, 0
INVAR-34, Run: 015, P, 0, 0, 25, 0, 0, 0, 0
INVAR-34, Run: 016, P, 0, 0, 25, 0, 0, 0, 0
INVAR-34, Run: 017, P, 0, 0, 25, 0, 0, 0, 0
INVAR-34, Run: 018, P, 0, 0, 25, 0, 0, 0, 0
INVAR-34, Run: 019, P, 0, 0, 25, 0, 0, 0, 0
INVAR-34, Run: 020, P, 0, 0, 25, 0, 0, 0, 0
INVAR-34, Run: 021, P, 0, 0, 25, 0, 0, 0, 0
INVAR-34, Run: 022, P, 0, 0, 25, 0, 0, 0, 0
INVAR-34, Run: 023, P, 0, 0, 25, 0, 0, 0, 0
INVAR-34, Run: 024, P, 0, 0, 25, 0, 0, 0, 0
INVAR-34, Run: 025, P, 0, 0, 25, 0, 0, 0, 0
INVAR-34, Run: 026, P, 0, 0, 25, 0, 0, 0, 0
INVAR-34, Run: 027, P, 0, 0, 25, 0, 0, 0, 0
INVAR-34, Run: 028, P, 0, 0, 25, 0, 0, 0, 0
INVAR-34, Run: 029, P, 0, 0, 25, 0, 0, 0, 0
INVAR-34, Run: 030, P, 0, 0, 25, 0, 0, 0, 0
INVAR-34, Run: 031, P, 0, 0, 25, 0, 0, 0, 0
INVAR-34, Run: 032, P, 0, 0, 25, 0, 0, 0, 0
INVAR-34, Run: 033, P, 0, 0, 25, 0, 0, 0, 0
INVAR-34, Run: 034, P, 0, 0, 25, 0, 0, 0, 0
INVAR-34, Run: 035, P, 0, 0, 25, 0, 0, 0, 0
INVAR-34, Run: 036, P, 0, 0, 25, 0, 0, 0, 0
INVAR-34, Run: 037, P, 0, 0, 25, 0, 0, 0, 0
INVAR-34, Run: 038, P, 0, 0, 25, 0, 0, 0, 0
INVAR-34, Run: 039, P, 0, 0, 25, 0, 0, 0, 0
INVAR-34, Run: 040, P, 0, 0, 25, 0, 0, 0, 0
INVAR-34, Run: 041, P, 0, 0, 25, 0, 0, 0, 0
INVAR-34, Run: 042, P, 0, 0, 25, 0, 0, 0, 0
INVAR-34, Run: 043, P, 0, 0, 25, 0, 0, 0, 0
INVAR-34, Run: 044, P, 0, 0, 25, 0, 0, 0, 0
INVAR-34, Run: 045, P, 0, 0, 25, 0, 0, 0, 0
INVAR-34, Run: 046, P, 0, 0, 25, 0, 0, 0, 0
INVAR-34, Run: 047, P, 0, 0, 25, 0, 0, 0, 0
INVAR-34, Run: 048, P, 0, 0, 25, 0, 0, 0, 0
INVAR-34, Run: 049, P, 0, 0, 25, 0, 0, 0, 0
INVAR-34, Run: 050, P, 0, 0, 25, 0, 0, 0, 0
INVAR-34, Run: 051, P, 0, 0, 25, 0, 0, 0, 0
INVAR-34, Run: 052, P, 0, 0, 25, 0, 0, 0, 0
INVAR-34, Run: 053, P, 0, 0, 25, 0, 0, 0, 0
INVAR-34, Run: 054, P, 0, 0, 25, 0, 0, 0, 0
INVAR-34, Run: 055, P, 0, 0, 25, 0, 0, 0, 0
INVAR-34, Run: 056, P, 0, 0, 25, 0, 0, 0, 0
INVAR-34, Run: 057, P, 0, 0, 25, 0, 0, 0, 0
INVAR-34, Run: 058, P, 0, 0, 25, 0, 0, 0, 0
INVAR-34, Run: 059, P, 0, 0, 25, 0, 0, 0, 0
INVAR-34, Run: 060, P, 0, 0, 25, 0, 0, 0, 0
INVAR-34, Run: 061, P, 0, 0, 25, 0, 0, 0, 0
INVAR-34, Run: 062, P, 0, 0, 25, 0, 0, 0, 0
INVAR-34, Run: 063, P, 0, 0, 25, 0, 0, 0, 0
INVAR-34, Run: 064, P, 0, 0, 25, 0, 0, 0, 0
INVAR-34, Run: 065, P, 0, 0, 25, 0, 0, 0, 0
INVAR-34, Run: 066, P, 0, 0, 25, 0, 0, 0, 0
INVAR-34, Run: 067, P, 0, 0, 25, 0, 0, 0, 0
INVAR-34, Run: 068, P, 0, 0, 25, 0, 0, 0, 0
INVAR-34, Run: 069, P, 0, 0, 25, 0, 0, 0, 0
INVAR-34, Run: 070, P, 0, 0, 25, 0, 0, 0, 0
INVAR-34, Run: 071, P, 0, 0, 25, 0, 0, 0, 0
INVAR-34, Run: 072, P, 0, 0, 25, 0, 0, 0, 0
INVAR-34, Run: 073, P, 0, 0, 25, 0, 0, 0, 0
INVAR-34, Run: 074, P, 0, 0, 25, 0, 0, 0, 0
INVAR-34, Run: 075, P, 0, 0, 25, 0, 0, 0, 0
INVAR-34, Run: 076, P, 0, 0, 25, 0, 0, 0, 0
INVAR-34, Run: 077, P, 0, 0, 25, 0, 0, 0, 0
INVAR-34, Run: 078, P, 0, 0, 25, 0, 0, 0, 0
INVAR-34, Run: 079, P, 0, 0, 25, 0, 0, 0, 0
INVAR-34, Run: 080, P, 0, 0, 25, 0, 0, 0, 0
INVAR-34, Run: 081, P, 0, 0, 25, 0, 0, 0, 0
INVAR-34, Run: 082, P, 0, 0, 25, 0, 0, 0, 0
INVAR-34, Run: 083, P, 0, 0, 25, 0, 0, 0, 0
INVAR-34, Run: 084, P, 0, 0, 25, 0, 0, 0, 0
INVAR-34, Run: 085, P, 0, 0, 25, 0, 0, 0, 0
INVAR-34, Run: 086, P, 0, 0, 25, 0, 0, 0, 0
INVAR-34, Run: 087, P, 0, 0, 25, 0, 0, 0, 0
INVAR-34, Run: 088, P, 0, 0, 25, 0, 0, 0, 0
INVAR-34, Run: 089, P, 0, 0, 25, 0, 0, 0, 0
INVAR-34, Run: 090, P, 0, 0, 25, 0, 0, 0, 0
INVAR-34, Run: 091, P, 0, 0, 25, 0, 0, 0, 0
INVAR-34, Run: 092, P, 0, 0, 25, 0, 0, 0, 0
INVAR-34, Run: 093, P, 0, 0, 25, 0, 0, 0, 0
INVAR-34, Run: 094, P, 0, 0, 25, 0, 0, 0, 0
INVAR-34, Run: 095, P, 0, 0, 25, 0, 0, 0, 0
INVAR-34, Run: 096, P, 0, 0, 25, 0, 0, 0, 0
INVAR-34, Run: 097, P, 0, 0, 25, 0, 0, 0, 0
INVAR-34, Run: 098, P, 0, 0, 25, 0, 0, 0, 0
INVAR-34, Run: 099, P, 0, 0, 25, 0, 0, 0, 0
INVAR-34, Run: 100, P, 0, 0, 25, 0, 0, 0, 0
INVAR-35, Run: 001, P, 0, 0, 61, 0, 0, 0, 0
INVAR-35, Run: 002, P, 0, 0, 61, 0, 0, 0, 0
INVAR-35, Run: 003, P, 0, 0, 61, 0, 0, 0, 0
INVAR-35, Run: 004, P, 0, 0, 61, 0, 0, 0, 0
INVAR-35, Run: 005, P, 0, 0, 61, 0, 0, 0, 0
INVAR-35, Run: 006, P, 0, 0, 61, 0, 0, 0, 0
INVAR-35, Run: 007, P, 0, 0, 61, 0, 0, 0, 0
INVAR-35, Run: 008, P, 0, 0, 61, 0, 0, 0, 0
INVAR-35, Run: 009, P, 0, 0, 61, 0, 0, 0, 0
INVAR-35, Run: 010, P, 0, 0, 61, 0, 0, 0, 0
INVAR-35, Run: 011, P, 0, 0, 61, 0, 0, 0, 0
INVAR-35, Run: 012, P, 0, 0, 61, 0, 0, 0, 0
INVAR-35, Run: 013, P, 0, 0, 61, 0, 0, 0, 0
INVAR-35, Run: 014, P, 0, 0, 61, 0, 0, 0, 0
INVAR-35, Run: 015, P, 0, 0, 61, 0, 0, 0, 0
INVAR-35, Run: 016, P, 0, 0, 61, 0, 0, 0, 0
INVAR-35, Run: 017, P, 0, 0, 61, 0, 0, 0, 0
INVAR-35, Run: 018, P, 0, 0, 61, 0, 0, 0, 0
INVAR-35, Run: 019, P, 0, 0, 61, 0, 0, 0, 0
INVAR-35, Run: 020, P, 0, 0, 61, 0, 0, 0, 0
INVAR-35, Run: 021, P, 0, 0, 61, 0, 0, 0, 0
INVAR-35, Run: 022, P, 0, 0, 61, 0, 0, 0, 0
INVAR-35, Run: 023, P, 0, 0, 61, 0, 0, 0, 0
INVAR-35, Run: 024, P, 0, 0, 61, 0, 0, 0, 0
INVAR-35, Run: 025, P, 0, 0, 61, 0, 0, 0, 0
INVAR-35, Run: 026, P, 0, 0, 61, 0, 0, 0, 0
INVAR-35, Run: 027, P, 0, 0, 61, 0, 0, 0, 0
INVAR-35, Run: 028, P, 0, 0, 61, 0, 0, 0, 0
INVAR-35, Run: 029, P, 0, 0, 61, 0, 0, 0, 0
INVAR-35, Run: 030, P, 0, 0, 61, 0, 0, 0, 0
INVAR-35, Run: 031, P, 0, 0, 61, 0, 0, 0, 0
INVAR-35, Run: 032, P, 0, 0, 61, 0, 0, 0, 0
INVAR-35, Run: 033, P, 0, 0, 61, 0, 0, 0, 0
INVAR-35, Run: 034, P, 0, 0, 61, 0, 0, 0, 0
INVAR-35, Run: 035, P, 0, 0, 61, 0, 0, 0, 0
INVAR-35, Run: 036, P, 0, 0, 61, 0, 0, 0, 0
INVAR-35, Run: 037, P, 0, 0, 61, 0, 0, 0, 0
INVAR-35, Run: 038, P, 0, 0, 61, 0, 0, 0, 0
INVAR-35, Run: 039, P, 0, 0, 61, 0, 0, 0, 0
INVAR-35, Run: 040, P, 0, 0, 61, 0, 0, 0, 0
INVAR-35, Run: 041, P, 0, 0, 61, 0, 0, 0, 0
INVAR-35, Run: 042, P, 0, 0, 61, 0, 0, 0, 0
INVAR-35, Run: 043, P, 0, 0, 61, 0, 0, 0, 0
INVAR-35, Run: 044, P, 0, 0, 61, 0, 0, 0, 0
INVAR-35, Run: 045, P, 0, 0, 61, 0, 0, 0, 0
INVAR-35, Run: 046, P, 0, 0, 61, 0, 0, 0, 0
INVAR-35, Run: 047, P, 0, 0, 61, 0, 0, 0, 0
INVAR-35, Run: 048, P, 0, 0, 61, 0, 0, 0, 0
INVAR-35, Run: 049, P, 0, 0, 61, 0, 0, 0, 0
INVAR-35, Run: 050, P, 0, 0, 61, 0, 0, 0, 0
INVAR-35, Run: 051, P, 0, 0, 61, 0, 0, 0, 0
INVAR-35, Run: 052, P, 0, 0, 61, 0, 0, 0, 0
INVAR-35, Run: 053, P, 0, 0, 61, 0, 0, 0, 0
INVAR-35, Run: 054, P, 0, 0, 61, 0, 0, 0, 0
INVAR-35, Run: 055, P, 0, 0, 61, 0, 0, 0, 0
INVAR-35, Run: 056, P, 0, 0, 61, 0, 0, 0, 0
INVAR-35, Run: 057, P, 0, 0, 61, 0, 0, 0, 0
INVAR-35, Run: 058, P, 0, 0, 61, 0, 0, 0, 0
INVAR-35, Run: 059, P, 0, 0, 61, 0, 0, 0, 0
INVAR-35, Run: 060, P, 0, 0, 61, 0, 0, 0, 0
INVAR-35, Run: 061, P, 0, 0, 61, 0, 0, 0, 0
INVAR-35, Run: 062, P, 0, 0, 61, 0, 0, 0, 0
INVAR-35, Run: 063, P, 0, 0, 61, 0, 0, 0, 0
INVAR-35, Run: 064, P, 0, 0, 61, 0, 0, 0, 0
INVAR-35, Run: 065, P, 0, 0, 61, 0, 0, 0, 0
INVAR-35, Run: 066, P, 0, 0, 61, 0, 0, 0, 0
INVAR-35, Run: 067, P, 0, 0, 61, 0, 0, 0, 0
INVAR-35, Run: 068, P, 0, 0, 61, 0, 0, 0, 0
INVAR-35, Run: 069, P, 0, 0, 61, 0, 0, 0, 0
INVAR-35, Run: 070, P, 0, 0, 61, 0, 0, 0, 0
INVAR-35, Run: 071, P, 0, 0, 61, 0, 0, 0, 0
INVAR-35, Run: 072, P, 0, 0, 61, 0, 0, 0, 0
INVAR-35, Run: 073, P, 0, 0, 61, 0, 0, 0, 0
INVAR-35, Run: 074, P, 0, 0, 61, 0, 0, 0, 0
INVAR-35, Run: 075, P, 0, 0, 61, 0, 0, 0, 0
INVAR-35, Run: 076, P, 0, 0, 61, 0, 0, 0, 0
INVAR-35, Run: 077, P, 0, 0, 61, 0, 0, 0, 0
INVAR-35, Run: 078, P, 0, 0, 61, 0, 0, 0, 0
INVAR-35, Run: 079, P, 0, 0, 61, 0, 0, 0, 0
INVAR-35, Run: 080, P, 0, 0, 61, 0, 0, 0, 0
INVAR-35, Run: 081, P, 0, 0, 61, 0, 0, 0, 0
INVAR-35, Run: 082, P, 0, 0, 61, 0, 0, 0, 0
INVAR-35, Run: 083, P, 0, 0, 61, 0, 0, 0, 0
INVAR-35, Run: 084, P, 0, 0, 61, 0, 0, 0, 0
INVAR-35, Run: 085, P, 0, 0, 61, 0, 0, 0, 0
INVAR-35, Run: 086, P, 0, 0, 61, 0, 0, 0, 0
INVAR-35, Run: 087, P, 0, 0, 61, 0, 0, 0, 0
INVAR-35, Run: 088, P, 0, 0, 61, 0, 0, 0, 0
INVAR-35, Run: 089, P, 0, 0, 61, 0, 0, 0, 0
INVAR-35, Run: 090, P, 0, 0, 61, 0, 0, 0, 0
INVAR-35, Run: 091, P, 0, 0, 61, 0, 0, 0, 0
INVAR-35, Run: 092, P, 0, 0, 61, 0, 0, 0, 0
INVAR-35, Run: 093, P, 0, 0, 61, 0, 0, 0, 0
INVAR-35, Run: 094, P, 0, 0, 61, 0, 0, 0, 0
INVAR-35, Run: 095, P, 0, 0, 61, 0, 0, 0, 0
INVAR-35, Run: 096, P, 0, 0, 61, 0, 0, 0, 0
INVAR-35, Run: 097, P, 0, 0, 61, 0, 0, 0, 0
INVAR-35, Run: 098, P, 0, 0, 61, 0, 0, 0, 0
INVAR-35, Run: 099, P, 0, 0, 61, 0, 0, 0, 0
INVAR-35, Run: 100, P, 0, 0, 61, 0, 0, 0, 0
INVAR-36, Run: 001, P, 0, 0, 109, 0, 0, 0, 0
INVAR-36, Run: 002, P, 0, 0, 109, 0, 0, 0, 0
INVAR-36, Run: 003, P, 0, 0, 109, 0, 0, 0, 0
INVAR-36, Run: 004, P, 0, 0, 109, 0, 0, 0, 0
INVAR-36, Run: 005, P, 0, 0, 109, 0, 0, 0, 0
INVAR-36, Run: 006, P, 0, 0, 109, 0, 0, 0, 0
INVAR-36, Run: 007, P, 0, 0, 109, 0, 0, 0, 0
INVAR-36, Run: 008, P, 0, 0, 109, 0, 0, 0, 0
INVAR-36, Run: 009, P, 0, 0, 109, 0, 0, 0, 0
INVAR-36, Run: 010, P, 0, 0, 109, 0, 0, 0, 0
INVAR-36, Run: 011, P, 0, 0, 109, 0, 0, 0, 0
INVAR-36, Run: 012, P, 0, 0, 109, 0, 0, 0, 0
INVAR-36, Run: 013, P, 0, 0, 109, 0, 0, 0, 0
INVAR-36, Run: 014, P, 0, 0, 109, 0, 0, 0, 0
INVAR-36, Run: 015, P, 0, 0, 109, 0, 0, 0, 0
INVAR-36, Run: 016, P, 0, 0, 109, 0, 0, 0, 0
INVAR-36, Run: 017, P, 0, 0, 109, 0, 0, 0, 0
INVAR-36, Run: 018, P, 0, 0, 109, 0, 0, 0, 0
INVAR-36, Run: 019, P, 0, 0, 109, 0, 0, 0, 0
INVAR-36, Run: 020, P, 0, 0, 109, 0, 0, 0, 0
INVAR-36, Run: 021, P, 0, 0, 109, 0, 0, 0, 0
INVAR-36, Run: 022, P, 0, 0, 109, 0, 0, 0, 0
INVAR-36, Run: 023, P, 0, 0, 109, 0, 0, 0, 0
INVAR-36, Run: 024, P, 0, 0, 109, 0, 0, 0, 0
INVAR-36, Run: 025, P, 0, 0, 109, 0, 0, 0, 0
INVAR-36, Run: 026, P, 0, 0, 109, 0, 0, 0, 0
INVAR-36, Run: 027, P, 0, 0, 109, 0, 0, 0, 0
INVAR-36, Run: 028, P, 0, 0, 109, 0, 0, 0, 0
INVAR-36, Run: 029, P, 0, 0, 109, 0, 0, 0, 0
INVAR-36, Run: 030, P, 0, 0, 109, 0, 0, 0, 0
INVAR-36, Run: 031, P, 0, 0, 109, 0, 0, 0, 0
INVAR-36, Run: 032, P, 0, 0, 109, 0, 0, 0, 0
INVAR-36, Run: 033, P, 0, 0, 109, 0, 0, 0, 0
INVAR-36, Run: 034, P, 0, 0, 109, 0, 0, 0, 0
INVAR-36, Run: 035, P, 0, 0, 109, 0, 0, 0, 0
INVAR-36, Run: 036, P, 0, 0, 109, 0, 0, 0, 0
INVAR-36, Run: 037, P, 0, 0, 109, 0, 0, 0, 0
INVAR-36, Run: 038, P, 0, 0, 109, 0, 0, 0, 0
INVAR-36, Run: 039, P, 0, 0, 109, 0, 0, 0, 0
INVAR-36, Run: 040, P, 0, 0, 109, 0, 0, 0, 0
INVAR-36, Run: 041, P, 0, 0, 109, 0, 0, 0, 0
INVAR-36, Run: 042, P, 0, 0, 109, 0, 0, 0, 0
INVAR-36, Run: 043, P, 0, 0, 109, 0, 0, 0, 0
INVAR-36, Run: 044, P, 0, 0, 109, 0, 0, 0, 0
INVAR-36, Run: 045, P, 0, 0, 109, 0, 0, 0, 0
INVAR-36, Run: 046, P, 0, 0, 109, 0, 0, 0, 0
INVAR-36, Run: 047, P, 0, 0, 109, 0, 0, 0, 0
INVAR-36, Run: 048, P, 0, 0, 109, 0, 0, 0, 0
INVAR-36, Run: 049, P, 0, 0, 109, 0, 0, 0, 0
INVAR-36, Run: 050, P, 0, 0, 109, 0, 0, 0, 0
INVAR-36, Run: 051, P, 0, 0, 109, 0, 0, 0, 0
INVAR-36, Run: 052, P, 0, 0, 109, 0, 0, 0, 0
INVAR-36, Run: 053, P, 0, 0, 109, 0, 0, 0, 0
INVAR-36, Run: 054, P, 0, 0, 109, 0, 0, 0, 0
INVAR-36, Run: 055, P, 0, 0, 109, 0, 0, 0, 0
INVAR-36, Run: 056, P, 0, 0, 109, 0, 0, 0, 0
INVAR-36, Run: 057, P, 0, 0, 109, 0, 0, 0, 0
INVAR-36, Run: 058, P, 0, 0, 109, 0, 0, 0, 0
INVAR-36, Run: 059, P, 0, 0, 109, 0, 0, 0, 0
INVAR-36, Run: 060, P, 0, 0, 109, 0, 0, 0, 0
INVAR-36, Run: 061, P, 0, 0, 109, 0, 0, 0, 0
INVAR-36, Run: 062, P, 0, 0, 109, 0, 0, 0, 0
INVAR-36, Run: 063, P, 0, 0, 109, 0, 0, 0, 0
INVAR-36, Run: 064, P, 0, 0, 109, 0, 0, 0, 0
INVAR-36, Run: 065, P, 0, 0, 109, 0, 0, 0, 0
INVAR-36, Run: 066, P, 0, 0, 109, 0, 0, 0, 0
INVAR-36, Run: 067, P, 0, 0, 109, 0, 0, 0, 0
INVAR-36, Run: 068, P, 0, 0, 109, 0, 0, 0, 0
INVAR-36, Run: 069, P, 0, 0, 109, 0, 0, 0, 0
INVAR-36, Run: 070, P, 0, 0, 109, 0, 0, 0, 0
INVAR-36, Run: 071, P, 0, 0, 109, 0, 0, 0, 0
INVAR-36, Run: 072, P, 0, 0, 109, 0, 0, 0, 0
INVAR-36, Run: 073, P, 0, 0, 109, 0, 0, 0, 0
INVAR-36, Run: 074, P, 0, 0, 109, 0, 0, 0, 0
INVAR-36, Run: 075, P, 0, 0, 109, 0, 0, 0, 0
INVAR-36, Run: 076, P, 0, 0, 109, 0, 0, 0, 0
INVAR-36, Run: 077, P, 0, 0, 109, 0, 0, 0, 0
INVAR-36, Run: 078, P, 0, 0, 109, 0, 0, 0, 0
INVAR-36, Run: 079, P, 0, 0, 109, 0, 0, 0, 0
INVAR-36, Run: 080, P, 0, 0, 109, 0, 0, 0, 0
INVAR-36, Run: 081, P, 0, 0, 109, 0, 0, 0, 0
INVAR-36, Run: 082, P, 0, 0, 109, 0, 0, 0, 0
INVAR-36, Run: 083, P, 0, 0, 109, 0, 0, 0, 0
INVAR-36, Run: 084, P, 0, 0, 109, 0, 0, 0, 0
INVAR-36, Run: 085, P, 0, 0, 109, 0, 0, 0, 0
INVAR-36, Run: 086, P, 0, 0, 109, 0, 0, 0, 0
INVAR-36, Run: 087, P, 0, 0, 109, 0, 0, 0, 0
INVAR-36, Run: 088, P, 0, 0, 109, 0, 0, 0, 0
INVAR-36, Run: 089, P, 0, 0, 109, 0, 0, 0, 0
INVAR-36, Run: 090, P, 0, 0, 109, 0, 0, 0, 0
INVAR-36, Run: 091, P, 0, 0, 109, 0, 0, 0, 0
INVAR-36, Run: 092, P, 0, 0, 109, 0, 0, 0, 0
INVAR-36, Run: 093, P, 0, 0, 109, 0, 0, 0, 0
INVAR-36, Run: 094, P, 0, 0, 109, 0, 0, 0, 0
INVAR-36, Run: 095, P, 0, 0, 109, 0, 0, 0, 0
INVAR-36, Run: 096, P, 0, 0, 109, 0, 0, 0, 0
INVAR-36, Run: 097, P, 0, 0, 109, 0, 0, 0, 0
INVAR-36, Run: 098, P, 0, 0, 109, 0, 0, 0, 0
INVAR-36, Run: 099, P, 0, 0, 109, 0, 0, 0, 0
INVAR-36, Run: 100, P, 0, 0, 109, 0, 0, 0, 0
INVAR-37, Run: 001, F, 0, 0, 48, 74, 264, 62, 326
INVAR-37, Run: 002, F, 0, 0, 48, 37, 181, 25, 206
INVAR-37, Run: 003, F, 0, 48, 0, 254, 148, 290, 438
INVAR-37, Run: 004, F, 0, 0, 48, 113, 427, 101, 528
INVAR-37, Run: 005, F, 0, 48, 0, 229, 153, 265, 418
INVAR-37, Run: 006, F, 0, 0, 48, 234, 403, 222, 625
INVAR-37, Run: 007, F, 0, 0, 48, 346, 569, 334, 903
INVAR-37, Run: 008, F, 0, 0, 48, 23, 219, 11, 230
INVAR-37, Run: 009, F, 0, 48, 0, 326, 195, 362, 557
INVAR-37, Run: 010, F, 0, 0, 48, 195, 459, 183, 642
INVAR-37, Run: 011, F, 0, 0, 48, 168, 739, 156, 895
INVAR-37, Run: 012, F, 0, 48, 0, 1189, 693, 1225, 1918
INVAR-37, Run: 013, F, 0, 0, 48, 30, 110, 18, 128
INVAR-37, Run: 014, F, 0, 48, 0, 207, 149, 243, 392
INVAR-37, Run: 015, F, 0, 0, 48, 303, 752, 291, 1043
INVAR-37, Run: 016, F, 0, 0, 48, 191, 548, 179, 727
INVAR-37, Run: 017, F, 0, 0, 48, 41, 406, 29, 435
INVAR-37, Run: 018, F, 0, 48, 0, 531, 360, 567, 927
INVAR-37, Run: 019, F, 0, 0, 48, 60, 342, 48, 390
INVAR-37, Run: 020, F, 0, 0, 48, 49, 260, 37, 297
INVAR-37, Run: 021, F, 0, 0, 48, 356, 548, 344, 892
INVAR-37, Run: 022, F, 0, 48, 0, 326, 335, 362, 697
INVAR-37, Run: 023, F, 0, 0, 48, 70, 398, 58, 456
INVAR-37, Run: 024, F, 0, 0, 48, 489, 1138, 477, 1615
INVAR-37, Run: 025, F, 0, 0, 48, 22, 199, 10, 209
INVAR-37, Run: 026, F, 0, 0, 48, 156, 684, 144, 828
INVAR-37, Run: 027, F, 0, 0, 48, 53, 345, 41, 386
INVAR-37, Run: 028, F, 0, 0, 48, 165, 418, 153, 571
INVAR-37, Run: 029, F, 0, 0, 48, 177, 361, 165, 526
INVAR-37, Run: 030, F, 0, 0, 48, 118, 465, 106, 571
INVAR-37, Run: 031, F, 0, 48, 0, 352, 203, 388, 591
INVAR-37, Run: 032, F, 0, 0, 48, 59, 262, 47, 309
INVAR-37, Run: 033, F, 0, 0, 48, 63, 212, 51, 263
INVAR-37, Run: 034, F, 0, 48, 0, 378, 180, 414, 594
INVAR-37, Run: 035, F, 0, 48, 0, 156, 74, 192, 266
INVAR-37, Run: 036, F, 0, 0, 48, 28, 142, 16, 158
INVAR-37, Run: 037, F, 0, 48, 0, 236, 98, 272, 370
INVAR-37, Run: 038, F, 0, 48, 0, 312, 243, 348, 591
INVAR-37, Run: 039, F, 0, 0, 48, 264, 489, 252, 741
INVAR-37, Run: 040, F, 0, 0, 48, 65, 232, 53, 285
INVAR-37, Run: 041, F, 0, 0, 48, 36, 145, 24, 169
INVAR-37, Run: 042, F, 0, 48, 0, 1290, 925, 1326, 2251
INVAR-37, Run: 043, F, 0, 0, 48, 264, 331, 252, 583
INVAR-37, Run: 044, F, 0, 0, 48, 138, 347, 126, 473
INVAR-37, Run: 045, F, 0, 0, 48, 208, 753, 196, 949
INVAR-37, Run: 046, F, 0, 48, 0, 76, 77, 112, 189
INVAR-37, Run: 047, F, 0, 0, 48, 283, 839, 271, 1110
INVAR-37, Run: 048, F, 0, 48, 0, 264, 207, 300, 507
INVAR-37, Run: 049, F, 0, 0, 48, 73, 440, 61, 501
INVAR-37, Run: 050, F, 0, 0, 48, 26, 66, 14, 80
INVAR-37, Run: 051, F, 0, 48, 0, 93, 97, 129, 226
INVAR-37, Run: 052, F, 0, 48, 0, 155, 52, 191, 243
INVAR-37, Run: 053, F, 0, 0, 48, 409, 1128, 397, 1525
INVAR-37, Run: 054, F, 0, 48, 0, 688, 340, 724, 1064
INVAR-37, Run: 055, F, 0, 0, 48, 31, 173, 19, 192
INVAR-37, Run: 056, F, 0, 0, 48, 180, 613, 168, 781
INVAR-37, Run: 057, F, 0, 0, 48, 212, 409, 200, 609
INVAR-37, Run: 058, F, 0, 0, 48, 72, 289, 60, 349
INVAR-37, Run: 059, F, 0, 0, 48, 23, 439, 11, 450
INVAR-37, Run: 060, F, 0, 0, 48, 384, 467, 372, 839
INVAR-37, Run: 061, F, 0, 48, 0, 358, 615, 394, 1009
INVAR-37, Run: 062, F, 0, 0, 48, 22, 124, 10, 134
INVAR-37, Run: 063, F, 0, 0, 48, 138, 637, 126, 763
INVAR-37, Run: 064, F, 0, 48, 0, 120, 83, 156, 239
INVAR-37, Run: 065, F, 0, 0, 48, 12, 37, 0, 37
INVAR-37, Run: 066, F, 0, 0, 48, 333, 923, 321, 1244
INVAR-37, Run: 067, F, 0, 0, 48, 110, 352, 98, 450
INVAR-37, Run: 068, F, 0, 0, 48, 319, 604, 307, 911
INVAR-37, Run: 069, F, 0, 0, 48, 188, 1197, 176, 1373
INVAR-37, Run: 070, F, 0, 0, 48, 100, 417, 88, 505
INVAR-37, Run: 071, F, 0, 0, 48, 225, 298, 213, 511
INVAR-37, Run: 072, F, 0, 0, 48, 319, 491, 307, 798
INVAR-37, Run: 073, F, 0, 48, 0, 400, 177, 436, 613
INVAR-37, Run: 074, F, 0, 0, 48, 230, 703, 218, 921
INVAR-37, Run: 075, F, 0, 48, 0, 248, 234, 284, 518
INVAR-37, Run: 076, F, 0, 0, 48, 19, 103, 7, 110
INVAR-37, Run: 077, F, 0, 0, 48, 80, 547, 68, 615
INVAR-37, Run: 078, F, 0, 0, 48, 200, 451, 188, 639
INVAR-37, Run: 079, F, 0, 0, 48, 112, 361, 100, 461
INVAR-37, Run: 080, F, 0, 0, 48, 85, 463, 73, 536
INVAR-37, Run: 081, F, 0, 0, 48, 22, 299, 10, 309
INVAR-37, Run: 082, F, 0, 48, 0, 215, 148, 251, 399
INVAR-37, Run: 083, F, 0, 48, 0, 92, 111, 128, 239
INVAR-37, Run: 084, F, 0, 0, 48, 14, 59, 2, 61
INVAR-37, Run: 085, F, 0, 0, 48, 85, 595, 73, 668
INVAR-37, Run: 086, F, 0, 0, 48, 81, 429, 69, 498
INVAR-37, Run: 087, F, 0, 48, 0, 559, 951, 595, 1546
INVAR-37, Run: 088, F, 0, 48, 0, 119, 89, 155, 244
INVAR-37, Run: 089, F, 0, 0, 48, 329, 532, 317, 849
INVAR-37, Run: 090, F, 0, 0, 48, 41, 351, 29, 380
INVAR-37, Run: 091, F, 0, 0, 48, 59, 362, 47, 409
INVAR-37, Run: 092, F, 0, 0, 48, 26, 116, 14, 130
INVAR-37, Run: 093, F, 0, 0, 48, 237, 388, 225, 613
INVAR-37, Run: 094, F, 0, 0, 48, 112, 988, 100, 1088
INVAR-37, Run: 095, F, 0, 0, 48, 35, 181, 23, 204
INVAR-37, Run: 096, F, 0, 0, 48, 27, 203, 15, 218
INVAR-37, Run: 097, F, 0, 0, 48, 19, 61, 7, 68
INVAR-37, Run: 098, F, 0, 0, 48, 270, 764, 258, 1022
INVAR-37, Run: 099, F, 0, 0, 48, 628, 1521, 616, 2137
INVAR-37, Run: 100, F, 0, 48, 0, 285, 137, 321, 458
INVAR-38, Run: 001, F, 0, 0, 104, 153, 696, 121, 817
INVAR-38, Run: 002, F, 0, 0, 104, 994, 1732, 962, 2694
INVAR-38, Run: 003, F, 0, 0, 104, 2121, 4394, 2089, 6483
INVAR-38, Run: 004, F, 0, 0, 104, 423, 1140, 391, 1531
INVAR-38, Run: 005, F, 0, 0, 104, 130, 502, 98, 600
INVAR-38, Run: 006, F, 0, 104, 0, 956, 542, 1028, 1570
INVAR-38, Run: 007, F, 0, 104, 0, 1762, 1729, 1834, 3563
INVAR-38, Run: 008, F, 0, 0, 104, 4282, 3936, 4250, 8186
INVAR-38, Run: 009, F, 0, 104, 0, 2939, 1414, 3011, 4425
INVAR-38, Run: 010, F, 0, 0, 104, 319, 1717, 287, 2004
INVAR-38, Run: 011, F, 0, 0, 104, 953, 3125, 921, 4046
INVAR-38, Run: 012, F, 0, 0, 104, 339, 2095, 307, 2402
INVAR-38, Run: 013, F, 0, 104, 0, 817, 747, 889, 1636
INVAR-38, Run: 014, F, 0, 0, 104, 652, 2242, 620, 2862
INVAR-38, Run: 015, F, 0, 0, 104, 490, 1456, 458, 1914
INVAR-38, Run: 016, F, 0, 104, 0, 552, 393, 624, 1017
INVAR-38, Run: 017, F, 0, 0, 104, 368, 706, 336, 1042
INVAR-38, Run: 018, F, 0, 0, 104, 473, 1122, 441, 1563
INVAR-38, Run: 019, F, 0, 0, 104, 170, 699, 138, 837
INVAR-38, Run: 020, F, 0, 104, 0, 892, 426, 964, 1390
INVAR-38, Run: 021, F, 0, 104, 0, 1072, 1318, 1144, 2462
INVAR-38, Run: 022, F, 0, 0, 104, 247, 925, 215, 1140
INVAR-38, Run: 023, F, 0, 0, 104, 2170, 4708, 2138, 6846
INVAR-38, Run: 024, F, 0, 0, 104, 382, 1326, 350, 1676
INVAR-38, Run: 025, F, 0, 0, 104, 2081, 3187, 2049, 5236
INVAR-38, Run: 026, F, 0, 104, 0, 3138, 3724, 3210, 6934
INVAR-38, Run: 027, F, 0, 0, 104, 739, 3107, 707, 3814
INVAR-38, Run: 028, F, 0, 104, 0, 1441, 543, 1513, 2056
INVAR-38, Run: 029, F, 0, 0, 104, 1242, 5389, 1210, 6599
INVAR-38, Run: 030, F, 0, 104, 0, 1776, 2892, 1848, 4740
INVAR-38, Run: 031, F, 0, 0, 104, 1252, 1653, 1220, 2873
INVAR-38, Run: 032, F, 0, 0, 104, 583, 2633, 551, 3184
INVAR-38, Run: 033, F, 0, 0, 104, 6819, 12925, 6787, 19712
INVAR-38, Run: 034, F, 0, 104, 0, 794, 461, 866, 1327
INVAR-38, Run: 035, F, 0, 0, 104, 3925, 5352, 3893, 9245
INVAR-38, Run: 036, F, 0, 104, 0, 3071, 5348, 3143, 8491
INVAR-38, Run: 037, F, 0, 0, 104, 402, 2487, 370, 2857
INVAR-38, Run: 038, F, 0, 0, 104, 5050, 3379, 5018, 8397
INVAR-38, Run: 039, F, 0, 104, 0, 1240, 625, 1312, 1937
INVAR-38, Run: 040, F, 0, 0, 104, 274, 756, 242, 998
INVAR-38, Run: 041, F, 0, 0, 104, 257, 1151, 225, 1376
INVAR-38, Run: 042, F, 0, 104, 0, 1713, 1296, 1785, 3081
INVAR-38, Run: 043, F, 0, 0, 104, 922, 3529, 890, 4419
INVAR-38, Run: 044, F, 0, 104, 0, 1158, 1344, 1230, 2574
INVAR-38, Run: 045, F, 0, 0, 104, 2985, 5381, 2953, 8334
INVAR-38, Run: 046, F, 0, 0, 104, 544, 3281, 512, 3793
INVAR-38, Run: 047, F, 0, 0, 104, 592, 1967, 560, 2527
INVAR-38, Run: 048, F, 0, 0, 104, 338, 710, 306, 1016
INVAR-38, Run: 049, F, 0, 0, 104, 540, 3371, 508, 3879
INVAR-38, Run: 050, F, 0, 0, 104, 290, 1201, 258, 1459
INVAR-38, Run: 051, F, 0, 0, 104, 1272, 1571, 1240, 2811
INVAR-38, Run: 052, F, 0, 0, 104, 484, 1759, 452, 2211
INVAR-38, Run: 053, F, 0, 0, 104, 903, 2953, 871, 3824
INVAR-38, Run: 054, F, 0, 0, 104, 1090, 3203, 1058, 4261
INVAR-38, Run: 055, F, 0, 0, 104, 181, 1322, 149, 1471
INVAR-38, Run: 056, F, 0, 0, 104, 528, 1866, 496, 2362
INVAR-38, Run: 057, F, 0, 104, 0, 496, 903, 568, 1471
INVAR-38, Run: 058, F, 0, 0, 104, 234, 741, 202, 943
INVAR-38, Run: 059, F, 0, 0, 104, 396, 1880, 364, 2244
INVAR-38, Run: 060, F, 0, 0, 104, 254, 3487, 222, 3709
INVAR-38, Run: 061, F, 0, 0, 104, 3805, 10657, 3773, 14430
INVAR-38, Run: 062, F, 0, 0, 104, 443, 1311, 411, 1722
INVAR-38, Run: 063, F, 0, 0, 104, 707, 2127, 675, 2802
INVAR-38, Run: 064, F, 0, 0, 104, 439, 1118, 407, 1525
INVAR-38, Run: 065, F, 0, 104, 0, 1063, 429, 1135, 1564
INVAR-38, Run: 066, F, 0, 0, 104, 100, 759, 68, 827
INVAR-38, Run: 067, F, 0, 0, 104, 124, 553, 92, 645
INVAR-38, Run: 068, F, 0, 104, 0, 3785, 3109, 3857, 6966
INVAR-38, Run: 069, F, 0, 0, 104, 171, 663, 139, 802
INVAR-38, Run: 070, F, 0, 104, 0, 1611, 1593, 1683, 3276
INVAR-38, Run: 071, F, 0, 0, 104, 622, 2135, 590, 2725
INVAR-38, Run: 072, F, 0, 104, 0, 2422, 4101, 2494, 6595
INVAR-38, Run: 073, F, 0, 104, 0, 2524, 1568, 2596, 4164
INVAR-38, Run: 074, F, 0, 0, 104, 349, 2357, 317, 2674
INVAR-38, Run: 075, F, 0, 0, 104, 192, 1655, 160, 1815
INVAR-38, Run: 076, F, 0, 0, 104, 587, 1944, 555, 2499
INVAR-38, Run: 077, F, 0, 0, 104, 363, 1860, 331, 2191
INVAR-38, Run: 078, F, 0, 0, 104, 1425, 4931, 1393, 6324
INVAR-38, Run: 079, F, 0, 104, 0, 991, 490, 1063, 1553
INVAR-38, Run: 080, F, 0, 104, 0, 1916, 3263, 1988, 5251
INVAR-38, Run: 081, F, 0, 0, 104, 178, 846, 146, 992
INVAR-38, Run: 082, F, 0, 0, 104, 3281, 4309, 3249, 7558
INVAR-38, Run: 083, F, 0, 104, 0, 1482, 1124, 1554, 2678
INVAR-38, Run: 084, F, 0, 0, 104, 520, 1860, 488, 2348
INVAR-38, Run: 085, F, 0, 0, 104, 378, 1237, 346, 1583
INVAR-38, Run: 086, F, 0, 0, 104, 155, 561, 123, 684
INVAR-38, Run: 087, F, 0, 104, 0, 6980, 9772, 7052, 16824
INVAR-38, Run: 088, F, 0, 0, 104, 256, 1668, 224, 1892
INVAR-38, Run: 089, F, 0, 0, 104, 192, 2189, 160, 2349
INVAR-38, Run: 090, F, 0, 0, 104, 574, 1509, 542, 2051
INVAR-38, Run: 091, F, 0, 0, 104, 1186, 4019, 1154, 5173
INVAR-38, Run: 092, F, 0, 0, 104, 2684, 6327, 2652, 8979
INVAR-38, Run: 093, F, 0, 104, 0, 1848, 1493, 1920, 3413
INVAR-38, Run: 094, F, 0, 104, 0, 207, 146, 279, 425
INVAR-38, Run: 095, F, 0, 104, 0, 653, 472, 725, 1197
INVAR-38, Run: 096, F, 0, 0, 104, 661, 3683, 629, 4312
INVAR-38, Run: 097, F, 0, 104, 0, 1578, 461, 1650, 2111
INVAR-38, Run: 098, F, 0, 0, 104, 3206, 5798, 3174, 8972
INVAR-38, Run: 099, F, 0, 104, 0, 993, 869, 1065, 1934
INVAR-38, Run: 100, F, 0, 104, 0, 1486, 1008, 1558, 2566
INVAR-39, Run: 001, F, 0, 214, 0, 12487, 7017, 12673, 19690
INVAR-39, Run: 002, F, 0, 0, 214, 197, 3238, 169, 3407
INVAR-39, Run: 003, F, 0, 0, 214, 393, 5375, 365, 5740
INVAR-39, Run: 004, F, 0, 0, 214, 403, 3686, 375, 4061
INVAR-39, Run: 005, F, 0, 0, 214, 8767, 20913, 8739, 29652
INVAR-39, Run: 006, F, 0, 0, 214, 6959, 19745, 6931, 26676
INVAR-39, Run: 007, F, 0, 0, 214, 4701, 11038, 4673, 15711
INVAR-39, Run: 008, F, 0, 0, 214, 399, 3411, 371, 3782
INVAR-39, Run: 009, F, 0, 214, 0, 5070, 9194, 5256, 14450
INVAR-39, Run: 010, F, 0, 0, 214, 229, 2965, 201, 3166
INVAR-39, Run: 011, F, 0, 0, 214, 163, 1373, 135, 1508
INVAR-39, Run: 012, F, 0, 0, 214, 1147, 6615, 1119, 7734
INVAR-39, Run: 013, F, 0, 0, 214, 134, 2364, 106, 2470
INVAR-39, Run: 014, F, 0, 0, 214, 590, 5357, 562, 5919
INVAR-39, Run: 015, F, 0, 0, 214, 99, 1730, 71, 1801
INVAR-39, Run: 016, F, 0, 0, 214, 602, 7335, 574, 7909
INVAR-39, Run: 017, F, 0, 0, 214, 2920, 6628, 2892, 9520
INVAR-39, Run: 018, F, 0, 0, 214, 2550, 18472, 2522, 20994
INVAR-39, Run: 019, F, 0, 0, 214, 3891, 7896, 3863, 11759
INVAR-39, Run: 020, F, 0, 214, 0, 8885, 26231, 9071, 35302
INVAR-39, Run: 021, F, 0, 0, 214, 1903, 16246, 1875, 18121
INVAR-39, Run: 022, F, 0, 0, 214, 1789, 8266, 1761, 10027
INVAR-39, Run: 023, F, 0, 0, 214, 159, 2354, 131, 2485
INVAR-39, Run: 024, F, 0, 214, 0, 3806, 6892, 3992, 10884
INVAR-39, Run: 025, F, 0, 0, 214, 2078, 5813, 2050, 7863
INVAR-39, Run: 026, F, 0, 0, 214, 106, 1549, 78, 1627
INVAR-39, Run: 027, F, 0, 0, 214, 8650, 20128, 8622, 28750
INVAR-39, Run: 028, F, 0, 0, 214, 491, 3622, 463, 4085
INVAR-39, Run: 029, F, 0, 0, 214, 253, 2836, 225, 3061
INVAR-39, Run: 030, F, 0, 0, 214, 350, 4572, 322, 4894
INVAR-39, Run: 031, F, 0, 0, 214, 112, 1862, 84, 1946
INVAR-39, Run: 032, F, 0, 0, 214, 447, 3866, 419, 4285
INVAR-39, Run: 033, F, 0, 0, 214, 2808, 15199, 2780, 17979
INVAR-39, Run: 034, F, 0, 0, 214, 560, 5260, 532, 5792
INVAR-39, Run: 035, F, 0, 0, 214, 9244, 13245, 9216, 22461
INVAR-39, Run: 036, F, 0, 214, 0, 7115, 6872, 7301, 14173
INVAR-39, Run: 037, F, 0, 0, 214, 307, 3697, 279, 3976
INVAR-39, Run: 038, F, 0, 0, 214, 329, 2781, 301, 3082
INVAR-39, Run: 039, F, 0, 0, 214, 2923, 9392, 2895, 12287
INVAR-39, Run: 040, F, 0, 0, 214, 5751, 16951, 5723, 22674
INVAR-39, Run: 041, F, 0, 0, 214, 140, 3239, 112, 3351
INVAR-39, Run: 042, F, 0, 0, 214, 3142, 9215, 3114, 12329
INVAR-39, Run: 043, F, 0, 214, 0, 2944, 2977, 3130, 6107
INVAR-39, Run: 044, F, 0, 214, 0, 2012, 6307, 2198, 8505
INVAR-39, Run: 045, F, 0, 0, 214, 869, 6636, 841, 7477
INVAR-39, Run: 046, F, 0, 0, 214, 263, 8937, 235, 9172
INVAR-39, Run: 047, F, 0, 0, 214, 357, 5198, 329, 5527
INVAR-39, Run: 048, F, 0, 0, 214, 100, 2933, 72, 3005
INVAR-39, Run: 049, F, 0, 0, 214, 1496, 14273, 1468, 15741
INVAR-39, Run: 050, F, 0, 0, 214, 5080, 13707, 5052, 18759
INVAR-39, Run: 051, F, 0, 214, 0, 15123, 9312, 15309, 24621
INVAR-39, Run: 052, F, 0, 0, 214, 270, 4726, 242, 4968
INVAR-39, Run: 053, F, 0, 0, 214, 2732, 7525, 2704, 10229
INVAR-39, Run: 054, F, 0, 0, 214, 3984, 13254, 3956, 17210
INVAR-39, Run: 055, F, 0, 0, 214, 357, 3470, 329, 3799
INVAR-39, Run: 056, F, 0, 0, 214, 1577, 8441, 1549, 9990
INVAR-39, Run: 057, F, 0, 0, 214, 6300, 18061, 6272, 24333
INVAR-39, Run: 058, F, 0, 0, 214, 89, 1816, 61, 1877
INVAR-39, Run: 059, F, 0, 0, 214, 328, 3908, 300, 4208
INVAR-39, Run: 060, F, 0, 0, 214, 1974, 6794, 1946, 8740
INVAR-39, Run: 061, F, 0, 0, 214, 205, 2393, 177, 2570
INVAR-39, Run: 062, F, 0, 0, 214, 476, 5455, 448, 5903
INVAR-39, Run: 063, F, 0, 0, 214, 72, 1564, 44, 1608
INVAR-39, Run: 064, F, 0, 0, 214, 1750, 6850, 1722, 8572
INVAR-39, Run: 065, F, 0, 0, 214, 575, 5860, 547, 6407
INVAR-39, Run: 066, F, 0, 0, 214, 142, 2565, 114, 2679
INVAR-39, Run: 067, F, 0, 0, 214, 97, 1973, 69, 2042
INVAR-39, Run: 068, F, 0, 214, 0, 2979, 3731, 3165, 6896
INVAR-39, Run: 069, F, 0, 0, 214, 324, 3157, 296, 3453
INVAR-39, Run: 070, F, 0, 0, 214, 145, 1325, 117, 1442
INVAR-39, Run: 071, F, 0, 0, 214, 224, 3325, 196, 3521
INVAR-39, Run: 072, F, 0, 0, 214, 87, 1073, 59, 1132
INVAR-39, Run: 073, F, 0, 0, 214, 519, 5432, 491, 5923
INVAR-39, Run: 074, F, 0, 0, 214, 164, 2409, 136, 2545
INVAR-39, Run: 075, F, 0, 0, 214, 117, 1468, 89, 1557
INVAR-39, Run: 076, F, 0, 0, 214, 292, 2877, 264, 3141
INVAR-39, Run: 077, F, 0, 0, 214, 933, 7455, 905, 8360
INVAR-39, Run: 078, F, 0, 0, 214, 1187, 12943, 1159, 14102
INVAR-39, Run: 079, F, 0, 0, 214, 6186, 12284, 6158, 18442
INVAR-39, Run: 080, F, 0, 0, 214, 208, 1929, 180, 2109
INVAR-39, Run: 081, F, 0, 0, 214, 3315, 14671, 3287, 17958
INVAR-39, Run: 082, F, 0, 0, 214, 1498, 7856, 1470, 9326
INVAR-39, Run: 083, F, 0, 0, 214, 2772, 12142, 2744, 14886
INVAR-39, Run: 084, F, 0, 0, 214, 2853, 21209, 2825, 24034
INVAR-39, Run: 085, F, 0, 0, 214, 711, 9116, 683, 9799
INVAR-39, Run: 086, F, 0, 214, 0, 11890, 8708, 12076, 20784
INVAR-39, Run: 087, F, 0, 0, 214, 351, 3980, 323, 4303
INVAR-39, Run: 088, F, 0, 0, 214, 379, 3052, 351, 3403
INVAR-39, Run: 089, F, 0, 0, 214, 250, 3498, 222, 3720
INVAR-39, Run: 090, F, 0, 0, 214, 10039, 29611, 10011, 39622
INVAR-39, Run: 091, F, 0, 0, 214, 1417, 8909, 1389, 10298
INVAR-39, Run: 092, F, 0, 214, 0, 9505, 15814, 9691, 25505
INVAR-39, Run: 093, F, 0, 0, 214, 1977, 7635, 1949, 9584
INVAR-39, Run: 094, F, 0, 214, 0, 6184, 3428, 6370, 9798
INVAR-39, Run: 095, F, 0, 0, 214, 814, 5252, 786, 6038
INVAR-39, Run: 096, F, 0, 0, 214, 381, 5290, 353, 5643
INVAR-39, Run: 097, F, 0, 0, 214, 601, 3626, 573, 4199
INVAR-39, Run: 098, F, 0, 0, 214, 722, 4926, 694, 5620
INVAR-39, Run: 099, F, 0, 214, 0, 3935, 4945, 4121, 9066
INVAR-39, Run: 100, F, 0, 0, 214, 177, 3877, 149, 4026
INVAR-4, Run: 001, F, 0, 0, 45, 152, 584, 137, 721
INVAR-4, Run: 002, F, 0, 45, 0, 249, 179, 279, 458
INVAR-4, Run: 003, F, 0, 0, 45, 103, 476, 88, 564
INVAR-4, Run: 004, F, 0, 0, 45, 214, 285, 199, 484
INVAR-4, Run: 005, F, 0, 0, 45, 47, 247, 32, 279
INVAR-4, Run: 006, F, 0, 45, 0, 124, 59, 154, 213
INVAR-4, Run: 007, F, 0, 0, 45, 124, 200, 109, 309
INVAR-4, Run: 008, F, 0, 0, 45, 368, 686, 353, 1039
INVAR-4, Run: 009, F, 0, 0, 45, 29, 162, 14, 176
INVAR-4, Run: 010, F, 0, 0, 45, 163, 598, 148, 746
INVAR-4, Run: 011, F, 0, 0, 45, 106, 248, 91, 339
INVAR-4, Run: 012, F, 0, 0, 45, 387, 540, 372, 912
INVAR-4, Run: 013, F, 0, 0, 45, 260, 436, 245, 681
INVAR-4, Run: 014, F, 0, 0, 45, 313, 576, 298, 874
INVAR-4, Run: 015, F, 0, 0, 45, 135, 205, 120, 325
INVAR-4, Run: 016, F, 0, 0, 45, 72, 190, 57, 247
INVAR-4, Run: 017, F, 0, 0, 45, 408, 695, 393, 1088
INVAR-4, Run: 018, F, 0, 0, 45, 42, 127, 27, 154
INVAR-4, Run: 019, F, 0, 0, 45, 96, 286, 81, 367
INVAR-4, Run: 020, F, 0, 0, 45, 366, 547, 351, 898
INVAR-4, Run: 021, F, 0, 0, 45, 120, 338, 105, 443
INVAR-4, Run: 022, F, 0, 0, 45, 46, 232, 31, 263
INVAR-4, Run: 023, F, 0, 0, 45, 186, 769, 171, 940
INVAR-4, Run: 024, F, 0, 45, 0, 957, 1052, 987, 2039
INVAR-4, Run: 025, F, 0, 0, 45, 1094, 1663, 1079, 2742
INVAR-4, Run: 026, F, 0, 0, 45, 76, 242, 61, 303
INVAR-4, Run: 027, F, 0, 45, 0, 396, 333, 426, 759
INVAR-4, Run: 028, F, 0, 45, 0, 394, 232, 424, 656
INVAR-4, Run: 029, F, 0, 45, 0, 670, 338, 700, 1038
INVAR-4, Run: 030, F, 0, 45, 0, 173, 106, 203, 309
INVAR-4, Run: 031, F, 0, 45, 0, 181, 128, 211, 339
INVAR-4, Run: 032, F, 0, 45, 0, 285, 167, 315, 482
INVAR-4, Run: 033, F, 0, 0, 45, 185, 367, 170, 537
INVAR-4, Run: 034, F, 0, 45, 0, 249, 179, 279, 458
INVAR-4, Run: 035, F, 0, 0, 45, 53, 317, 38, 355
INVAR-4, Run: 036, F, 0, 0, 45, 113, 365, 98, 463
INVAR-4, Run: 037, F, 0, 0, 45, 73, 286, 58, 344
INVAR-4, Run: 038, F, 0, 45, 0, 212, 271, 242, 513
INVAR-4, Run: 039, F, 0, 0, 45, 105, 221, 90, 311
INVAR-4, Run: 040, F, 0, 0, 45, 30, 110, 15, 125
INVAR-4, Run: 041, F, 0, 0, 45, 108, 268, 93, 361
INVAR-4, Run: 042, F, 0, 45, 0, 424, 658, 454, 1112
INVAR-4, Run: 043, F, 0, 45, 0, 118, 54, 148, 202
INVAR-4, Run: 044, F, 0, 0, 45, 576, 490, 561, 1051
INVAR-4, Run: 045, F, 0, 0, 45, 778, 1259, 763, 2022
INVAR-4, Run: 046, F, 0, 0, 45, 85, 275, 70, 345
INVAR-4, Run: 047, F, 0, 0, 45, 51, 289, 36, 325
INVAR-4, Run: 048, F, 0, 0, 45, 86, 290, 71, 361
INVAR-4, Run: 049, F, 0, 0, 45, 38, 156, 23, 179
INVAR-4, Run: 050, F, 0, 45, 0, 69, 31, 99, 130
INVAR-4, Run: 051, F, 0, 0, 45, 92, 335, 77, 412
INVAR-4, Run: 052, F, 0, 45, 0, 261, 277, 291, 568
INVAR-4, Run: 053, F, 0, 0, 45, 487, 921, 472, 1393
INVAR-4, Run: 054, F, 0, 0, 45, 170, 205, 155, 360
INVAR-4, Run: 055, F, 0, 0, 45, 182, 828, 167, 995
INVAR-4, Run: 056, F, 0, 0, 45, 124, 394, 109, 503
INVAR-4, Run: 057, F, 0, 0, 45, 46, 140, 31, 171
INVAR-4, Run: 058, F, 0, 0, 45, 21, 118, 6, 124
INVAR-4, Run: 059, F, 0, 45, 0, 462, 440, 492, 932
INVAR-4, Run: 060, F, 0, 0, 45, 376, 894, 361, 1255
INVAR-4, Run: 061, F, 0, 0, 45, 50, 131, 35, 166
INVAR-4, Run: 062, F, 0, 45, 0, 146, 124, 176, 300
INVAR-4, Run: 063, F, 0, 0, 45, 105, 424, 90, 514
INVAR-4, Run: 064, F, 0, 45, 0, 308, 258, 338, 596
INVAR-4, Run: 065, F, 0, 45, 0, 139, 97, 169, 266
INVAR-4, Run: 066, F, 0, 0, 45, 97, 373, 82, 455
INVAR-4, Run: 067, F, 0, 0, 45, 146, 293, 131, 424
INVAR-4, Run: 068, F, 0, 0, 45, 101, 293, 86, 379
INVAR-4, Run: 069, F, 0, 45, 0, 50, 20, 80, 100
INVAR-4, Run: 070, F, 0, 45, 0, 131, 72, 161, 233
INVAR-4, Run: 071, F, 0, 0, 45, 73, 272, 58, 330
INVAR-4, Run: 072, F, 0, 0, 45, 785, 1136, 770, 1906
INVAR-4, Run: 073, F, 0, 0, 45, 69, 225, 54, 279
INVAR-4, Run: 074, F, 0, 0, 45, 165, 489, 150, 639
INVAR-4, Run: 075, F, 0, 0, 45, 232, 401, 217, 618
INVAR-4, Run: 076, F, 0, 0, 45, 143, 297, 128, 425
INVAR-4, Run: 077, F, 0, 0, 45, 67, 234, 52, 286
INVAR-4, Run: 078, F, 0, 0, 45, 173, 542, 158, 700
INVAR-4, Run: 079, F, 0, 0, 45, 275, 449, 260, 709
INVAR-4, Run: 080, F, 0, 0, 45, 200, 417, 185, 602
INVAR-4, Run: 081, F, 0, 0, 45, 301, 372, 286, 658
INVAR-4, Run: 082, F, 0, 0, 45, 256, 934, 241, 1175
INVAR-4, Run: 083, F, 0, 0, 45, 259, 479, 244, 723
INVAR-4, Run: 084, F, 0, 0, 45, 125, 348, 110, 458
INVAR-4, Run: 085, F, 0, 0, 45, 477, 1121, 462, 1583
INVAR-4, Run: 086, F, 0, 0, 45, 573, 895, 558, 1453
INVAR-4, Run: 087, F, 0, 0, 45, 134, 490, 119, 609
INVAR-4, Run: 088, F, 0, 0, 45, 57, 118, 42, 160
INVAR-4, Run: 089, F, 0, 0, 45, 105, 156, 90, 246
INVAR-4, Run: 090, F, 0, 0, 45, 77, 236, 62, 298
INVAR-4, Run: 091, F, 0, 45, 0, 306, 208, 336, 544
INVAR-4, Run: 092, F, 0, 0, 45, 47, 237, 32, 269
INVAR-4, Run: 093, F, 0, 0, 45, 49, 258, 34, 292
INVAR-4, Run: 094, F, 0, 0, 45, 236, 579, 221, 800
INVAR-4, Run: 095, F, 0, 0, 45, 786, 1339, 771, 2110
INVAR-4, Run: 096, F, 0, 0, 45, 54, 163, 39, 202
INVAR-4, Run: 097, F, 0, 0, 45, 152, 524, 137, 661
INVAR-4, Run: 098, F, 0, 0, 45, 88, 208, 73, 281
INVAR-4, Run: 099, F, 0, 45, 0, 148, 77, 178, 255
INVAR-4, Run: 100, F, 0, 0, 45, 340, 443, 325, 768
INVAR-40, Run: 001, F, 0, 55, 0, 522, 721, 568, 1289
INVAR-40, Run: 002, F, 0, 0, 55, 15, 135, 6, 141
INVAR-40, Run: 003, F, 0, 0, 55, 822, 1972, 813, 2785
INVAR-40, Run: 004, F, 0, 0, 55, 47, 494, 38, 532
INVAR-40, Run: 005, F, 0, 55, 0, 562, 343, 608, 951
INVAR-40, Run: 006, F, 0, 0, 55, 242, 840, 233, 1073
INVAR-40, Run: 007, F, 0, 0, 55, 44, 392, 35, 427
INVAR-40, Run: 008, F, 0, 0, 55, 53, 371, 44, 415
INVAR-40, Run: 009, F, 0, 0, 55, 85, 652, 76, 728
INVAR-40, Run: 010, F, 0, 0, 55, 98, 456, 89, 545
INVAR-40, Run: 011, F, 0, 0, 55, 178, 732, 169, 901
INVAR-40, Run: 012, F, 0, 0, 55, 165, 461, 156, 617
INVAR-40, Run: 013, F, 0, 0, 55, 83, 381, 74, 455
INVAR-40, Run: 014, F, 0, 0, 55, 15, 187, 6, 193
INVAR-40, Run: 015, F, 0, 0, 55, 121, 481, 112, 593
INVAR-40, Run: 016, F, 0, 0, 55, 263, 434, 254, 688
INVAR-40, Run: 017, F, 0, 55, 0, 573, 1444, 619, 2063
INVAR-40, Run: 018, F, 0, 0, 55, 49, 291, 40, 331
INVAR-40, Run: 019, F, 0, 0, 55, 37, 425, 28, 453
INVAR-40, Run: 020, F, 0, 0, 55, 236, 1003, 227, 1230
INVAR-40, Run: 021, F, 0, 0, 55, 64, 494, 55, 549
INVAR-40, Run: 022, F, 0, 0, 55, 26, 247, 17, 264
INVAR-40, Run: 023, F, 0, 0, 55, 14, 54, 5, 59
INVAR-40, Run: 024, F, 0, 55, 0, 298, 382, 344, 726
INVAR-40, Run: 025, F, 0, 55, 0, 846, 1583, 892, 2475
INVAR-40, Run: 026, F, 0, 0, 55, 161, 1154, 152, 1306
INVAR-40, Run: 027, F, 0, 0, 55, 21, 105, 12, 117
INVAR-40, Run: 028, F, 0, 55, 0, 1051, 735, 1097, 1832
INVAR-40, Run: 029, F, 0, 0, 55, 778, 1402, 769, 2171
INVAR-40, Run: 030, F, 0, 0, 55, 58, 480, 49, 529
INVAR-40, Run: 031, F, 0, 55, 0, 523, 1035, 569, 1604
INVAR-40, Run: 032, F, 0, 0, 55, 66, 616, 57, 673
INVAR-40, Run: 033, F, 0, 0, 55, 104, 473, 95, 568
INVAR-40, Run: 034, F, 0, 0, 55, 58, 442, 49, 491
INVAR-40, Run: 035, F, 0, 55, 0, 161, 60, 207, 267
INVAR-40, Run: 036, F, 0, 0, 55, 28, 291, 19, 310
INVAR-40, Run: 037, F, 0, 0, 55, 24, 166, 15, 181
INVAR-40, Run: 038, F, 0, 0, 55, 13, 132, 4, 136
INVAR-40, Run: 039, F, 0, 0, 55, 30, 145, 21, 166
INVAR-40, Run: 040, F, 0, 0, 55, 17, 129, 8, 137
INVAR-40, Run: 041, F, 0, 0, 55, 14, 159, 5, 164
INVAR-40, Run: 042, F, 0, 0, 55, 42, 378, 33, 411
INVAR-40, Run: 043, F, 0, 0, 55, 24, 166, 15, 181
INVAR-40, Run: 044, F, 0, 55, 0, 103, 211, 149, 360
INVAR-40, Run: 045, F, 0, 0, 55, 41, 285, 32, 317
INVAR-40, Run: 046, F, 0, 55, 0, 192, 452, 238, 690
INVAR-40, Run: 047, F, 0, 0, 55, 76, 638, 67, 705
INVAR-40, Run: 048, F, 0, 0, 55, 116, 625, 107, 732
INVAR-40, Run: 049, F, 0, 0, 55, 118, 551, 109, 660
INVAR-40, Run: 050, F, 0, 0, 55, 79, 441, 70, 511
INVAR-40, Run: 051, F, 0, 0, 55, 15, 186, 6, 192
INVAR-40, Run: 052, F, 0, 0, 55, 14, 65, 5, 70
INVAR-40, Run: 053, F, 0, 0, 55, 28, 410, 19, 429
INVAR-40, Run: 054, F, 0, 0, 55, 58, 378, 49, 427
INVAR-40, Run: 055, F, 0, 55, 0, 303, 316, 349, 665
INVAR-40, Run: 056, F, 0, 0, 55, 14, 45, 5, 50
INVAR-40, Run: 057, F, 0, 0, 55, 58, 318, 49, 367
INVAR-40, Run: 058, F, 0, 0, 55, 15, 41, 6, 47
INVAR-40, Run: 059, F, 0, 0, 55, 1041, 2253, 1032, 3285
INVAR-40, Run: 060, F, 0, 0, 55, 88, 274, 79, 353
INVAR-40, Run: 061, F, 0, 0, 55, 27, 338, 18, 356
INVAR-40, Run: 062, F, 0, 0, 55, 64, 494, 55, 549
INVAR-40, Run: 063, F, 0, 0, 55, 25, 181, 16, 197
INVAR-40, Run: 064, F, 0, 55, 0, 285, 371, 331, 702
INVAR-40, Run: 065, F, 0, 0, 55, 31, 277, 22, 299
INVAR-40, Run: 066, F, 0, 0, 55, 603, 1284, 594, 1878
INVAR-40, Run: 067, F, 0, 0, 55, 109, 550, 100, 650
INVAR-40, Run: 068, F, 0, 55, 0, 455, 449, 501, 950
INVAR-40, Run: 069, F, 0, 0, 55, 23, 175, 14, 189
INVAR-40, Run: 070, F, 0, 0, 55, 33, 291, 24, 315
INVAR-40, Run: 071, F, 0, 0, 55, 31, 225, 22, 247
INVAR-40, Run: 072, F, 0, 0, 55, 65, 487, 56, 543
INVAR-40, Run: 073, F, 0, 0, 55, 22, 280, 13, 293
INVAR-40, Run: 074, F, 0, 0, 55, 150, 572, 141, 713
INVAR-40, Run: 075, F, 0, 0, 55, 10, 98, 1, 99
INVAR-40, Run: 076, F, 0, 0, 55, 12, 117, 3, 120
INVAR-40, Run: 077, F, 0, 0, 55, 257, 500, 248, 748
INVAR-40, Run: 078, F, 0, 0, 55, 66, 410, 57, 467
INVAR-40, Run: 079, F, 0, 55, 0, 585, 261, 631, 892
INVAR-40, Run: 080, F, 0, 0, 55, 97, 495, 88, 583
INVAR-40, Run: 081, F, 0, 0, 55, 27, 134, 18, 152
INVAR-40, Run: 082, F, 0, 0, 55, 418, 993, 409, 1402
INVAR-40, Run: 083, F, 0, 0, 55, 105, 780, 96, 876
INVAR-40, Run: 084, F, 0, 0, 55, 31, 335, 22, 357
INVAR-40, Run: 085, F, 0, 0, 55, 32, 239, 23, 262
INVAR-40, Run: 086, F, 0, 0, 55, 237, 802, 228, 1030
INVAR-40, Run: 087, F, 0, 0, 55, 154, 907, 145, 1052
INVAR-40, Run: 088, F, 0, 0, 55, 235, 977, 226, 1203
INVAR-40, Run: 089, F, 0, 55, 0, 375, 139, 421, 560
INVAR-40, Run: 090, F, 0, 55, 0, 305, 654, 351, 1005
INVAR-40, Run: 091, F, 0, 0, 55, 57, 479, 48, 527
INVAR-40, Run: 092, F, 0, 55, 0, 348, 332, 394, 726
INVAR-40, Run: 093, F, 0, 0, 55, 47, 260, 38, 298
INVAR-40, Run: 094, F, 0, 0, 55, 67, 299, 58, 357
INVAR-40, Run: 095, F, 0, 0, 55, 413, 885, 404, 1289
INVAR-40, Run: 096, F, 0, 55, 0, 65, 63, 111, 174
INVAR-40, Run: 097, F, 0, 0, 55, 14, 108, 5, 113
INVAR-40, Run: 098, F, 0, 55, 0, 192, 198, 238, 436
INVAR-40, Run: 099, F, 0, 55, 0, 648, 724, 694, 1418
INVAR-40, Run: 100, F, 0, 0, 55, 114, 402, 105, 507
INVAR-41, Run: 001, F, 0, 0, 103, 38, 383, 31, 414
INVAR-41, Run: 002, F, 0, 0, 103, 1496, 3326, 1489, 4815
INVAR-41, Run: 003, F, 0, 0, 103, 92, 749, 85, 834
INVAR-41, Run: 004, F, 0, 0, 103, 18, 360, 11, 371
INVAR-41, Run: 005, F, 0, 0, 103, 15, 342, 8, 350
INVAR-41, Run: 006, F, 0, 0, 103, 18, 583, 11, 594
INVAR-41, Run: 007, F, 0, 0, 103, 11, 208, 4, 212
INVAR-41, Run: 008, F, 0, 0, 103, 573, 5132, 566, 5698
INVAR-41, Run: 009, F, 0, 0, 103, 121, 1806, 114, 1920
INVAR-41, Run: 010, F, 0, 0, 103, 32, 587, 25, 612
INVAR-41, Run: 011, F, 0, 0, 103, 1927, 4925, 1920, 6845
INVAR-41, Run: 012, F, 0, 0, 103, 36, 850, 29, 879
INVAR-41, Run: 013, F, 0, 0, 103, 123, 1844, 116, 1960
INVAR-41, Run: 014, F, 0, 0, 103, 32, 784, 25, 809
INVAR-41, Run: 015, F, 0, 0, 103, 23, 534, 16, 550
INVAR-41, Run: 016, F, 0, 0, 103, 471, 4150, 464, 4614
INVAR-41, Run: 017, F, 0, 0, 103, 23, 438, 16, 454
INVAR-41, Run: 018, F, 0, 0, 103, 682, 4423, 675, 5098
INVAR-41, Run: 019, F, 0, 0, 103, 10, 428, 3, 431
INVAR-41, Run: 020, F, 0, 0, 103, 7, 170, 0, 170
INVAR-41, Run: 021, F, 0, 0, 103, 106, 1485, 99, 1584
INVAR-41, Run: 022, F, 0, 0, 103, 649, 2693, 642, 3335
INVAR-41, Run: 023, F, 0, 0, 103, 36, 639, 29, 668
INVAR-41, Run: 024, F, 0, 0, 103, 186, 1953, 179, 2132
INVAR-41, Run: 025, F, 0, 0, 103, 38, 560, 31, 591
INVAR-41, Run: 026, F, 0, 0, 103, 74, 653, 67, 720
INVAR-41, Run: 027, F, 0, 0, 103, 22, 513, 15, 528
INVAR-41, Run: 028, F, 0, 0, 103, 1923, 4586, 1916, 6502
INVAR-41, Run: 029, F, 0, 0, 103, 107, 1354, 100, 1454
INVAR-41, Run: 030, F, 0, 0, 103, 14, 205, 7, 212
INVAR-41, Run: 031, F, 0, 0, 103, 158, 2322, 151, 2473
INVAR-41, Run: 032, F, 0, 0, 103, 123, 1110, 116, 1226
INVAR-41, Run: 033, F, 0, 0, 103, 49, 654, 42, 696
INVAR-41, Run: 034, F, 0, 0, 103, 34, 899, 27, 926
INVAR-41, Run: 035, F, 0, 0, 103, 101, 855, 94, 949
INVAR-41, Run: 036, F, 0, 0, 103, 1226, 2375, 1219, 3594
INVAR-41, Run: 037, F, 0, 0, 103, 59, 960, 52, 1012
INVAR-41, Run: 038, F, 0, 0, 103, 84, 1041, 77, 1118
INVAR-41, Run: 039, F, 0, 0, 103, 905, 4489, 898, 5387
INVAR-41, Run: 040, F, 0, 0, 103, 17, 232, 10, 242
INVAR-41, Run: 041, F, 0, 0, 103, 136, 1265, 129, 1394
INVAR-41, Run: 042, F, 0, 0, 103, 36, 415, 29, 444
INVAR-41, Run: 043, F, 0, 0, 103, 584, 4587, 577, 5164
INVAR-41, Run: 044, F, 0, 103, 0, 1594, 2261, 1690, 3951
INVAR-41, Run: 045, F, 0, 0, 103, 44, 833, 37, 870
INVAR-41, Run: 046, F, 0, 0, 103, 156, 2879, 149, 3028
INVAR-41, Run: 047, F, 0, 0, 103, 50, 805, 43, 848
INVAR-41, Run: 048, F, 0, 0, 103, 175, 1281, 168, 1449
INVAR-41, Run: 049, F, 0, 0, 103, 69, 723, 62, 785
INVAR-41, Run: 050, F, 0, 0, 103, 1419, 3789, 1412, 5201
INVAR-41, Run: 051, F, 0, 0, 103, 9, 190, 2, 192
INVAR-41, Run: 052, F, 0, 0, 103, 190, 2655, 183, 2838
INVAR-41, Run: 053, F, 0, 0, 103, 22, 381, 15, 396
INVAR-41, Run: 054, F, 0, 0, 103, 558, 1715, 551, 2266
INVAR-41, Run: 055, F, 0, 0, 103, 8, 177, 1, 178
INVAR-41, Run: 056, F, 0, 0, 103, 16, 255, 9, 264
INVAR-41, Run: 057, F, 0, 103, 0, 745, 2047, 841, 2888
INVAR-41, Run: 058, F, 0, 0, 103, 101, 1109, 94, 1203
INVAR-41, Run: 059, F, 0, 0, 103, 24, 657, 17, 674
INVAR-41, Run: 060, F, 0, 0, 103, 894, 2657, 887, 3544
INVAR-41, Run: 061, F, 0, 0, 103, 746, 1527, 739, 2266
INVAR-41, Run: 062, F, 0, 0, 103, 21, 437, 14, 451
INVAR-41, Run: 063, F, 0, 0, 103, 32, 846, 25, 871
INVAR-41, Run: 064, F, 0, 0, 103, 29, 278, 22, 300
INVAR-41, Run: 065, F, 0, 0, 103, 31, 618, 24, 642
INVAR-41, Run: 066, F, 0, 0, 103, 36, 709, 29, 738
INVAR-41, Run: 067, F, 0, 0, 103, 42, 707, 35, 742
INVAR-41, Run: 068, F, 0, 0, 103, 32, 650, 25, 675
INVAR-41, Run: 069, F, 0, 0, 103, 907, 2475, 900, 3375
INVAR-41, Run: 070, F, 0, 0, 103, 130, 1264, 123, 1387
INVAR-41, Run: 071, F, 0, 0, 103, 195, 1061, 188, 1249
INVAR-41, Run: 072, F, 0, 0, 103, 38, 916, 31, 947
INVAR-41, Run: 073, F, 0, 103, 0, 743, 485, 839, 1324
INVAR-41, Run: 074, F, 0, 0, 103, 36, 749, 29, 778
INVAR-41, Run: 075, F, 0, 0, 103, 12, 128, 5, 133
INVAR-41, Run: 076, F, 0, 0, 103, 16, 250, 9, 259
INVAR-41, Run: 077, F, 0, 0, 103, 146, 1875, 139, 2014
INVAR-41, Run: 078, F, 0, 0, 103, 226, 3061, 219, 3280
INVAR-41, Run: 079, F, 0, 0, 103, 13, 193, 6, 199
INVAR-41, Run: 080, F, 0, 0, 103, 245, 1501, 238, 1739
INVAR-41, Run: 081, F, 0, 0, 103, 49, 883, 42, 925
INVAR-41, Run: 082, F, 0, 0, 103, 32, 626, 25, 651
INVAR-41, Run: 083, F, 0, 0, 103, 18, 397, 11, 408
INVAR-41, Run: 084, F, 0, 0, 103, 32, 374, 25, 399
INVAR-41, Run: 085, F, 0, 0, 103, 41, 578, 34, 612
INVAR-41, Run: 086, F, 0, 0, 103, 11, 149, 4, 153
INVAR-41, Run: 087, F, 0, 0, 103, 3424, 5258, 3417, 8675
INVAR-41, Run: 088, F, 0, 0, 103, 30, 699, 23, 722
INVAR-41, Run: 089, F, 0, 0, 103, 99, 1115, 92, 1207
INVAR-41, Run: 090, F, 0, 0, 103, 387, 2609, 380, 2989
INVAR-41, Run: 091, F, 0, 0, 103, 14, 194, 7, 201
INVAR-41, Run: 092, F, 0, 0, 103, 22, 378, 15, 393
INVAR-41, Run: 093, F, 0, 0, 103, 85, 1336, 78, 1414
INVAR-41, Run: 094, F, 0, 0, 103, 509, 1722, 502, 2224
INVAR-41, Run: 095, F, 0, 103, 0, 1144, 1057, 1240, 2297
INVAR-41, Run: 096, F, 0, 0, 103, 2662, 3788, 2655, 6443
INVAR-41, Run: 097, F, 0, 0, 103, 42, 839, 35, 874
INVAR-41, Run: 098, F, 0, 0, 103, 117, 773, 110, 883
INVAR-41, Run: 099, F, 0, 0, 103, 525, 3318, 518, 3836
INVAR-41, Run: 100, F, 0, 0, 103, 23, 322, 16, 338
INVAR-42, Run: 001, F, 0, 0, 233, 515, 3391, 478, 3869
INVAR-42, Run: 002, F, 0, 0, 233, 233, 2861, 196, 3057
INVAR-42, Run: 003, F, 0, 0, 233, 986, 8100, 949, 9049
INVAR-42, Run: 004, F, 0, 0, 233, 2242, 14078, 2205, 16283
INVAR-42, Run: 005, F, 0, 0, 233, 645, 6852, 608, 7460
INVAR-42, Run: 006, F, 0, 0, 233, 2245, 4685, 2208, 6893
INVAR-42, Run: 007, F, 0, 0, 233, 4257, 14918, 4220, 19138
INVAR-42, Run: 008, F, 0, 0, 233, 252, 4916, 215, 5131
INVAR-42, Run: 009, F, 0, 0, 233, 1911, 19427, 1874, 21301
INVAR-42, Run: 010, F, 0, 233, 0, 2123, 1818, 2319, 4137
INVAR-42, Run: 011, F, 0, 0, 233, 154, 2544, 117, 2661
INVAR-42, Run: 012, F, 0, 233, 0, 21008, 25202, 21204, 46406
INVAR-42, Run: 013, F, 0, 233, 0, 4211, 3055, 4407, 7462
INVAR-42, Run: 014, F, 0, 0, 233, 255, 2015, 218, 2233
INVAR-42, Run: 015, F, 0, 0, 233, 557, 5565, 520, 6085
INVAR-42, Run: 016, F, 0, 0, 233, 332, 3975, 295, 4270
INVAR-42, Run: 017, F, 0, 0, 233, 1011, 7822, 974, 8796
INVAR-42, Run: 018, F, 0, 233, 0, 3743, 3745, 3939, 7684
INVAR-42, Run: 019, F, 0, 0, 233, 663, 5676, 626, 6302
INVAR-42, Run: 020, F, 0, 0, 233, 4929, 7853, 4892, 12745
INVAR-42, Run: 021, F, 0, 233, 0, 14906, 7980, 15102, 23082
INVAR-42, Run: 022, F, 0, 0, 233, 17638, 21321, 17601, 38922
INVAR-42, Run: 023, F, 0, 0, 233, 12851, 21555, 12814, 34369
INVAR-42, Run: 024, F, 0, 0, 233, 2605, 10089, 2568, 12657
INVAR-42, Run: 025, F, 0, 0, 233, 2353, 9307, 2316, 11623
INVAR-42, Run: 026, F, 0, 0, 233, 2491, 14868, 2454, 17322
INVAR-42, Run: 027, F, 0, 233, 0, 10577, 5484, 10773, 16257
INVAR-42, Run: 028, F, 0, 0, 233, 404, 5162, 367, 5529
INVAR-42, Run: 029, F, 0, 0, 233, 2367, 17174, 2330, 19504
INVAR-42, Run: 030, F, 0, 0, 233, 2220, 7426, 2183, 9609
INVAR-42, Run: 031, F, 0, 0, 233, 693, 4502, 656, 5158
INVAR-42, Run: 032, F, 0, 0, 233, 754, 5949, 717, 6666
INVAR-42, Run: 033, F, 0, 0, 233, 1188, 16754, 1151, 17905
INVAR-42, Run: 034, F, 0, 0, 233, 235, 1754, 198, 1952
INVAR-42, Run: 035, F, 0, 0, 233, 114, 1286, 77, 1363
INVAR-42, Run: 036, F, 0, 0, 233, 5021, 16128, 4984, 21112
INVAR-42, Run: 037, F, 0, 0, 233, 11960, 34195, 11923, 46118
INVAR-42, Run: 038, F, 0, 0, 233, 14449, 34729, 14412, 49141
INVAR-42, Run: 039, F, 0, 0, 233, 11230, 22579, 11193, 33772
INVAR-42, Run: 040, F, 0, 0, 233, 545, 4011, 508, 4519
INVAR-42, Run: 041, F, 0, 0, 233, 3825, 19917, 3788, 23705
INVAR-42, Run: 042, F, 0, 0, 233, 349, 4257, 312, 4569
INVAR-42, Run: 043, F, 0, 0, 233, 223, 3978, 186, 4164
INVAR-42, Run: 044, F, 0, 0, 233, 19111, 40448, 19074, 59522
INVAR-42, Run: 045, F, 0, 0, 233, 7012, 12972, 6975, 19947
INVAR-42, Run: 046, F, 0, 0, 233, 105, 1628, 68, 1696
INVAR-42, Run: 047, F, 0, 0, 233, 258, 4307, 221, 4528
INVAR-42, Run: 048, F, 0, 0, 233, 301, 3508, 264, 3772
INVAR-42, Run: 049, F, 0, 0, 233, 1454, 8766, 1417, 10183
INVAR-42, Run: 050, F, 0, 233, 0, 8115, 24600, 8311, 32911
INVAR-42, Run: 051, F, 0, 0, 233, 578, 6530, 541, 7071
INVAR-42, Run: 052, F, 0, 0, 233, 5022, 21714, 4985, 26699
INVAR-42, Run: 053, F, 0, 0, 233, 7408, 12418, 7371, 19789
INVAR-42, Run: 054, F, 0, 0, 233, 1184, 6382, 1147, 7529
INVAR-42, Run: 055, F, 0, 0, 233, 1199, 5796, 1162, 6958
INVAR-42, Run: 056, F, 0, 0, 233, 2714, 14798, 2677, 17475
INVAR-42, Run: 057, F, 0, 0, 233, 2095, 11083, 2058, 13141
INVAR-42, Run: 058, F, 0, 233, 0, 11673, 7312, 11869, 19181
INVAR-42, Run: 059, F, 0, 0, 233, 232, 1846, 195, 2041
INVAR-42, Run: 060, F, 0, 233, 0, 3130, 2394, 3326, 5720
INVAR-42, Run: 061, F, 0, 0, 233, 576, 6830, 539, 7369
INVAR-42, Run: 062, F, 0, 0, 233, 778, 6904, 741, 7645
INVAR-42, Run: 063, F, 0, 0, 233, 348, 4786, 311, 5097
INVAR-42, Run: 064, F, 0, 233, 0, 12686, 15754, 12882, 28636
INVAR-42, Run: 065, F, 0, 0, 233, 12589, 27252, 12552, 39804
INVAR-42, Run: 066, F, 0, 0, 233, 4648, 17354, 4611, 21965
INVAR-42, Run: 067, F, 0, 0, 233, 1142, 9160, 1105, 10265
INVAR-42, Run: 068, F, 0, 0, 233, 508, 3888, 471, 4359
INVAR-42, Run: 069, F, 0, 0, 233, 720, 6853, 683, 7536
INVAR-42, Run: 070, F, 0, 0, 233, 609, 6828, 572, 7400
INVAR-42, Run: 071, F, 0, 0, 233, 834, 7758, 797, 8555
INVAR-42, Run: 072, F, 0, 233, 0, 12291, 15953, 12487, 28440
INVAR-42, Run: 073, F, 0, 0, 233, 235, 2118, 198, 2316
INVAR-42, Run: 074, F, 0, 0, 233, 2308, 5644, 2271, 7915
INVAR-42, Run: 075, F, 0, 0, 233, 811, 13188, 774, 13962
INVAR-42, Run: 076, F, 0, 0, 233, 694, 2888, 657, 3545
INVAR-42, Run: 077, F, 0, 0, 233, 787, 6042, 750, 6792
INVAR-42, Run: 078, F, 0, 0, 233, 2935, 25752, 2898, 28650
INVAR-42, Run: 079, F, 0, 0, 233, 6406, 26710, 6369, 33079
INVAR-42, Run: 080, F, 0, 0, 233, 7264, 13860, 7227, 21087
INVAR-42, Run: 081, F, 0, 0, 233, 965, 8877, 928, 9805
INVAR-42, Run: 082, F, 0, 233, 0, 10512, 19333, 10708, 30041
INVAR-42, Run: 083, F, 0, 0, 233, 6854, 18641, 6817, 25458
INVAR-42, Run: 084, F, 0, 0, 233, 3788, 28882, 3751, 32633
INVAR-42, Run: 085, F, 0, 0, 233, 15252, 30003, 15215, 45218
INVAR-42, Run: 086, F, 0, 0, 233, 572, 4589, 535, 5124
INVAR-42, Run: 087, F, 0, 233, 0, 4891, 2656, 5087, 7743
INVAR-42, Run: 088, F, 0, 0, 233, 809, 6591, 772, 7363
INVAR-42, Run: 089, F, 0, 0, 233, 7629, 30698, 7592, 38290
INVAR-42, Run: 090, F, 0, 233, 0, 14017, 7471, 14213, 21684
INVAR-42, Run: 091, F, 0, 0, 233, 481, 5258, 444, 5702
INVAR-42, Run: 092, F, 0, 233, 0, 3167, 9707, 3363, 13070
INVAR-42, Run: 093, F, 0, 0, 233, 12043, 29988, 12006, 41994
INVAR-42, Run: 094, F, 0, 0, 233, 23494, 42309, 23457, 65766
INVAR-42, Run: 095, F, 0, 0, 233, 972, 7269, 935, 8204
INVAR-42, Run: 096, F, 0, 233, 0, 5587, 16195, 5783, 21978
INVAR-42, Run: 097, F, 0, 0, 233, 535, 3942, 498, 4440
INVAR-42, Run: 098, F, 0, 0, 233, 491, 5219, 454, 5673
INVAR-42, Run: 099, F, 0, 0, 233, 293, 2442, 256, 2698
INVAR-42, Run: 100, F, 0, 0, 233, 4037, 21703, 4000, 25703
INVAR-43, Run: 001, F, 0, 60, 0, 272, 117, 308, 425
INVAR-43, Run: 002, F, 0, 0, 60, 279, 791, 255, 1046
INVAR-43, Run: 003, F, 0, 0, 60, 47, 372, 23, 395
INVAR-43, Run: 004, F, 0, 0, 60, 1138, 2153, 1114, 3267
INVAR-43, Run: 005, F, 0, 0, 60, 156, 779, 132, 911
INVAR-43, Run: 006, F, 0, 60, 0, 177, 45, 213, 258
INVAR-43, Run: 007, F, 0, 60, 0, 258, 104, 294, 398
INVAR-43, Run: 008, F, 0, 0, 60, 261, 453, 237, 690
INVAR-43, Run: 009, F, 0, 60, 0, 113, 54, 149, 203
INVAR-43, Run: 010, F, 0, 0, 60, 121, 943, 97, 1040
INVAR-43, Run: 011, F, 0, 60, 0, 209, 89, 245, 334
INVAR-43, Run: 012, F, 0, 0, 60, 98, 337, 74, 411
INVAR-43, Run: 013, F, 0, 60, 0, 300, 235, 336, 571
INVAR-43, Run: 014, F, 0, 0, 60, 1486, 932, 1462, 2394
INVAR-43, Run: 015, F, 0, 60, 0, 452, 685, 488, 1173
INVAR-43, Run: 016, F, 0, 0, 60, 157, 530, 133, 663
INVAR-43, Run: 017, F, 0, 0, 60, 1055, 1468, 1031, 2499
INVAR-43, Run: 018, F, 0, 60, 0, 348, 234, 384, 618
INVAR-43, Run: 019, F, 0, 0, 60, 809, 1499, 785, 2284
INVAR-43, Run: 020, F, 0, 0, 60, 1307, 1546, 1283, 2829
INVAR-43, Run: 021, F, 0, 0, 60, 340, 610, 316, 926
INVAR-43, Run: 022, F, 0, 0, 60, 520, 816, 496, 1312
INVAR-43, Run: 023, F, 0, 0, 60, 114, 308, 90, 398
INVAR-43, Run: 024, F, 0, 0, 60, 194, 519, 170, 689
INVAR-43, Run: 025, F, 0, 60, 0, 568, 1272, 604, 1876
INVAR-43, Run: 026, F, 0, 0, 60, 244, 615, 220, 835
INVAR-43, Run: 027, F, 0, 0, 60, 95, 300, 71, 371
INVAR-43, Run: 028, F, 0, 0, 60, 398, 1505, 374, 1879
INVAR-43, Run: 029, F, 0, 60, 0, 621, 1073, 657, 1730
INVAR-43, Run: 030, F, 0, 0, 60, 75, 265, 51, 316
INVAR-43, Run: 031, F, 0, 0, 60, 159, 467, 135, 602
INVAR-43, Run: 032, F, 0, 60, 0, 636, 424, 672, 1096
INVAR-43, Run: 033, F, 0, 0, 60, 226, 355, 202, 557
INVAR-43, Run: 034, F, 0, 60, 0, 139, 37, 175, 212
INVAR-43, Run: 035, F, 0, 60, 0, 239, 105, 275, 380
INVAR-43, Run: 036, F, 0, 60, 0, 587, 200, 623, 823
INVAR-43, Run: 037, F, 0, 60, 0, 379, 338, 415, 753
INVAR-43, Run: 038, F, 0, 0, 60, 216, 335, 192, 527
INVAR-43, Run: 039, F, 0, 60, 0, 765, 702, 801, 1503
INVAR-43, Run: 040, F, 0, 0, 60, 1312, 1719, 1288, 3007
INVAR-43, Run: 041, F, 0, 0, 60, 366, 563, 342, 905
INVAR-43, Run: 042, F, 0, 0, 60, 249, 376, 225, 601
INVAR-43, Run: 043, F, 0, 0, 60, 82, 451, 58, 509
INVAR-43, Run: 044, F, 0, 0, 60, 502, 777, 478, 1255
INVAR-43, Run: 045, F, 0, 0, 60, 496, 518, 472, 990
INVAR-43, Run: 046, F, 0, 0, 60, 326, 729, 302, 1031
INVAR-43, Run: 047, F, 0, 0, 60, 122, 354, 98, 452
INVAR-43, Run: 048, F, 0, 0, 60, 1619, 1464, 1595, 3059
INVAR-43, Run: 049, F, 0, 0, 60, 490, 754, 466, 1220
INVAR-43, Run: 050, F, 0, 0, 60, 295, 377, 271, 648
INVAR-43, Run: 051, F, 0, 60, 0, 580, 415, 616, 1031
INVAR-43, Run: 052, F, 0, 0, 60, 213, 464, 189, 653
INVAR-43, Run: 053, F, 0, 0, 60, 68, 492, 44, 536
INVAR-43, Run: 054, F, 0, 60, 0, 139, 77, 175, 252
INVAR-43, Run: 055, F, 0, 0, 60, 326, 515, 302, 817
INVAR-43, Run: 056, F, 0, 0, 60, 188, 368, 164, 532
INVAR-43, Run: 057, F, 0, 60, 0, 343, 172, 379, 551
INVAR-43, Run: 058, F, 0, 0, 60, 327, 361, 303, 664
INVAR-43, Run: 059, F, 0, 0, 60, 100, 384, 76, 460
INVAR-43, Run: 060, F, 0, 60, 0, 219, 149, 255, 404
INVAR-43, Run: 061, F, 0, 0, 60, 185, 785, 161, 946
INVAR-43, Run: 062, F, 0, 0, 60, 81, 255, 57, 312
INVAR-43, Run: 063, F, 0, 0, 60, 1008, 1294, 984, 2278
INVAR-43, Run: 064, F, 0, 0, 60, 634, 832, 610, 1442
INVAR-43, Run: 065, F, 0, 0, 60, 234, 1482, 210, 1692
INVAR-43, Run: 066, F, 0, 0, 60, 117, 540, 93, 633
INVAR-43, Run: 067, F, 0, 60, 0, 254, 158, 290, 448
INVAR-43, Run: 068, F, 0, 60, 0, 446, 242, 482, 724
INVAR-43, Run: 069, F, 0, 0, 60, 765, 1613, 741, 2354
INVAR-43, Run: 070, F, 0, 0, 60, 71, 211, 47, 258
INVAR-43, Run: 071, F, 0, 0, 60, 1814, 3470, 1790, 5260
INVAR-43, Run: 072, F, 0, 0, 60, 901, 1617, 877, 2494
INVAR-43, Run: 073, F, 0, 0, 60, 269, 1471, 245, 1716
INVAR-43, Run: 074, F, 0, 60, 0, 75, 18, 111, 129
INVAR-43, Run: 075, F, 0, 0, 60, 212, 589, 188, 777
INVAR-43, Run: 076, F, 0, 0, 60, 148, 782, 124, 906
INVAR-43, Run: 077, F, 0, 0, 60, 133, 433, 109, 542
INVAR-43, Run: 078, F, 0, 0, 60, 88, 279, 64, 343
INVAR-43, Run: 079, F, 0, 0, 60, 97, 510, 73, 583
INVAR-43, Run: 080, F, 0, 0, 60, 330, 1171, 306, 1477
INVAR-43, Run: 081, F, 0, 0, 60, 265, 772, 241, 1013
INVAR-43, Run: 082, F, 0, 60, 0, 821, 746, 857, 1603
INVAR-43, Run: 083, F, 0, 0, 60, 69, 171, 45, 216
INVAR-43, Run: 084, F, 0, 0, 60, 228, 255, 204, 459
INVAR-43, Run: 085, F, 0, 60, 0, 134, 50, 170, 220
INVAR-43, Run: 086, F, 0, 0, 60, 58, 379, 34, 413
INVAR-43, Run: 087, F, 0, 60, 0, 309, 158, 345, 503
INVAR-43, Run: 088, F, 0, 60, 0, 411, 518, 447, 965
INVAR-43, Run: 089, F, 0, 0, 60, 243, 730, 219, 949
INVAR-43, Run: 090, F, 0, 0, 60, 873, 2298, 849, 3147
INVAR-43, Run: 091, F, 0, 0, 60, 122, 234, 98, 332
INVAR-43, Run: 092, F, 0, 60, 0, 358, 248, 394, 642
INVAR-43, Run: 093, F, 0, 0, 60, 359, 1161, 335, 1496
INVAR-43, Run: 094, F, 0, 0, 60, 628, 1241, 604, 1845
INVAR-43, Run: 095, F, 0, 0, 60, 370, 1399, 346, 1745
INVAR-43, Run: 096, F, 0, 60, 0, 443, 114, 479, 593
INVAR-43, Run: 097, F, 0, 0, 60, 274, 1128, 250, 1378
INVAR-43, Run: 098, F, 0, 0, 60, 143, 608, 119, 727
INVAR-43, Run: 099, F, 0, 0, 60, 212, 1105, 188, 1293
INVAR-43, Run: 100, F, 0, 0, 60, 165, 778, 141, 919
INVAR-44, Run: 001, F, 0, 0, 144, 1993, 7429, 1947, 9376
INVAR-44, Run: 002, F, 0, 0, 144, 3094, 7311, 3048, 10359
INVAR-44, Run: 003, F, 0, 144, 0, 1815, 3572, 1913, 5485
INVAR-44, Run: 004, F, 0, 0, 144, 4637, 16059, 4591, 20650
INVAR-44, Run: 005, F, 0, 144, 0, 1451, 872, 1549, 2421
INVAR-44, Run: 006, F, 0, 144, 0, 2061, 621, 2159, 2780
INVAR-44, Run: 007, F, 0, 144, 0, 1761, 513, 1859, 2372
INVAR-44, Run: 008, F, 0, 0, 144, 579, 2333, 533, 2866
INVAR-44, Run: 009, F, 0, 144, 0, 6656, 6165, 6754, 12919
INVAR-44, Run: 010, F, 0, 144, 0, 7330, 5261, 7428, 12689
INVAR-44, Run: 011, F, 0, 0, 144, 526, 2115, 480, 2595
INVAR-44, Run: 012, F, 0, 0, 144, 890, 3700, 844, 4544
INVAR-44, Run: 013, F, 0, 0, 144, 2248, 3769, 2202, 5971
INVAR-44, Run: 014, F, 0, 0, 144, 522, 2125, 476, 2601
INVAR-44, Run: 015, F, 0, 144, 0, 6648, 11396, 6746, 18142
INVAR-44, Run: 016, F, 0, 144, 0, 2023, 1092, 2121, 3213
INVAR-44, Run: 017, F, 0, 0, 144, 169, 842, 123, 965
INVAR-44, Run: 018, F, 0, 0, 144, 3792, 6696, 3746, 10442
INVAR-44, Run: 019, F, 0, 0, 144, 4843, 10218, 4797, 15015
INVAR-44, Run: 020, F, 0, 0, 144, 103, 430, 57, 487
INVAR-44, Run: 021, F, 0, 144, 0, 1847, 795, 1945, 2740
INVAR-44, Run: 022, F, 0, 0, 144, 1724, 3320, 1678, 4998
INVAR-44, Run: 023, F, 0, 144, 0, 4316, 2700, 4414, 7114
INVAR-44, Run: 024, F, 0, 0, 144, 329, 2542, 283, 2825
INVAR-44, Run: 025, F, 0, 0, 144, 2357, 4941, 2311, 7252
INVAR-44, Run: 026, F, 0, 144, 0, 1938, 1503, 2036, 3539
INVAR-44, Run: 027, F, 0, 0, 144, 967, 2551, 921, 3472
INVAR-44, Run: 028, F, 0, 0, 144, 605, 1778, 559, 2337
INVAR-44, Run: 029, F, 0, 144, 0, 1762, 1187, 1860, 3047
INVAR-44, Run: 030, F, 0, 144, 0, 7061, 4953, 7159, 12112
INVAR-44, Run: 031, F, 0, 0, 144, 623, 4075, 577, 4652
INVAR-44, Run: 032, F, 0, 0, 144, 2711, 5315, 2665, 7980
INVAR-44, Run: 033, F, 0, 0, 144, 1663, 6064, 1617, 7681
INVAR-44, Run: 034, F, 0, 0, 144, 6549, 9791, 6503, 16294
INVAR-44, Run: 035, F, 0, 0, 144, 4402, 8960, 4356, 13316
INVAR-44, Run: 036, F, 0, 144, 0, 3888, 3941, 3986, 7927
INVAR-44, Run: 037, F, 0, 0, 144, 539, 1738, 493, 2231
INVAR-44, Run: 038, F, 0, 144, 0, 722, 389, 820, 1209
INVAR-44, Run: 039, F, 0, 0, 144, 3588, 10059, 3542, 13601
INVAR-44, Run: 040, F, 0, 0, 144, 732, 2542, 686, 3228
INVAR-44, Run: 041, F, 0, 0, 144, 1202, 5072, 1156, 6228
INVAR-44, Run: 042, F, 0, 144, 0, 3021, 3445, 3119, 6564
INVAR-44, Run: 043, F, 0, 0, 144, 3385, 8431, 3339, 11770
INVAR-44, Run: 044, F, 0, 0, 144, 273, 676, 227, 903
INVAR-44, Run: 045, F, 0, 0, 144, 654, 2137, 608, 2745
INVAR-44, Run: 046, F, 0, 0, 144, 7356, 10755, 7310, 18065
INVAR-44, Run: 047, F, 0, 144, 0, 2099, 2391, 2197, 4588
INVAR-44, Run: 048, F, 0, 0, 144, 565, 2987, 519, 3506
INVAR-44, Run: 049, F, 0, 0, 144, 941, 3754, 895, 4649
INVAR-44, Run: 050, F, 0, 144, 0, 2744, 2065, 2842, 4907
INVAR-44, Run: 051, F, 0, 144, 0, 731, 416, 829, 1245
INVAR-44, Run: 052, F, 0, 0, 144, 709, 6647, 663, 7310
INVAR-44, Run: 053, F, 0, 144, 0, 1855, 2127, 1953, 4080
INVAR-44, Run: 054, F, 0, 0, 144, 6248, 6339, 6202, 12541
INVAR-44, Run: 055, F, 0, 0, 144, 4083, 5884, 4037, 9921
INVAR-44, Run: 056, F, 0, 0, 144, 266, 1240, 220, 1460
INVAR-44, Run: 057, F, 0, 0, 144, 1648, 4012, 1602, 5614
INVAR-44, Run: 058, F, 0, 0, 144, 2772, 6281, 2726, 9007
INVAR-44, Run: 059, F, 0, 144, 0, 933, 356, 1031, 1387
INVAR-44, Run: 060, F, 0, 0, 144, 937, 2570, 891, 3461
INVAR-44, Run: 061, F, 0, 0, 144, 2606, 4675, 2560, 7235
INVAR-44, Run: 062, F, 0, 144, 0, 2161, 1624, 2259, 3883
INVAR-44, Run: 063, F, 0, 0, 144, 429, 1797, 383, 2180
INVAR-44, Run: 064, F, 0, 0, 144, 295, 2868, 249, 3117
INVAR-44, Run: 065, F, 0, 0, 144, 1599, 6421, 1553, 7974
INVAR-44, Run: 066, F, 0, 0, 144, 1213, 4156, 1167, 5323
INVAR-44, Run: 067, F, 0, 0, 144, 1488, 6790, 1442, 8232
INVAR-44, Run: 068, F, 0, 0, 144, 1191, 2812, 1145, 3957
INVAR-44, Run: 069, F, 0, 0, 144, 5691, 7357, 5645, 13002
INVAR-44, Run: 070, F, 0, 144, 0, 871, 641, 969, 1610
INVAR-44, Run: 071, F, 0, 144, 0, 4826, 6379, 4924, 11303
INVAR-44, Run: 072, F, 0, 0, 144, 491, 2334, 445, 2779
INVAR-44, Run: 073, F, 0, 0, 144, 7338, 17557, 7292, 24849
INVAR-44, Run: 074, F, 0, 144, 0, 1017, 419, 1115, 1534
INVAR-44, Run: 075, F, 0, 0, 144, 324, 1944, 278, 2222
INVAR-44, Run: 076, F, 0, 144, 0, 2202, 904, 2300, 3204
INVAR-44, Run: 077, F, 0, 0, 144, 1249, 4130, 1203, 5333
INVAR-44, Run: 078, F, 0, 0, 144, 3367, 6585, 3321, 9906
INVAR-44, Run: 079, F, 0, 144, 0, 3383, 2275, 3481, 5756
INVAR-44, Run: 080, F, 0, 0, 144, 744, 2299, 698, 2997
INVAR-44, Run: 081, F, 0, 0, 144, 409, 2406, 363, 2769
INVAR-44, Run: 082, F, 0, 144, 0, 6787, 5765, 6885, 12650
INVAR-44, Run: 083, F, 0, 0, 144, 671, 2074, 625, 2699
INVAR-44, Run: 084, F, 0, 144, 0, 4691, 1810, 4789, 6599
INVAR-44, Run: 085, F, 0, 0, 144, 4039, 8950, 3993, 12943
INVAR-44, Run: 086, F, 0, 0, 144, 1167, 2364, 1121, 3485
INVAR-44, Run: 087, F, 0, 0, 144, 1711, 3471, 1665, 5136
INVAR-44, Run: 088, F, 0, 0, 144, 1261, 6099, 1215, 7314
INVAR-44, Run: 089, F, 0, 144, 0, 4007, 5567, 4105, 9672
INVAR-44, Run: 090, F, 0, 0, 144, 2329, 10164, 2283, 12447
INVAR-44, Run: 091, F, 0, 144, 0, 3507, 1776, 3605, 5381
INVAR-44, Run: 092, F, 0, 144, 0, 1780, 1843, 1878, 3721
INVAR-44, Run: 093, F, 0, 0, 144, 507, 2287, 461, 2748
INVAR-44, Run: 094, F, 0, 0, 144, 733, 2784, 687, 3471
INVAR-44, Run: 095, F, 0, 0, 144, 910, 5012, 864, 5876
INVAR-44, Run: 096, F, 0, 0, 144, 253, 1139, 207, 1346
INVAR-44, Run: 097, F, 0, 0, 144, 2521, 6075, 2475, 8550
INVAR-44, Run: 098, F, 0, 144, 0, 3152, 2378, 3250, 5628
INVAR-44, Run: 099, F, 0, 0, 144, 8596, 15825, 8550, 24375
INVAR-44, Run: 100, F, 0, 0, 144, 736, 3357, 690, 4047
INVAR-45, Run: 001, F, 0, 0, 240, 2170, 5102, 2078, 7180
INVAR-45, Run: 002, F, 0, 240, 0, 7140, 6902, 7288, 14190
INVAR-45, Run: 003, F, 0, 0, 240, 815, 3224, 723, 3947
INVAR-45, Run: 004, F, 0, 0, 240, 2178, 4864, 2086, 6950
INVAR-45, Run: 005, F, 0, 0, 240, 11017, 15547, 10925, 26472
INVAR-45, Run: 006, F, 0, 0, 240, 3496, 10095, 3404, 13499
INVAR-45, Run: 007, F, 0, 240, 0, 4163, 2583, 4311, 6894
INVAR-45, Run: 008, F, 0, 0, 240, 7332, 10832, 7240, 18072
INVAR-45, Run: 009, F, 0, 0, 240, 3742, 14932, 3650, 18582
INVAR-45, Run: 010, F, 0, 0, 240, 5854, 13813, 5762, 19575
INVAR-45, Run: 011, F, 0, 0, 240, 5503, 21596, 5411, 27007
INVAR-45, Run: 012, F, 0, 0, 240, 3016, 9187, 2924, 12111
INVAR-45, Run: 013, F, 0, 0, 240, 5450, 8611, 5358, 13969
INVAR-45, Run: 014, F, 0, 0, 240, 10633, 26694, 10541, 37235
INVAR-45, Run: 015, F, 0, 240, 0, 3393, 2862, 3541, 6403
INVAR-45, Run: 016, F, 0, 0, 240, 9245, 20735, 9153, 29888
INVAR-45, Run: 017, F, 0, 240, 0, 2553, 1748, 2701, 4449
INVAR-45, Run: 018, F, 0, 0, 240, 4746, 15530, 4654, 20184
INVAR-45, Run: 019, F, 0, 240, 0, 4253, 1551, 4401, 5952
INVAR-45, Run: 020, F, 0, 0, 240, 14070, 8474, 13978, 22452
INVAR-45, Run: 021, F, 0, 0, 240, 955, 10722, 863, 11585
INVAR-45, Run: 022, F, 0, 0, 240, 11974, 15665, 11882, 27547
INVAR-45, Run: 023, F, 0, 0, 240, 2744, 10016, 2652, 12668
INVAR-45, Run: 024, F, 0, 240, 0, 11998, 21288, 12146, 33434
INVAR-45, Run: 025, F, 0, 0, 240, 1652, 5793, 1560, 7353
INVAR-45, Run: 026, F, 0, 0, 240, 3314, 15624, 3222, 18846
INVAR-45, Run: 027, F, 0, 240, 0, 4661, 2252, 4809, 7061
INVAR-45, Run: 028, F, 0, 240, 0, 9589, 7127, 9737, 16864
INVAR-45, Run: 029, F, 0, 0, 240, 3267, 10028, 3175, 13203
INVAR-45, Run: 030, F, 0, 0, 240, 665, 3097, 573, 3670
INVAR-45, Run: 031, F, 0, 240, 0, 10435, 7356, 10583, 17939
INVAR-45, Run: 032, F, 0, 0, 240, 4017, 7038, 3925, 10963
INVAR-45, Run: 033, F, 0, 240, 0, 4872, 1924, 5020, 6944
INVAR-45, Run: 034, F, 0, 240, 0, 5711, 3634, 5859, 9493
INVAR-45, Run: 035, F, 0, 0, 240, 712, 4223, 620, 4843
INVAR-45, Run: 036, F, 0, 0, 240, 1854, 8136, 1762, 9898
INVAR-45, Run: 037, F, 0, 240, 0, 15672, 8640, 15820, 24460
INVAR-45, Run: 038, F, 0, 240, 0, 6628, 6523, 6776, 13299
INVAR-45, Run: 039, F, 0, 240, 0, 9402, 2314, 9550, 11864
INVAR-45, Run: 040, F, 0, 240, 0, 10191, 4288, 10339, 14627
INVAR-45, Run: 041, F, 0, 240, 0, 1511, 361, 1659, 2020
INVAR-45, Run: 042, F, 0, 240, 0, 21556, 11727, 21704, 33431
INVAR-45, Run: 043, F, 0, 0, 240, 8580, 7950, 8488, 16438
INVAR-45, Run: 044, F, 0, 0, 240, 3671, 9472, 3579, 13051
INVAR-45, Run: 045, F, 0, 0, 240, 3145, 10496, 3053, 13549
INVAR-45, Run: 046, F, 0, 0, 240, 6332, 27362, 6240, 33602
INVAR-45, Run: 047, F, 0, 0, 240, 3721, 11394, 3629, 15023
INVAR-45, Run: 048, F, 0, 0, 240, 4173, 13808, 4081, 17889
INVAR-45, Run: 049, F, 0, 240, 0, 8509, 7101, 8657, 15758
INVAR-45, Run: 050, F, 0, 240, 0, 13774, 13752, 13922, 27674
INVAR-45, Run: 051, F, 0, 240, 0, 2727, 900, 2875, 3775
INVAR-45, Run: 052, F, 0, 0, 240, 4721, 16450, 4629, 21079
INVAR-45, Run: 053, F, 0, 0, 240, 4288, 16034, 4196, 20230
INVAR-45, Run: 054, F, 0, 240, 0, 3132, 1054, 3280, 4334
INVAR-45, Run: 055, F, 0, 240, 0, 3604, 1530, 3752, 5282
INVAR-45, Run: 056, F, 0, 0, 240, 3650, 14794, 3558, 18352
INVAR-45, Run: 057, F, 0, 240, 0, 6492, 7999, 6640, 14639
INVAR-45, Run: 058, F, 0, 240, 0, 6411, 2435, 6559, 8994
INVAR-45, Run: 059, F, 0, 0, 240, 4986, 8610, 4894, 13504
INVAR-45, Run: 060, F, 0, 0, 240, 2713, 15757, 2621, 18378
INVAR-45, Run: 061, F, 0, 240, 0, 5330, 3413, 5478, 8891
INVAR-45, Run: 062, F, 0, 240, 0, 3537, 5120, 3685, 8805
INVAR-45, Run: 063, F, 0, 0, 240, 5603, 9524, 5511, 15035
INVAR-45, Run: 064, F, 0, 0, 240, 9728, 14271, 9636, 23907
INVAR-45, Run: 065, F, 0, 0, 240, 561, 3621, 469, 4090
INVAR-45, Run: 066, F, 0, 0, 240, 13919, 15154, 13827, 28981
INVAR-45, Run: 067, F, 0, 0, 240, 9468, 6095, 9376, 15471
INVAR-45, Run: 068, F, 0, 240, 0, 3686, 1929, 3834, 5763
INVAR-45, Run: 069, F, 0, 0, 240, 12761, 10243, 12669, 22912
INVAR-45, Run: 070, F, 0, 240, 0, 3436, 1064, 3584, 4648
INVAR-45, Run: 071, F, 0, 0, 240, 2752, 10221, 2660, 12881
INVAR-45, Run: 072, F, 0, 240, 0, 4382, 1811, 4530, 6341
INVAR-45, Run: 073, F, 0, 0, 240, 14724, 14887, 14632, 29519
INVAR-45, Run: 074, F, 0, 240, 0, 7257, 5233, 7405, 12638
INVAR-45, Run: 075, F, 0, 240, 0, 12873, 12118, 13021, 25139
INVAR-45, Run: 076, F, 0, 0, 240, 1194, 5340, 1102, 6442
INVAR-45, Run: 077, F, 0, 0, 240, 4448, 15593, 4356, 19949
INVAR-45, Run: 078, F, 0, 0, 240, 10345, 10646, 10253, 20899
INVAR-45, Run: 079, F, 0, 0, 240, 1608, 10657, 1516, 12173
INVAR-45, Run: 080, F, 0, 240, 0, 13463, 6578, 13611, 20189
INVAR-45, Run: 081, F, 0, 240, 0, 2490, 1039, 2638, 3677
INVAR-45, Run: 082, F, 0, 240, 0, 12472, 4724, 12620, 17344
INVAR-45, Run: 083, F, 0, 240, 0, 11305, 5594, 11453, 17047
INVAR-45, Run: 084, F, 0, 240, 0, 7785, 17046, 7933, 24979
INVAR-45, Run: 085, F, 0, 0, 240, 9224, 10853, 9132, 19985
INVAR-45, Run: 086, F, 0, 0, 240, 4856, 12260, 4764, 17024
INVAR-45, Run: 087, F, 0, 0, 240, 8672, 17074, 8580, 25654
INVAR-45, Run: 088, F, 0, 240, 0, 8769, 15258, 8917, 24175
INVAR-45, Run: 089, F, 0, 240, 0, 7612, 5582, 7760, 13342
INVAR-45, Run: 090, F, 0, 0, 240, 15030, 13518, 14938, 28456
INVAR-45, Run: 091, F, 0, 240, 0, 1723, 752, 1871, 2623
INVAR-45, Run: 092, F, 0, 0, 240, 4020, 10848, 3928, 14776
INVAR-45, Run: 093, F, 0, 0, 240, 22883, 20901, 22791, 43692
INVAR-45, Run: 094, F, 0, 0, 240, 697, 2732, 605, 3337
INVAR-45, Run: 095, F, 0, 0, 240, 8056, 11403, 7964, 19367
INVAR-45, Run: 096, F, 0, 0, 240, 3430, 10538, 3338, 13876
INVAR-45, Run: 097, F, 0, 0, 240, 3479, 6056, 3387, 9443
INVAR-45, Run: 098, F, 0, 0, 240, 16433, 29413, 16341, 45754
INVAR-45, Run: 099, F, 0, 0, 240, 39646, 36835, 39554, 76389
INVAR-45, Run: 100, F, 0, 0, 240, 16562, 27530, 16470, 44000
INVAR-46, Run: 001, F, 0, 0, 69, 216, 800, 191, 991
INVAR-46, Run: 002, F, 0, 0, 69, 216, 801, 191, 992
INVAR-46, Run: 003, F, 0, 0, 69, 1070, 3295, 1045, 4340
INVAR-46, Run: 004, F, 0, 69, 0, 73, 43, 117, 160
INVAR-46, Run: 005, F, 0, 0, 69, 148, 1198, 123, 1321
INVAR-46, Run: 006, F, 0, 69, 0, 594, 320, 638, 958
INVAR-46, Run: 007, F, 0, 0, 69, 317, 1736, 292, 2028
INVAR-46, Run: 008, F, 0, 0, 69, 115, 712, 90, 802
INVAR-46, Run: 009, F, 0, 0, 69, 231, 1954, 206, 2160
INVAR-46, Run: 010, F, 0, 69, 0, 260, 74, 304, 378
INVAR-46, Run: 011, F, 0, 69, 0, 386, 130, 430, 560
INVAR-46, Run: 012, F, 0, 0, 69, 459, 1648, 434, 2082
INVAR-46, Run: 013, F, 0, 0, 69, 151, 289, 126, 415
INVAR-46, Run: 014, F, 0, 69, 0, 547, 956, 591, 1547
INVAR-46, Run: 015, F, 0, 69, 0, 961, 911, 1005, 1916
INVAR-46, Run: 016, F, 0, 0, 69, 1349, 3865, 1324, 5189
INVAR-46, Run: 017, F, 0, 0, 69, 421, 689, 396, 1085
INVAR-46, Run: 018, F, 0, 69, 0, 1157, 705, 1201, 1906
INVAR-46, Run: 019, F, 0, 69, 0, 294, 141, 338, 479
INVAR-46, Run: 020, F, 0, 0, 69, 1309, 1912, 1284, 3196
INVAR-46, Run: 021, F, 0, 0, 69, 112, 766, 87, 853
INVAR-46, Run: 022, F, 0, 69, 0, 359, 533, 403, 936
INVAR-46, Run: 023, F, 0, 69, 0, 170, 69, 214, 283
INVAR-46, Run: 024, F, 0, 69, 0, 138, 58, 182, 240
INVAR-46, Run: 025, F, 0, 0, 69, 1133, 1885, 1108, 2993
INVAR-46, Run: 026, F, 0, 69, 0, 368, 291, 412, 703
INVAR-46, Run: 027, F, 0, 69, 0, 154, 66, 198, 264
INVAR-46, Run: 028, F, 0, 69, 0, 1930, 2158, 1974, 4132
INVAR-46, Run: 029, F, 0, 0, 69, 653, 2023, 628, 2651
INVAR-46, Run: 030, F, 0, 0, 69, 446, 951, 421, 1372
INVAR-46, Run: 031, F, 0, 69, 0, 336, 109, 380, 489
INVAR-46, Run: 032, F, 0, 69, 0, 466, 623, 510, 1133
INVAR-46, Run: 033, F, 0, 0, 69, 335, 1371, 310, 1681
INVAR-46, Run: 034, F, 0, 69, 0, 798, 364, 842, 1206
INVAR-46, Run: 035, F, 0, 0, 69, 543, 1191, 518, 1709
INVAR-46, Run: 036, F, 0, 0, 69, 271, 868, 246, 1114
INVAR-46, Run: 037, F, 0, 0, 69, 416, 1100, 391, 1491
INVAR-46, Run: 038, F, 0, 0, 69, 163, 857, 138, 995
INVAR-46, Run: 039, F, 0, 0, 69, 98, 314, 73, 387
INVAR-46, Run: 040, F, 0, 0, 69, 742, 992, 717, 1709
INVAR-46, Run: 041, F, 0, 69, 0, 284, 64, 328, 392
INVAR-46, Run: 042, F, 0, 0, 69, 173, 650, 148, 798
INVAR-46, Run: 043, F, 0, 0, 69, 335, 1220, 310, 1530
INVAR-46, Run: 044, F, 0, 0, 69, 180, 458, 155, 613
INVAR-46, Run: 045, F, 0, 0, 69, 871, 1450, 846, 2296
INVAR-46, Run: 046, F, 0, 0, 69, 548, 921, 523, 1444
INVAR-46, Run: 047, F, 0, 0, 69, 477, 1818, 452, 2270
INVAR-46, Run: 048, F, 0, 0, 69, 49, 361, 24, 385
INVAR-46, Run: 049, F, 0, 0, 69, 170, 468, 145, 613
INVAR-46, Run: 050, F, 0, 0, 69, 374, 1537, 349, 1886
INVAR-46, Run: 051, F, 0, 0, 69, 110, 604, 85, 689
INVAR-46, Run: 052, F, 0, 69, 0, 397, 327, 441, 768
INVAR-46, Run: 053, F, 0, 0, 69, 453, 465, 428, 893
INVAR-46, Run: 054, F, 0, 0, 69, 106, 519, 81, 600
INVAR-46, Run: 055, F, 0, 0, 69, 421, 1283, 396, 1679
INVAR-46, Run: 056, F, 0, 69, 0, 373, 168, 417, 585
INVAR-46, Run: 057, F, 0, 0, 69, 176, 299, 151, 450
INVAR-46, Run: 058, F, 0, 0, 69, 1926, 2558, 1901, 4459
INVAR-46, Run: 059, F, 0, 69, 0, 368, 328, 412, 740
INVAR-46, Run: 060, F, 0, 0, 69, 93, 606, 68, 674
INVAR-46, Run: 061, F, 0, 0, 69, 442, 803, 417, 1220
INVAR-46, Run: 062, F, 0, 0, 69, 276, 996, 251, 1247
INVAR-46, Run: 063, F, 0, 0, 69, 185, 441, 160, 601
INVAR-46, Run: 064, F, 0, 69, 0, 419, 260, 463, 723
INVAR-46, Run: 065, F, 0, 69, 0, 796, 614, 840, 1454
INVAR-46, Run: 066, F, 0, 0, 69, 1390, 2656, 1365, 4021
INVAR-46, Run: 067, F, 0, 0, 69, 179, 835, 154, 989
INVAR-46, Run: 068, F, 0, 0, 69, 396, 501, 371, 872
INVAR-46, Run: 069, F, 0, 0, 69, 431, 1798, 406, 2204
INVAR-46, Run: 070, F, 0, 0, 69, 964, 1689, 939, 2628
INVAR-46, Run: 071, F, 0, 69, 0, 112, 39, 156, 195
INVAR-46, Run: 072, F, 0, 0, 69, 592, 1483, 567, 2050
INVAR-46, Run: 073, F, 0, 0, 69, 377, 1316, 352, 1668
INVAR-46, Run: 074, F, 0, 69, 0, 690, 409, 734, 1143
INVAR-46, Run: 075, F, 0, 0, 69, 294, 1005, 269, 1274
INVAR-46, Run: 076, F, 0, 0, 69, 160, 501, 135, 636
INVAR-46, Run: 077, F, 0, 0, 69, 1436, 1742, 1411, 3153
INVAR-46, Run: 078, F, 0, 0, 69, 459, 1064, 434, 1498
INVAR-46, Run: 079, F, 0, 0, 69, 719, 1070, 694, 1764
INVAR-46, Run: 080, F, 0, 0, 69, 149, 845, 124, 969
INVAR-46, Run: 081, F, 0, 69, 0, 777, 442, 821, 1263
INVAR-46, Run: 082, F, 0, 0, 69, 181, 871, 156, 1027
INVAR-46, Run: 083, F, 0, 0, 69, 78, 587, 53, 640
INVAR-46, Run: 084, F, 0, 0, 69, 143, 579, 118, 697
INVAR-46, Run: 085, F, 0, 0, 69, 465, 804, 440, 1244
INVAR-46, Run: 086, F, 0, 69, 0, 233, 183, 277, 460
INVAR-46, Run: 087, F, 0, 0, 69, 237, 1025, 212, 1237
INVAR-46, Run: 088, F, 0, 69, 0, 136, 63, 180, 243
INVAR-46, Run: 089, F, 0, 0, 69, 466, 1337, 441, 1778
INVAR-46, Run: 090, F, 0, 69, 0, 666, 510, 710, 1220
INVAR-46, Run: 091, F, 0, 69, 0, 520, 355, 564, 919
INVAR-46, Run: 092, F, 0, 69, 0, 191, 108, 235, 343
INVAR-46, Run: 093, F, 0, 0, 69, 166, 959, 141, 1100
INVAR-46, Run: 094, F, 0, 0, 69, 316, 871, 291, 1162
INVAR-46, Run: 095, F, 0, 0, 69, 101, 374, 76, 450
INVAR-46, Run: 096, F, 0, 69, 0, 1097, 1004, 1141, 2145
INVAR-46, Run: 097, F, 0, 0, 69, 530, 851, 505, 1356
INVAR-46, Run: 098, F, 0, 0, 69, 561, 1122, 536, 1658
INVAR-46, Run: 099, F, 0, 69, 0, 1101, 769, 1145, 1914
INVAR-46, Run: 100, F, 0, 0, 69, 236, 750, 211, 961
INVAR-47, Run: 001, F, 0, 141, 0, 1585, 858, 1683, 2541
INVAR-47, Run: 002, F, 0, 141, 0, 1873, 1387, 1971, 3358
INVAR-47, Run: 003, F, 0, 0, 141, 4750, 10075, 4707, 14782
INVAR-47, Run: 004, F, 0, 0, 141, 348, 2630, 305, 2935
INVAR-47, Run: 005, F, 0, 0, 141, 667, 3664, 624, 4288
INVAR-47, Run: 006, F, 0, 141, 0, 1387, 800, 1485, 2285
INVAR-47, Run: 007, F, 0, 141, 0, 3441, 3363, 3539, 6902
INVAR-47, Run: 008, F, 0, 141, 0, 5482, 4020, 5580, 9600
INVAR-47, Run: 009, F, 0, 141, 0, 2301, 1035, 2399, 3434
INVAR-47, Run: 010, F, 0, 0, 141, 891, 5174, 848, 6022
INVAR-47, Run: 011, F, 0, 0, 141, 6289, 15738, 6246, 21984
INVAR-47, Run: 012, F, 0, 0, 141, 690, 2130, 647, 2777
INVAR-47, Run: 013, F, 0, 0, 141, 1794, 4008, 1751, 5759
INVAR-47, Run: 014, F, 0, 0, 141, 4943, 5193, 4900, 10093
INVAR-47, Run: 015, F, 0, 0, 141, 311, 2454, 268, 2722
INVAR-47, Run: 016, F, 0, 0, 141, 228, 1155, 185, 1340
INVAR-47, Run: 017, F, 0, 141, 0, 1798, 898, 1896, 2794
INVAR-47, Run: 018, F, 0, 0, 141, 1423, 4243, 1380, 5623
INVAR-47, Run: 019, F, 0, 141, 0, 963, 822, 1061, 1883
INVAR-47, Run: 020, F, 0, 141, 0, 2858, 1828, 2956, 4784
INVAR-47, Run: 021, F, 0, 0, 141, 3989, 6010, 3946, 9956
INVAR-47, Run: 022, F, 0, 0, 141, 107, 618, 64, 682
INVAR-47, Run: 023, F, 0, 0, 141, 193, 811, 150, 961
INVAR-47, Run: 024, F, 0, 0, 141, 904, 2498, 861, 3359
INVAR-47, Run: 025, F, 0, 0, 141, 1854, 3800, 1811, 5611
INVAR-47, Run: 026, F, 0, 0, 141, 333, 1936, 290, 2226
INVAR-47, Run: 027, F, 0, 0, 141, 1059, 3802, 1016, 4818
INVAR-47, Run: 028, F, 0, 0, 141, 5282, 5102, 5239, 10341
INVAR-47, Run: 029, F, 0, 0, 141, 456, 3625, 413, 4038
INVAR-47, Run: 030, F, 0, 0, 141, 234, 1258, 191, 1449
INVAR-47, Run: 031, F, 0, 0, 141, 348, 4159, 305, 4464
INVAR-47, Run: 032, F, 0, 0, 141, 4031, 8442, 3988, 12430
INVAR-47, Run: 033, F, 0, 0, 141, 522, 3736, 479, 4215
INVAR-47, Run: 034, F, 0, 0, 141, 2408, 3061, 2365, 5426
INVAR-47, Run: 035, F, 0, 141, 0, 3867, 5061, 3965, 9026
INVAR-47, Run: 036, F, 0, 0, 141, 2925, 4451, 2882, 7333
INVAR-47, Run: 037, F, 0, 0, 141, 162, 937, 119, 1056
INVAR-47, Run: 038, F, 0, 0, 141, 516, 2616, 473, 3089
INVAR-47, Run: 039, F, 0, 0, 141, 5494, 14345, 5451, 19796
INVAR-47, Run: 040, F, 0, 141, 0, 2502, 2639, 2600, 5239
INVAR-47, Run: 041, F, 0, 0, 141, 2460, 3092, 2417, 5509
INVAR-47, Run: 042, F, 0, 0, 141, 565, 3938, 522, 4460
INVAR-47, Run: 043, F, 0, 0, 141, 2818, 4711, 2775, 7486
INVAR-47, Run: 044, F, 0, 141, 0, 1938, 2084, 2036, 4120
INVAR-47, Run: 045, F, 0, 141, 0, 2271, 1013, 2369, 3382
INVAR-47, Run: 046, F, 0, 141, 0, 635, 258, 733, 991
INVAR-47, Run: 047, F, 0, 0, 141, 3400, 8817, 3357, 12174
INVAR-47, Run: 048, F, 0, 141, 0, 1096, 395, 1194, 1589
INVAR-47, Run: 049, F, 0, 0, 141, 276, 1063, 233, 1296
INVAR-47, Run: 050, F, 0, 0, 141, 246, 2097, 203, 2300
INVAR-47, Run: 051, F, 0, 0, 141, 726, 2945, 683, 3628
INVAR-47, Run: 052, F, 0, 141, 0, 1796, 4457, 1894, 6351
INVAR-47, Run: 053, F, 0, 0, 141, 350, 1939, 307, 2246
INVAR-47, Run: 054, F, 0, 0, 141, 546, 3048, 503, 3551
INVAR-47, Run: 055, F, 0, 0, 141, 513, 2035, 470, 2505
INVAR-47, Run: 056, F, 0, 141, 0, 2809, 2849, 2907, 5756
INVAR-47, Run: 057, F, 0, 0, 141, 541, 1770, 498, 2268
INVAR-47, Run: 058, F, 0, 0, 141, 477, 1574, 434, 2008
INVAR-47, Run: 059, F, 0, 0, 141, 3651, 5612, 3608, 9220
INVAR-47, Run: 060, F, 0, 0, 141, 587, 2943, 544, 3487
INVAR-47, Run: 061, F, 0, 0, 141, 6780, 8111, 6737, 14848
INVAR-47, Run: 062, F, 0, 141, 0, 6230, 3182, 6328, 9510
INVAR-47, Run: 063, F, 0, 0, 141, 271, 1676, 228, 1904
INVAR-47, Run: 064, F, 0, 141, 0, 4181, 4243, 4279, 8522
INVAR-47, Run: 065, F, 0, 0, 141, 2452, 2951, 2409, 5360
INVAR-47, Run: 066, F, 0, 0, 141, 630, 2697, 587, 3284
INVAR-47, Run: 067, F, 0, 0, 141, 4416, 9297, 4373, 13670
INVAR-47, Run: 068, F, 0, 0, 141, 1606, 2441, 1563, 4004
INVAR-47, Run: 069, F, 0, 141, 0, 3182, 2977, 3280, 6257
INVAR-47, Run: 070, F, 0, 0, 141, 1175, 6048, 1132, 7180
INVAR-47, Run: 071, F, 0, 0, 141, 408, 2507, 365, 2872
INVAR-47, Run: 072, F, 0, 141, 0, 1547, 2712, 1645, 4357
INVAR-47, Run: 073, F, 0, 141, 0, 1015, 338, 1113, 1451
INVAR-47, Run: 074, F, 0, 0, 141, 1043, 7364, 1000, 8364
INVAR-47, Run: 075, F, 0, 141, 0, 2595, 4829, 2693, 7522
INVAR-47, Run: 076, F, 0, 141, 0, 1326, 1776, 1424, 3200
INVAR-47, Run: 077, F, 0, 141, 0, 1024, 531, 1122, 1653
INVAR-47, Run: 078, F, 0, 0, 141, 1189, 3508, 1146, 4654
INVAR-47, Run: 079, F, 0, 141, 0, 6571, 7670, 6669, 14339
INVAR-47, Run: 080, F, 0, 0, 141, 1752, 5129, 1709, 6838
INVAR-47, Run: 081, F, 0, 0, 141, 3527, 10241, 3484, 13725
INVAR-47, Run: 082, F, 0, 0, 141, 785, 3180, 742, 3922
INVAR-47, Run: 083, F, 0, 0, 141, 838, 3103, 795, 3898
INVAR-47, Run: 084, F, 0, 0, 141, 4847, 10387, 4804, 15191
INVAR-47, Run: 085, F, 0, 0, 141, 1856, 4778, 1813, 6591
INVAR-47, Run: 086, F, 0, 0, 141, 683, 4134, 640, 4774
INVAR-47, Run: 087, F, 0, 0, 141, 7592, 11483, 7549, 19032
INVAR-47, Run: 088, F, 0, 0, 141, 1456, 4862, 1413, 6275
INVAR-47, Run: 089, F, 0, 141, 0, 3023, 2505, 3121, 5626
INVAR-47, Run: 090, F, 0, 0, 141, 443, 2319, 400, 2719
INVAR-47, Run: 091, F, 0, 0, 141, 1591, 7456, 1548, 9004
INVAR-47, Run: 092, F, 0, 141, 0, 2974, 2510, 3072, 5582
INVAR-47, Run: 093, F, 0, 0, 141, 407, 1854, 364, 2218
INVAR-47, Run: 094, F, 0, 0, 141, 709, 1903, 666, 2569
INVAR-47, Run: 095, F, 0, 141, 0, 1205, 822, 1303, 2125
INVAR-47, Run: 096, F, 0, 0, 141, 4013, 9144, 3970, 13114
INVAR-47, Run: 097, F, 0, 0, 141, 2208, 3936, 2165, 6101
INVAR-47, Run: 098, F, 0, 141, 0, 2835, 1771, 2933, 4704
INVAR-47, Run: 099, F, 0, 0, 141, 2637, 9088, 2594, 11682
INVAR-47, Run: 100, F, 0, 0, 141, 1030, 3504, 987, 4491
INVAR-48, Run: 001, F, 0, 0, 281, 6234, 15263, 6121, 21384
INVAR-48, Run: 002, F, 0, 0, 281, 2395, 8022, 2282, 10304
INVAR-48, Run: 003, F, 0, 0, 281, 7114, 24054, 7001, 31055
INVAR-48, Run: 004, F, 0, 281, 0, 3801, 769, 3969, 4738
INVAR-48, Run: 005, F, 0, 281, 0, 4850, 3319, 5018, 8337
INVAR-48, Run: 006, F, 0, 281, 0, 10690, 3810, 10858, 14668
INVAR-48, Run: 007, F, 0, 0, 281, 9897, 34623, 9784, 44407
INVAR-48, Run: 008, F, 0, 0, 281, 12290, 24725, 12177, 36902
INVAR-48, Run: 009, F, 0, 281, 0, 4322, 2189, 4490, 6679
INVAR-48, Run: 010, F, 0, 0, 281, 10384, 12047, 10271, 22318
INVAR-48, Run: 011, F, 0, 0, 281, 5680, 12677, 5567, 18244
INVAR-48, Run: 012, F, 0, 0, 281, 3757, 10816, 3644, 14460
INVAR-48, Run: 013, F, 0, 281, 0, 9648, 7022, 9816, 16838
INVAR-48, Run: 014, F, 0, 0, 281, 23021, 37588, 22908, 60496
INVAR-48, Run: 015, F, 0, 0, 281, 5401, 14042, 5288, 19330
INVAR-48, Run: 016, F, 0, 0, 281, 2461, 10489, 2348, 12837
INVAR-48, Run: 017, F, 0, 0, 281, 4662, 10527, 4549, 15076
INVAR-48, Run: 018, F, 0, 0, 281, 2030, 12628, 1917, 14545
INVAR-48, Run: 019, F, 0, 0, 281, 960, 5727, 847, 6574
INVAR-48, Run: 020, F, 0, 281, 0, 6627, 2532, 6795, 9327
INVAR-48, Run: 021, F, 0, 0, 281, 4273, 17712, 4160, 21872
INVAR-48, Run: 022, F, 0, 281, 0, 7123, 2447, 7291, 9738
INVAR-48, Run: 023, F, 0, 281, 0, 3841, 1134, 4009, 5143
INVAR-48, Run: 024, F, 0, 281, 0, 28109, 24597, 28277, 52874
INVAR-48, Run: 025, F, 0, 0, 281, 1685, 6973, 1572, 8545
INVAR-48, Run: 026, F, 0, 0, 281, 1649, 8681, 1536, 10217
INVAR-48, Run: 027, F, 0, 0, 281, 17781, 14159, 17668, 31827
INVAR-48, Run: 028, F, 0, 281, 0, 6250, 4499, 6418, 10917
INVAR-48, Run: 029, F, 0, 0, 281, 6727, 31551, 6614, 38165
INVAR-48, Run: 030, F, 0, 281, 0, 20406, 11072, 20574, 31646
INVAR-48, Run: 031, F, 0, 0, 281, 2819, 12515, 2706, 15221
INVAR-48, Run: 032, F, 0, 281, 0, 1964, 595, 2132, 2727
INVAR-48, Run: 033, F, 0, 0, 281, 1929, 5258, 1816, 7074
INVAR-48, Run: 034, F, 0, 281, 0, 4999, 1559, 5167, 6726
INVAR-48, Run: 035, F, 0, 0, 281, 3797, 14562, 3684, 18246
INVAR-48, Run: 036, F, 0, 281, 0, 14459, 13962, 14627, 28589
INVAR-48, Run: 037, F, 0, 281, 0, 5949, 2450, 6117, 8567
INVAR-48, Run: 038, F, 0, 0, 281, 9818, 22510, 9705, 32215
INVAR-48, Run: 039, F, 0, 0, 281, 28457, 30348, 28344, 58692
INVAR-48, Run: 040, F, 0, 0, 281, 2635, 6569, 2522, 9091
INVAR-48, Run: 041, F, 0, 0, 281, 1475, 6772, 1362, 8134
INVAR-48, Run: 042, F, 0, 0, 281, 13989, 30571, 13876, 44447
INVAR-48, Run: 043, F, 0, 0, 281, 4525, 17367, 4412, 21779
INVAR-48, Run: 044, F, 0, 0, 281, 5341, 32204, 5228, 37432
INVAR-48, Run: 045, F, 0, 0, 281, 8055, 17715, 7942, 25657
INVAR-48, Run: 046, F, 0, 0, 281, 5076, 18149, 4963, 23112
INVAR-48, Run: 047, F, 0, 0, 281, 7566, 16574, 7453, 24027
INVAR-48, Run: 048, F, 0, 0, 281, 2404, 8669, 2291, 10960
INVAR-48, Run: 049, F, 0, 281, 0, 5180, 4486, 5348, 9834
INVAR-48, Run: 050, F, 0, 281, 0, 4235, 2109, 4403, 6512
INVAR-48, Run: 051, F, 0, 0, 281, 11544, 31796, 11431, 43227
INVAR-48, Run: 052, F, 0, 0, 281, 5604, 19540, 5491, 25031
INVAR-48, Run: 053, F, 0, 0, 281, 1370, 4489, 1257, 5746
INVAR-48, Run: 054, F, 0, 0, 281, 2890, 6425, 2777, 9202
INVAR-48, Run: 055, F, 0, 0, 281, 4901, 9360, 4788, 14148
INVAR-48, Run: 056, F, 0, 0, 281, 3769, 13884, 3656, 17540
INVAR-48, Run: 057, F, 0, 0, 281, 5065, 18034, 4952, 22986
INVAR-48, Run: 058, F, 0, 0, 281, 6166, 18735, 6053, 24788
INVAR-48, Run: 059, F, 0, 0, 281, 2268, 15066, 2155, 17221
INVAR-48, Run: 060, F, 0, 0, 281, 4645, 13638, 4532, 18170
INVAR-48, Run: 061, F, 0, 281, 0, 12652, 27901, 12820, 40721
INVAR-48, Run: 062, F, 0, 0, 281, 6905, 16970, 6792, 23762
INVAR-48, Run: 063, F, 0, 281, 0, 15150, 8857, 15318, 24175
INVAR-48, Run: 064, F, 0, 281, 0, 8619, 3419, 8787, 12206
INVAR-48, Run: 065, F, 0, 0, 281, 3490, 12763, 3377, 16140
INVAR-48, Run: 066, F, 0, 0, 281, 11898, 24552, 11785, 36337
INVAR-48, Run: 067, F, 0, 0, 281, 9702, 13783, 9589, 23372
INVAR-48, Run: 068, F, 0, 0, 281, 1726, 5108, 1613, 6721
INVAR-48, Run: 069, F, 0, 0, 281, 1816, 7185, 1703, 8888
INVAR-48, Run: 070, F, 0, 0, 281, 912, 6854, 799, 7653
INVAR-48, Run: 071, F, 0, 0, 281, 2054, 12017, 1941, 13958
INVAR-48, Run: 072, F, 0, 281, 0, 4880, 1789, 5048, 6837
INVAR-48, Run: 073, F, 0, 0, 281, 5657, 16926, 5544, 22470
INVAR-48, Run: 074, F, 0, 0, 281, 12234, 46029, 12121, 58150
INVAR-48, Run: 075, F, 0, 0, 281, 2343, 15109, 2230, 17339
INVAR-48, Run: 076, F, 0, 281, 0, 8413, 2966, 8581, 11547
INVAR-48, Run: 077, F, 0, 0, 281, 4711, 11470, 4598, 16068
INVAR-48, Run: 078, F, 0, 0, 281, 3177, 18754, 3064, 21818
INVAR-48, Run: 079, F, 0, 281, 0, 24545, 12567, 24713, 37280
INVAR-48, Run: 080, F, 0, 0, 281, 6083, 27591, 5970, 33561
INVAR-48, Run: 081, F, 0, 0, 281, 8145, 41588, 8032, 49620
INVAR-48, Run: 082, F, 0, 281, 0, 30567, 37778, 30735, 68513
INVAR-48, Run: 083, F, 0, 0, 281, 2829, 10834, 2716, 13550
INVAR-48, Run: 084, F, 0, 0, 281, 8839, 11491, 8726, 20217
INVAR-48, Run: 085, F, 0, 281, 0, 5661, 1489, 5829, 7318
INVAR-48, Run: 086, F, 0, 281, 0, 7665, 3179, 7833, 11012
INVAR-48, Run: 087, F, 0, 281, 0, 6980, 1909, 7148, 9057
INVAR-48, Run: 088, F, 0, 281, 0, 12260, 18984, 12428, 31412
INVAR-48, Run: 089, F, 0, 0, 281, 19427, 26591, 19314, 45905
INVAR-48, Run: 090, F, 0, 0, 281, 18308, 30322, 18195, 48517
INVAR-48, Run: 091, F, 0, 281, 0, 4526, 2091, 4694, 6785
INVAR-48, Run: 092, F, 0, 0, 281, 2839, 6452, 2726, 9178
INVAR-48, Run: 093, F, 0, 281, 0, 4751, 1932, 4919, 6851
INVAR-48, Run: 094, F, 0, 0, 281, 3929, 6723, 3816, 10539
INVAR-48, Run: 095, F, 0, 281, 0, 17052, 5706, 17220, 22926
INVAR-48, Run: 096, F, 0, 281, 0, 3552, 1373, 3720, 5093
INVAR-48, Run: 097, F, 0, 281, 0, 4478, 1182, 4646, 5828
INVAR-48, Run: 098, F, 0, 0, 281, 7746, 33923, 7633, 41556
INVAR-48, Run: 099, F, 0, 281, 0, 7840, 3382, 8008, 11390
INVAR-48, Run: 100, F, 0, 281, 0, 5785, 2181, 5953, 8134
INVAR-49, Run: 001, F, 0, 0, 90, 168, 579, 124, 703
INVAR-49, Run: 002, F, 0, 90, 0, 1784, 1470, 1830, 3300
INVAR-49, Run: 003, F, 0, 0, 90, 500, 1340, 456, 1796
INVAR-49, Run: 004, F, 0, 90, 0, 1079, 579, 1125, 1704
INVAR-49, Run: 005, F, 0, 0, 90, 578, 1564, 534, 2098
INVAR-49, Run: 006, F, 0, 0, 90, 179, 658, 135, 793
INVAR-49, Run: 007, F, 0, 90, 0, 293, 27, 339, 366
INVAR-49, Run: 008, F, 0, 0, 90, 1226, 1328, 1182, 2510
INVAR-49, Run: 009, F, 0, 0, 90, 399, 2431, 355, 2786
INVAR-49, Run: 010, F, 0, 0, 90, 2555, 4945, 2511, 7456
INVAR-49, Run: 011, F, 0, 90, 0, 255, 45, 301, 346
INVAR-49, Run: 012, F, 0, 90, 0, 1216, 2116, 1262, 3378
INVAR-49, Run: 013, F, 0, 0, 90, 2743, 2487, 2699, 5186
INVAR-49, Run: 014, F, 0, 0, 90, 1547, 4468, 1503, 5971
INVAR-49, Run: 015, F, 0, 0, 90, 831, 1698, 787, 2485
INVAR-49, Run: 016, F, 0, 90, 0, 701, 917, 747, 1664
INVAR-49, Run: 017, F, 0, 90, 0, 1170, 670, 1216, 1886
INVAR-49, Run: 018, F, 0, 90, 0, 810, 542, 856, 1398
INVAR-49, Run: 019, F, 0, 90, 0, 1302, 849, 1348, 2197
INVAR-49, Run: 020, F, 0, 90, 0, 2749, 2728, 2795, 5523
INVAR-49, Run: 021, F, 0, 90, 0, 584, 212, 630, 842
INVAR-49, Run: 022, F, 0, 0, 90, 1551, 3835, 1507, 5342
INVAR-49, Run: 023, F, 0, 0, 90, 687, 1322, 643, 1965
INVAR-49, Run: 024, F, 0, 0, 90, 855, 3409, 811, 4220
INVAR-49, Run: 025, F, 0, 90, 0, 256, 138, 302, 440
INVAR-49, Run: 026, F, 0, 0, 90, 1711, 2211, 1667, 3878
INVAR-49, Run: 027, F, 0, 0, 90, 438, 1243, 394, 1637
INVAR-49, Run: 028, F, 0, 90, 0, 2454, 2366, 2500, 4866
INVAR-49, Run: 029, F, 0, 0, 90, 831, 1770, 787, 2557
INVAR-49, Run: 030, F, 0, 90, 0, 179, 54, 225, 279
INVAR-49, Run: 031, F, 0, 0, 90, 794, 1496, 750, 2246
INVAR-49, Run: 032, F, 0, 0, 90, 408, 1172, 364, 1536
INVAR-49, Run: 033, F, 0, 90, 0, 327, 163, 373, 536
INVAR-49, Run: 034, F, 0, 0, 90, 3065, 3357, 3021, 6378
INVAR-49, Run: 035, F, 0, 0, 90, 565, 1197, 521, 1718
INVAR-49, Run: 036, F, 0, 90, 0, 1019, 513, 1065, 1578
INVAR-49, Run: 037, F, 0, 0, 90, 4235, 5914, 4191, 10105
INVAR-49, Run: 038, F, 0, 0, 90, 880, 2028, 836, 2864
INVAR-49, Run: 039, F, 0, 0, 90, 740, 1896, 696, 2592
INVAR-49, Run: 040, F, 0, 0, 90, 430, 731, 386, 1117
INVAR-49, Run: 041, F, 0, 0, 90, 482, 900, 438, 1338
INVAR-49, Run: 042, F, 0, 90, 0, 1487, 1076, 1533, 2609
INVAR-49, Run: 043, F, 0, 90, 0, 616, 331, 662, 993
INVAR-49, Run: 044, F, 0, 90, 0, 584, 237, 630, 867
INVAR-49, Run: 045, F, 0, 90, 0, 908, 414, 954, 1368
INVAR-49, Run: 046, F, 0, 0, 90, 1612, 2098, 1568, 3666
INVAR-49, Run: 047, F, 0, 90, 0, 380, 124, 426, 550
INVAR-49, Run: 048, F, 0, 0, 90, 1249, 2267, 1205, 3472
INVAR-49, Run: 049, F, 0, 90, 0, 422, 95, 468, 563
INVAR-49, Run: 050, F, 0, 90, 0, 1452, 1115, 1498, 2613
INVAR-49, Run: 051, F, 0, 0, 90, 1358, 2294, 1314, 3608
INVAR-49, Run: 052, F, 0, 0, 90, 1616, 2609, 1572, 4181
INVAR-49, Run: 053, F, 0, 0, 90, 465, 1861, 421, 2282
INVAR-49, Run: 054, F, 0, 90, 0, 836, 481, 882, 1363
INVAR-49, Run: 055, F, 0, 0, 90, 409, 949, 365, 1314
INVAR-49, Run: 056, F, 0, 0, 90, 2351, 2380, 2307, 4687
INVAR-49, Run: 057, F, 0, 0, 90, 848, 2457, 804, 3261
INVAR-49, Run: 058, F, 0, 90, 0, 520, 296, 566, 862
INVAR-49, Run: 059, F, 0, 90, 0, 1211, 428, 1257, 1685
INVAR-49, Run: 060, F, 0, 0, 90, 1061, 1778, 1017, 2795
INVAR-49, Run: 061, F, 0, 0, 90, 249, 712, 205, 917
INVAR-49, Run: 062, F, 0, 90, 0, 642, 158, 688, 846
INVAR-49, Run: 063, F, 0, 90, 0, 462, 133, 508, 641
INVAR-49, Run: 064, F, 0, 0, 90, 1097, 1036, 1053, 2089
INVAR-49, Run: 065, F, 0, 90, 0, 801, 273, 847, 1120
INVAR-49, Run: 066, F, 0, 0, 90, 483, 1617, 439, 2056
INVAR-49, Run: 067, F, 0, 90, 0, 101, 72, 147, 219
INVAR-49, Run: 068, F, 0, 90, 0, 349, 101, 395, 496
INVAR-49, Run: 069, F, 0, 90, 0, 1323, 452, 1369, 1821
INVAR-49, Run: 070, F, 0, 90, 0, 475, 160, 521, 681
INVAR-49, Run: 071, F, 0, 0, 90, 660, 2102, 616, 2718
INVAR-49, Run: 072, F, 0, 0, 90, 1067, 1739, 1023, 2762
INVAR-49, Run: 073, F, 0, 90, 0, 637, 246, 683, 929
INVAR-49, Run: 074, F, 0, 0, 90, 413, 859, 369, 1228
INVAR-49, Run: 075, F, 0, 0, 90, 530, 875, 486, 1361
INVAR-49, Run: 076, F, 0, 0, 90, 490, 1648, 446, 2094
INVAR-49, Run: 077, F, 0, 90, 0, 512, 136, 558, 694
INVAR-49, Run: 078, F, 0, 0, 90, 1027, 1823, 983, 2806
INVAR-49, Run: 079, F, 0, 90, 0, 446, 287, 492, 779
INVAR-49, Run: 080, F, 0, 0, 90, 1587, 3497, 1543, 5040
INVAR-49, Run: 081, F, 0, 0, 90, 370, 894, 326, 1220
INVAR-49, Run: 082, F, 0, 90, 0, 248, 72, 294, 366
INVAR-49, Run: 083, F, 0, 90, 0, 585, 160, 631, 791
INVAR-49, Run: 084, F, 0, 0, 90, 630, 760, 586, 1346
INVAR-49, Run: 085, F, 0, 90, 0, 805, 388, 851, 1239
INVAR-49, Run: 086, F, 0, 90, 0, 379, 326, 425, 751
INVAR-49, Run: 087, F, 0, 0, 90, 1530, 3115, 1486, 4601
INVAR-49, Run: 088, F, 0, 90, 0, 191, 23, 237, 260
INVAR-49, Run: 089, F, 0, 0, 90, 745, 1004, 701, 1705
INVAR-49, Run: 090, F, 0, 0, 90, 1201, 774, 1157, 1931
INVAR-49, Run: 091, F, 0, 90, 0, 1630, 2849, 1676, 4525
INVAR-49, Run: 092, F, 0, 90, 0, 377, 75, 423, 498
INVAR-49, Run: 093, F, 0, 0, 90, 785, 2095, 741, 2836
INVAR-49, Run: 094, F, 0, 90, 0, 875, 1058, 921, 1979
INVAR-49, Run: 095, F, 0, 0, 90, 304, 466, 260, 726
INVAR-49, Run: 096, F, 0, 0, 90, 322, 929, 278, 1207
INVAR-49, Run: 097, F, 0, 90, 0, 280, 105, 326, 431
INVAR-49, Run: 098, F, 0, 0, 90, 694, 2237, 650, 2887
INVAR-49, Run: 099, F, 0, 0, 90, 862, 2178, 818, 2996
INVAR-49, Run: 100, F, 0, 0, 90, 1328, 3137, 1284, 4421
INVAR-5, Run: 001, P, 0, 0, 6, 0, 0, 0, 0
INVAR-5, Run: 002, P, 0, 0, 6, 0, 0, 0, 0
INVAR-5, Run: 003, P, 0, 0, 6, 0, 0, 0, 0
INVAR-5, Run: 004, P, 0, 0, 6, 0, 0, 0, 0
INVAR-5, Run: 005, P, 0, 0, 6, 0, 0, 0, 0
INVAR-5, Run: 006, P, 0, 0, 6, 0, 0, 0, 0
INVAR-5, Run: 007, P, 0, 0, 6, 0, 0, 0, 0
INVAR-5, Run: 008, P, 0, 0, 6, 0, 0, 0, 0
INVAR-5, Run: 009, P, 0, 0, 6, 0, 0, 0, 0
INVAR-5, Run: 010, P, 0, 0, 6, 0, 0, 0, 0
INVAR-5, Run: 011, P, 0, 0, 6, 0, 0, 0, 0
INVAR-5, Run: 012, P, 0, 0, 6, 0, 0, 0, 0
INVAR-5, Run: 013, P, 0, 0, 6, 0, 0, 0, 0
INVAR-5, Run: 014, P, 0, 0, 6, 0, 0, 0, 0
INVAR-5, Run: 015, P, 0, 0, 6, 0, 0, 0, 0
INVAR-5, Run: 016, P, 0, 0, 6, 0, 0, 0, 0
INVAR-5, Run: 017, P, 0, 0, 6, 0, 0, 0, 0
INVAR-5, Run: 018, P, 0, 0, 6, 0, 0, 0, 0
INVAR-5, Run: 019, P, 0, 0, 6, 0, 0, 0, 0
INVAR-5, Run: 020, P, 0, 0, 6, 0, 0, 0, 0
INVAR-5, Run: 021, P, 0, 0, 6, 0, 0, 0, 0
INVAR-5, Run: 022, P, 0, 0, 6, 0, 0, 0, 0
INVAR-5, Run: 023, P, 0, 0, 6, 0, 0, 0, 0
INVAR-5, Run: 024, P, 0, 0, 6, 0, 0, 0, 0
INVAR-5, Run: 025, P, 0, 0, 6, 0, 0, 0, 0
INVAR-5, Run: 026, P, 0, 0, 6, 0, 0, 0, 0
INVAR-5, Run: 027, P, 0, 0, 6, 0, 0, 0, 0
INVAR-5, Run: 028, P, 0, 0, 6, 0, 0, 0, 0
INVAR-5, Run: 029, P, 0, 0, 6, 0, 0, 0, 0
INVAR-5, Run: 030, P, 0, 0, 6, 0, 0, 0, 0
INVAR-5, Run: 031, P, 0, 0, 6, 0, 0, 0, 0
INVAR-5, Run: 032, P, 0, 0, 6, 0, 0, 0, 0
INVAR-5, Run: 033, P, 0, 0, 6, 0, 0, 0, 0
INVAR-5, Run: 034, P, 0, 0, 6, 0, 0, 0, 0
INVAR-5, Run: 035, P, 0, 0, 6, 0, 0, 0, 0
INVAR-5, Run: 036, P, 0, 0, 6, 0, 0, 0, 0
INVAR-5, Run: 037, P, 0, 0, 6, 0, 0, 0, 0
INVAR-5, Run: 038, P, 0, 0, 6, 0, 0, 0, 0
INVAR-5, Run: 039, P, 0, 0, 6, 0, 0, 0, 0
INVAR-5, Run: 040, P, 0, 0, 6, 0, 0, 0, 0
INVAR-5, Run: 041, P, 0, 0, 6, 0, 0, 0, 0
INVAR-5, Run: 042, P, 0, 0, 6, 0, 0, 0, 0
INVAR-5, Run: 043, P, 0, 0, 6, 0, 0, 0, 0
INVAR-5, Run: 044, P, 0, 0, 6, 0, 0, 0, 0
INVAR-5, Run: 045, P, 0, 0, 6, 0, 0, 0, 0
INVAR-5, Run: 046, P, 0, 0, 6, 0, 0, 0, 0
INVAR-5, Run: 047, P, 0, 0, 6, 0, 0, 0, 0
INVAR-5, Run: 048, P, 0, 0, 6, 0, 0, 0, 0
INVAR-5, Run: 049, P, 0, 0, 6, 0, 0, 0, 0
INVAR-5, Run: 050, P, 0, 0, 6, 0, 0, 0, 0
INVAR-5, Run: 051, P, 0, 0, 6, 0, 0, 0, 0
INVAR-5, Run: 052, P, 0, 0, 6, 0, 0, 0, 0
INVAR-5, Run: 053, P, 0, 0, 6, 0, 0, 0, 0
INVAR-5, Run: 054, P, 0, 0, 6, 0, 0, 0, 0
INVAR-5, Run: 055, P, 0, 0, 6, 0, 0, 0, 0
INVAR-5, Run: 056, P, 0, 0, 6, 0, 0, 0, 0
INVAR-5, Run: 057, P, 0, 0, 6, 0, 0, 0, 0
INVAR-5, Run: 058, P, 0, 0, 6, 0, 0, 0, 0
INVAR-5, Run: 059, P, 0, 0, 6, 0, 0, 0, 0
INVAR-5, Run: 060, P, 0, 0, 6, 0, 0, 0, 0
INVAR-5, Run: 061, P, 0, 0, 6, 0, 0, 0, 0
INVAR-5, Run: 062, P, 0, 0, 6, 0, 0, 0, 0
INVAR-5, Run: 063, P, 0, 0, 6, 0, 0, 0, 0
INVAR-5, Run: 064, P, 0, 0, 6, 0, 0, 0, 0
INVAR-5, Run: 065, P, 0, 0, 6, 0, 0, 0, 0
INVAR-5, Run: 066, P, 0, 0, 6, 0, 0, 0, 0
INVAR-5, Run: 067, P, 0, 0, 6, 0, 0, 0, 0
INVAR-5, Run: 068, P, 0, 0, 6, 0, 0, 0, 0
INVAR-5, Run: 069, P, 0, 0, 6, 0, 0, 0, 0
INVAR-5, Run: 070, P, 0, 0, 6, 0, 0, 0, 0
INVAR-5, Run: 071, P, 0, 0, 6, 0, 0, 0, 0
INVAR-5, Run: 072, P, 0, 0, 6, 0, 0, 0, 0
INVAR-5, Run: 073, P, 0, 0, 6, 0, 0, 0, 0
INVAR-5, Run: 074, P, 0, 0, 6, 0, 0, 0, 0
INVAR-5, Run: 075, P, 0, 0, 6, 0, 0, 0, 0
INVAR-5, Run: 076, P, 0, 0, 6, 0, 0, 0, 0
INVAR-5, Run: 077, P, 0, 0, 6, 0, 0, 0, 0
INVAR-5, Run: 078, P, 0, 0, 6, 0, 0, 0, 0
INVAR-5, Run: 079, P, 0, 0, 6, 0, 0, 0, 0
INVAR-5, Run: 080, P, 0, 0, 6, 0, 0, 0, 0
INVAR-5, Run: 081, P, 0, 0, 6, 0, 0, 0, 0
INVAR-5, Run: 082, P, 0, 0, 6, 0, 0, 0, 0
INVAR-5, Run: 083, P, 0, 0, 6, 0, 0, 0, 0
INVAR-5, Run: 084, P, 0, 0, 6, 0, 0, 0, 0
INVAR-5, Run: 085, P, 0, 0, 6, 0, 0, 0, 0
INVAR-5, Run: 086, P, 0, 0, 6, 0, 0, 0, 0
INVAR-5, Run: 087, P, 0, 0, 6, 0, 0, 0, 0
INVAR-5, Run: 088, P, 0, 0, 6, 0, 0, 0, 0
INVAR-5, Run: 089, P, 0, 0, 6, 0, 0, 0, 0
INVAR-5, Run: 090, P, 0, 0, 6, 0, 0, 0, 0
INVAR-5, Run: 091, P, 0, 0, 6, 0, 0, 0, 0
INVAR-5, Run: 092, P, 0, 0, 6, 0, 0, 0, 0
INVAR-5, Run: 093, P, 0, 0, 6, 0, 0, 0, 0
INVAR-5, Run: 094, P, 0, 0, 6, 0, 0, 0, 0
INVAR-5, Run: 095, P, 0, 0, 6, 0, 0, 0, 0
INVAR-5, Run: 096, P, 0, 0, 6, 0, 0, 0, 0
INVAR-5, Run: 097, P, 0, 0, 6, 0, 0, 0, 0
INVAR-5, Run: 098, P, 0, 0, 6, 0, 0, 0, 0
INVAR-5, Run: 099, P, 0, 0, 6, 0, 0, 0, 0
INVAR-5, Run: 100, P, 0, 0, 6, 0, 0, 0, 0
INVAR-50, Run: 001, F, 0, 0, 318, 6903, 13142, 6739, 19881
INVAR-50, Run: 002, F, 0, 318, 0, 5644, 1713, 5798, 7511
INVAR-50, Run: 003, F, 0, 318, 0, 2387, 660, 2541, 3201
INVAR-50, Run: 004, F, 0, 0, 318, 14105, 22662, 13941, 36603
INVAR-50, Run: 005, F, 0, 318, 0, 9562, 1737, 9716, 11453
INVAR-50, Run: 006, F, 0, 318, 0, 8009, 2371, 8163, 10534
INVAR-50, Run: 007, F, 0, 0, 318, 35306, 42284, 35142, 77426
INVAR-50, Run: 008, F, 0, 0, 318, 7579, 21438, 7415, 28853
INVAR-50, Run: 009, F, 0, 0, 318, 10853, 21638, 10689, 32327
INVAR-50, Run: 010, F, 0, 0, 318, 15005, 37264, 14841, 52105
INVAR-50, Run: 011, F, 0, 0, 318, 5849, 12069, 5685, 17754
INVAR-50, Run: 012, F, 0, 318, 0, 19472, 6571, 19626, 26197
INVAR-50, Run: 013, F, 0, 0, 318, 3110, 14261, 2946, 17207
INVAR-50, Run: 014, F, 0, 0, 318, 14191, 50484, 14027, 64511
INVAR-50, Run: 015, F, 0, 0, 318, 5824, 12973, 5660, 18633
INVAR-50, Run: 016, F, 0, 0, 318, 1273, 3205, 1109, 4314
INVAR-50, Run: 017, F, 0, 318, 0, 7078, 4431, 7232, 11663
INVAR-50, Run: 018, F, 0, 0, 318, 3556, 10600, 3392, 13992
INVAR-50, Run: 019, F, 0, 0, 318, 12638, 52642, 12474, 65116
INVAR-50, Run: 020, F, 0, 0, 318, 16970, 45570, 16806, 62376
INVAR-50, Run: 021, F, 0, 318, 0, 47338, 15012, 47492, 62504
INVAR-50, Run: 022, F, 0, 0, 318, 9499, 23638, 9335, 32973
INVAR-50, Run: 023, F, 0, 0, 318, 33015, 37204, 32851, 70055
INVAR-50, Run: 024, F, 0, 0, 318, 2608, 9761, 2444, 12205
INVAR-50, Run: 025, F, 0, 0, 318, 23714, 27944, 23550, 51494
INVAR-50, Run: 026, F, 0, 318, 0, 10879, 11109, 11033, 22142
INVAR-50, Run: 027, F, 0, 0, 318, 6605, 31298, 6441, 37739
INVAR-50, Run: 028, F, 0, 318, 0, 28149, 17972, 28303, 46275
INVAR-50, Run: 029, F, 0, 318, 0, 9742, 4212, 9896, 14108
INVAR-50, Run: 030, F, 0, 318, 0, 7553, 2183, 7707, 9890
INVAR-50, Run: 031, F, 0, 0, 318, 27686, 34550, 27522, 62072
INVAR-50, Run: 032, F, 0, 318, 0, 9617, 13651, 9771, 23422
INVAR-50, Run: 033, F, 0, 318, 0, 18635, 6270, 18789, 25059
INVAR-50, Run: 034, F, 0, 318, 0, 13167, 3370, 13321, 16691
INVAR-50, Run: 035, F, 0, 318, 0, 20463, 8656, 20617, 29273
INVAR-50, Run: 036, F, 0, 0, 318, 3576, 7043, 3412, 10455
INVAR-50, Run: 037, F, 0, 0, 318, 14507, 27775, 14343, 42118
INVAR-50, Run: 038, F, 0, 318, 0, 4436, 1156, 4590, 5746
INVAR-50, Run: 039, F, 0, 318, 0, 11385, 2891, 11539, 14430
INVAR-50, Run: 040, F, 0, 0, 318, 9246, 18916, 9082, 27998
INVAR-50, Run: 041, F, 0, 0, 318, 8835, 27720, 8671, 36391
INVAR-50, Run: 042, F, 0, 318, 0, 12861, 8004, 13015, 21019
INVAR-50, Run: 043, F, 0, 318, 0, 16648, 4979, 16802, 21781
INVAR-50, Run: 044, F, 0, 318, 0, 2546, 758, 2700, 3458
INVAR-50, Run: 045, F, 0, 318, 0, 9287, 5093, 9441, 14534
INVAR-50, Run: 046, F, 0, 0, 318, 9589, 14142, 9425, 23567
INVAR-50, Run: 047, F, 0, 318, 0, 5557, 1918, 5711, 7629
INVAR-50, Run: 048, F, 0, 318, 0, 10080, 10645, 10234, 20879
INVAR-50, Run: 049, F, 0, 318, 0, 8715, 2229, 8869, 11098
INVAR-50, Run: 050, F, 0, 318, 0, 8612, 2376, 8766, 11142
INVAR-50, Run: 051, F, 0, 0, 318, 8106, 30032, 7942, 37974
INVAR-50, Run: 052, F, 0, 0, 318, 6172, 16511, 6008, 22519
INVAR-50, Run: 053, F, 0, 318, 0, 13673, 3150, 13827, 16977
INVAR-50, Run: 054, F, 0, 0, 318, 20998, 33385, 20834, 54219
INVAR-50, Run: 055, F, 0, 318, 0, 12553, 5540, 12707, 18247
INVAR-50, Run: 056, F, 0, 0, 318, 2430, 11663, 2266, 13929
INVAR-50, Run: 057, F, 0, 318, 0, 21898, 9493, 22052, 31545
INVAR-50, Run: 058, F, 0, 0, 318, 2409, 11873, 2245, 14118
INVAR-50, Run: 059, F, 0, 0, 318, 4883, 10164, 4719, 14883
INVAR-50, Run: 060, F, 0, 318, 0, 10662, 4252, 10816, 15068
INVAR-50, Run: 061, F, 0, 0, 318, 4151, 9330, 3987, 13317
INVAR-50, Run: 062, F, 0, 0, 318, 12215, 28574, 12051, 40625
INVAR-50, Run: 063, F, 0, 318, 0, 6597, 2158, 6751, 8909
INVAR-50, Run: 064, F, 0, 0, 318, 28790, 61549, 28626, 90175
INVAR-50, Run: 065, F, 0, 0, 318, 8889, 22121, 8725, 30846
INVAR-50, Run: 066, F, 0, 318, 0, 5196, 1168, 5350, 6518
INVAR-50, Run: 067, F, 0, 0, 318, 6405, 12411, 6241, 18652
INVAR-50, Run: 068, F, 0, 318, 0, 16710, 15737, 16864, 32601
INVAR-50, Run: 069, F, 0, 0, 318, 4176, 8655, 4012, 12667
INVAR-50, Run: 070, F, 0, 318, 0, 5517, 1241, 5671, 6912
INVAR-50, Run: 071, F, 0, 318, 0, 12559, 4830, 12713, 17543
INVAR-50, Run: 072, F, 0, 0, 318, 23937, 25395, 23773, 49168
INVAR-50, Run: 073, F, 0, 0, 318, 4340, 10651, 4176, 14827
INVAR-50, Run: 074, F, 0, 0, 318, 8386, 22237, 8222, 30459
INVAR-50, Run: 075, F, 0, 0, 318, 7292, 16444, 7128, 23572
INVAR-50, Run: 076, F, 0, 0, 318, 4919, 14204, 4755, 18959
INVAR-50, Run: 077, F, 0, 318, 0, 6812, 4751, 6966, 11717
INVAR-50, Run: 078, F, 0, 318, 0, 5044, 1771, 5198, 6969
INVAR-50, Run: 079, F, 0, 0, 318, 3827, 16829, 3663, 20492
INVAR-50, Run: 080, F, 0, 318, 0, 16728, 12228, 16882, 29110
INVAR-50, Run: 081, F, 0, 318, 0, 10064, 3313, 10218, 13531
INVAR-50, Run: 082, F, 0, 318, 0, 7886, 2171, 8040, 10211
INVAR-50, Run: 083, F, 0, 318, 0, 13499, 5945, 13653, 19598
INVAR-50, Run: 084, F, 0, 318, 0, 16811, 14169, 16965, 31134
INVAR-50, Run: 085, F, 0, 318, 0, 12721, 8698, 12875, 21573
INVAR-50, Run: 086, F, 0, 318, 0, 9272, 5262, 9426, 14688
INVAR-50, Run: 087, F, 0, 0, 318, 10815, 28024, 10651, 38675
INVAR-50, Run: 088, F, 0, 318, 0, 10446, 2611, 10600, 13211
INVAR-50, Run: 089, F, 0, 0, 318, 8012, 10907, 7848, 18755
INVAR-50, Run: 090, F, 0, 318, 0, 9341, 1663, 9495, 11158
INVAR-50, Run: 091, F, 0, 318, 0, 1039, 188, 1193, 1381
INVAR-50, Run: 092, F, 0, 0, 318, 25243, 61121, 25079, 86200
INVAR-50, Run: 093, F, 0, 318, 0, 16211, 10250, 16365, 26615
INVAR-50, Run: 094, F, 0, 318, 0, 12386, 10254, 12540, 22794
INVAR-50, Run: 095, F, 0, 318, 0, 11389, 2514, 11543, 14057
INVAR-50, Run: 096, F, 0, 318, 0, 6177, 1795, 6331, 8126
INVAR-50, Run: 097, F, 0, 318, 0, 1860, 517, 2014, 2531
INVAR-50, Run: 098, F, 0, 0, 318, 10526, 15713, 10362, 26075
INVAR-50, Run: 099, F, 0, 0, 318, 21045, 32558, 20881, 53439
INVAR-50, Run: 100, F, 0, 318, 0, 1574, 241, 1728, 1969
INVAR-51, Run: 001, P, 0, 0, 48, 0, 0, 0, 0
INVAR-51, Run: 002, P, 0, 0, 48, 0, 0, 0, 0
INVAR-51, Run: 003, P, 0, 0, 48, 0, 0, 0, 0
INVAR-51, Run: 004, P, 0, 0, 48, 0, 0, 0, 0
INVAR-51, Run: 005, P, 0, 0, 48, 0, 0, 0, 0
INVAR-51, Run: 006, P, 0, 0, 48, 0, 0, 0, 0
INVAR-51, Run: 007, P, 0, 0, 48, 0, 0, 0, 0
INVAR-51, Run: 008, P, 0, 0, 48, 0, 0, 0, 0
INVAR-51, Run: 009, P, 0, 0, 48, 0, 0, 0, 0
INVAR-51, Run: 010, P, 0, 0, 48, 0, 0, 0, 0
INVAR-51, Run: 011, P, 0, 0, 48, 0, 0, 0, 0
INVAR-51, Run: 012, P, 0, 0, 48, 0, 0, 0, 0
INVAR-51, Run: 013, P, 0, 0, 48, 0, 0, 0, 0
INVAR-51, Run: 014, P, 0, 0, 48, 0, 0, 0, 0
INVAR-51, Run: 015, P, 0, 0, 48, 0, 0, 0, 0
INVAR-51, Run: 016, P, 0, 0, 48, 0, 0, 0, 0
INVAR-51, Run: 017, P, 0, 0, 48, 0, 0, 0, 0
INVAR-51, Run: 018, P, 0, 0, 48, 0, 0, 0, 0
INVAR-51, Run: 019, P, 0, 0, 48, 0, 0, 0, 0
INVAR-51, Run: 020, P, 0, 0, 48, 0, 0, 0, 0
INVAR-51, Run: 021, P, 0, 0, 48, 0, 0, 0, 0
INVAR-51, Run: 022, P, 0, 0, 48, 0, 0, 0, 0
INVAR-51, Run: 023, P, 0, 0, 48, 0, 0, 0, 0
INVAR-51, Run: 024, P, 0, 0, 48, 0, 0, 0, 0
INVAR-51, Run: 025, P, 0, 0, 48, 0, 0, 0, 0
INVAR-51, Run: 026, P, 0, 0, 48, 0, 0, 0, 0
INVAR-51, Run: 027, P, 0, 0, 48, 0, 0, 0, 0
INVAR-51, Run: 028, P, 0, 0, 48, 0, 0, 0, 0
INVAR-51, Run: 029, P, 0, 0, 48, 0, 0, 0, 0
INVAR-51, Run: 030, P, 0, 0, 48, 0, 0, 0, 0
INVAR-51, Run: 031, P, 0, 0, 48, 0, 0, 0, 0
INVAR-51, Run: 032, P, 0, 0, 48, 0, 0, 0, 0
INVAR-51, Run: 033, P, 0, 0, 48, 0, 0, 0, 0
INVAR-51, Run: 034, P, 0, 0, 48, 0, 0, 0, 0
INVAR-51, Run: 035, P, 0, 0, 48, 0, 0, 0, 0
INVAR-51, Run: 036, P, 0, 0, 48, 0, 0, 0, 0
INVAR-51, Run: 037, P, 0, 0, 48, 0, 0, 0, 0
INVAR-51, Run: 038, P, 0, 0, 48, 0, 0, 0, 0
INVAR-51, Run: 039, P, 0, 0, 48, 0, 0, 0, 0
INVAR-51, Run: 040, P, 0, 0, 48, 0, 0, 0, 0
INVAR-51, Run: 041, P, 0, 0, 48, 0, 0, 0, 0
INVAR-51, Run: 042, P, 0, 0, 48, 0, 0, 0, 0
INVAR-51, Run: 043, P, 0, 0, 48, 0, 0, 0, 0
INVAR-51, Run: 044, P, 0, 0, 48, 0, 0, 0, 0
INVAR-51, Run: 045, P, 0, 0, 48, 0, 0, 0, 0
INVAR-51, Run: 046, P, 0, 0, 48, 0, 0, 0, 0
INVAR-51, Run: 047, P, 0, 0, 48, 0, 0, 0, 0
INVAR-51, Run: 048, P, 0, 0, 48, 0, 0, 0, 0
INVAR-51, Run: 049, P, 0, 0, 48, 0, 0, 0, 0
INVAR-51, Run: 050, P, 0, 0, 48, 0, 0, 0, 0
INVAR-51, Run: 051, P, 0, 0, 48, 0, 0, 0, 0
INVAR-51, Run: 052, P, 0, 0, 48, 0, 0, 0, 0
INVAR-51, Run: 053, P, 0, 0, 48, 0, 0, 0, 0
INVAR-51, Run: 054, P, 0, 0, 48, 0, 0, 0, 0
INVAR-51, Run: 055, P, 0, 0, 48, 0, 0, 0, 0
INVAR-51, Run: 056, P, 0, 0, 48, 0, 0, 0, 0
INVAR-51, Run: 057, P, 0, 0, 48, 0, 0, 0, 0
INVAR-51, Run: 058, P, 0, 0, 48, 0, 0, 0, 0
INVAR-51, Run: 059, P, 0, 0, 48, 0, 0, 0, 0
INVAR-51, Run: 060, P, 0, 0, 48, 0, 0, 0, 0
INVAR-51, Run: 061, P, 0, 0, 48, 0, 0, 0, 0
INVAR-51, Run: 062, P, 0, 0, 48, 0, 0, 0, 0
INVAR-51, Run: 063, P, 0, 0, 48, 0, 0, 0, 0
INVAR-51, Run: 064, P, 0, 0, 48, 0, 0, 0, 0
INVAR-51, Run: 065, P, 0, 0, 48, 0, 0, 0, 0
INVAR-51, Run: 066, P, 0, 0, 48, 0, 0, 0, 0
INVAR-51, Run: 067, P, 0, 0, 48, 0, 0, 0, 0
INVAR-51, Run: 068, P, 0, 0, 48, 0, 0, 0, 0
INVAR-51, Run: 069, P, 0, 0, 48, 0, 0, 0, 0
INVAR-51, Run: 070, P, 0, 0, 48, 0, 0, 0, 0
INVAR-51, Run: 071, P, 0, 0, 48, 0, 0, 0, 0
INVAR-51, Run: 072, P, 0, 0, 48, 0, 0, 0, 0
INVAR-51, Run: 073, P, 0, 0, 48, 0, 0, 0, 0
INVAR-51, Run: 074, P, 0, 0, 48, 0, 0, 0, 0
INVAR-51, Run: 075, P, 0, 0, 48, 0, 0, 0, 0
INVAR-51, Run: 076, P, 0, 0, 48, 0, 0, 0, 0
INVAR-51, Run: 077, P, 0, 0, 48, 0, 0, 0, 0
INVAR-51, Run: 078, P, 0, 0, 48, 0, 0, 0, 0
INVAR-51, Run: 079, P, 0, 0, 48, 0, 0, 0, 0
INVAR-51, Run: 080, P, 0, 0, 48, 0, 0, 0, 0
INVAR-51, Run: 081, P, 0, 0, 48, 0, 0, 0, 0
INVAR-51, Run: 082, P, 0, 0, 48, 0, 0, 0, 0
INVAR-51, Run: 083, P, 0, 0, 48, 0, 0, 0, 0
INVAR-51, Run: 084, P, 0, 0, 48, 0, 0, 0, 0
INVAR-51, Run: 085, P, 0, 0, 48, 0, 0, 0, 0
INVAR-51, Run: 086, P, 0, 0, 48, 0, 0, 0, 0
INVAR-51, Run: 087, P, 0, 0, 48, 0, 0, 0, 0
INVAR-51, Run: 088, P, 0, 0, 48, 0, 0, 0, 0
INVAR-51, Run: 089, P, 0, 0, 48, 0, 0, 0, 0
INVAR-51, Run: 090, P, 0, 0, 48, 0, 0, 0, 0
INVAR-51, Run: 091, P, 0, 0, 48, 0, 0, 0, 0
INVAR-51, Run: 092, P, 0, 0, 48, 0, 0, 0, 0
INVAR-51, Run: 093, P, 0, 0, 48, 0, 0, 0, 0
INVAR-51, Run: 094, P, 0, 0, 48, 0, 0, 0, 0
INVAR-51, Run: 095, P, 0, 0, 48, 0, 0, 0, 0
INVAR-51, Run: 096, P, 0, 0, 48, 0, 0, 0, 0
INVAR-51, Run: 097, P, 0, 0, 48, 0, 0, 0, 0
INVAR-51, Run: 098, P, 0, 0, 48, 0, 0, 0, 0
INVAR-51, Run: 099, P, 0, 0, 48, 0, 0, 0, 0
INVAR-51, Run: 100, P, 0, 0, 48, 0, 0, 0, 0
INVAR-52, Run: 001, P, 0, 0, 80, 0, 0, 0, 0
INVAR-52, Run: 002, P, 0, 0, 80, 0, 0, 0, 0
INVAR-52, Run: 003, P, 0, 0, 80, 0, 0, 0, 0
INVAR-52, Run: 004, P, 0, 0, 80, 0, 0, 0, 0
INVAR-52, Run: 005, P, 0, 0, 80, 0, 0, 0, 0
INVAR-52, Run: 006, P, 0, 0, 80, 0, 0, 0, 0
INVAR-52, Run: 007, P, 0, 0, 80, 0, 0, 0, 0
INVAR-52, Run: 008, P, 0, 0, 80, 0, 0, 0, 0
INVAR-52, Run: 009, P, 0, 0, 80, 0, 0, 0, 0
INVAR-52, Run: 010, P, 0, 0, 80, 0, 0, 0, 0
INVAR-52, Run: 011, P, 0, 0, 80, 0, 0, 0, 0
INVAR-52, Run: 012, P, 0, 0, 80, 0, 0, 0, 0
INVAR-52, Run: 013, P, 0, 0, 80, 0, 0, 0, 0
INVAR-52, Run: 014, P, 0, 0, 80, 0, 0, 0, 0
INVAR-52, Run: 015, P, 0, 0, 80, 0, 0, 0, 0
INVAR-52, Run: 016, P, 0, 0, 80, 0, 0, 0, 0
INVAR-52, Run: 017, P, 0, 0, 80, 0, 0, 0, 0
INVAR-52, Run: 018, P, 0, 0, 80, 0, 0, 0, 0
INVAR-52, Run: 019, P, 0, 0, 80, 0, 0, 0, 0
INVAR-52, Run: 020, P, 0, 0, 80, 0, 0, 0, 0
INVAR-52, Run: 021, P, 0, 0, 80, 0, 0, 0, 0
INVAR-52, Run: 022, P, 0, 0, 80, 0, 0, 0, 0
INVAR-52, Run: 023, P, 0, 0, 80, 0, 0, 0, 0
INVAR-52, Run: 024, P, 0, 0, 80, 0, 0, 0, 0
INVAR-52, Run: 025, P, 0, 0, 80, 0, 0, 0, 0
INVAR-52, Run: 026, P, 0, 0, 80, 0, 0, 0, 0
INVAR-52, Run: 027, P, 0, 0, 80, 0, 0, 0, 0
INVAR-52, Run: 028, P, 0, 0, 80, 0, 0, 0, 0
INVAR-52, Run: 029, P, 0, 0, 80, 0, 0, 0, 0
INVAR-52, Run: 030, P, 0, 0, 80, 0, 0, 0, 0
INVAR-52, Run: 031, P, 0, 0, 80, 0, 0, 0, 0
INVAR-52, Run: 032, P, 0, 0, 80, 0, 0, 0, 0
INVAR-52, Run: 033, P, 0, 0, 80, 0, 0, 0, 0
INVAR-52, Run: 034, P, 0, 0, 80, 0, 0, 0, 0
INVAR-52, Run: 035, P, 0, 0, 80, 0, 0, 0, 0
INVAR-52, Run: 036, P, 0, 0, 80, 0, 0, 0, 0
INVAR-52, Run: 037, P, 0, 0, 80, 0, 0, 0, 0
INVAR-52, Run: 038, P, 0, 0, 80, 0, 0, 0, 0
INVAR-52, Run: 039, P, 0, 0, 80, 0, 0, 0, 0
INVAR-52, Run: 040, P, 0, 0, 80, 0, 0, 0, 0
INVAR-52, Run: 041, P, 0, 0, 80, 0, 0, 0, 0
INVAR-52, Run: 042, P, 0, 0, 80, 0, 0, 0, 0
INVAR-52, Run: 043, P, 0, 0, 80, 0, 0, 0, 0
INVAR-52, Run: 044, P, 0, 0, 80, 0, 0, 0, 0
INVAR-52, Run: 045, P, 0, 0, 80, 0, 0, 0, 0
INVAR-52, Run: 046, P, 0, 0, 80, 0, 0, 0, 0
INVAR-52, Run: 047, P, 0, 0, 80, 0, 0, 0, 0
INVAR-52, Run: 048, P, 0, 0, 80, 0, 0, 0, 0
INVAR-52, Run: 049, P, 0, 0, 80, 0, 0, 0, 0
INVAR-52, Run: 050, P, 0, 0, 80, 0, 0, 0, 0
INVAR-52, Run: 051, P, 0, 0, 80, 0, 0, 0, 0
INVAR-52, Run: 052, P, 0, 0, 80, 0, 0, 0, 0
INVAR-52, Run: 053, P, 0, 0, 80, 0, 0, 0, 0
INVAR-52, Run: 054, P, 0, 0, 80, 0, 0, 0, 0
INVAR-52, Run: 055, P, 0, 0, 80, 0, 0, 0, 0
INVAR-52, Run: 056, P, 0, 0, 80, 0, 0, 0, 0
INVAR-52, Run: 057, P, 0, 0, 80, 0, 0, 0, 0
INVAR-52, Run: 058, P, 0, 0, 80, 0, 0, 0, 0
INVAR-52, Run: 059, P, 0, 0, 80, 0, 0, 0, 0
INVAR-52, Run: 060, P, 0, 0, 80, 0, 0, 0, 0
INVAR-52, Run: 061, P, 0, 0, 80, 0, 0, 0, 0
INVAR-52, Run: 062, P, 0, 0, 80, 0, 0, 0, 0
INVAR-52, Run: 063, P, 0, 0, 80, 0, 0, 0, 0
INVAR-52, Run: 064, P, 0, 0, 80, 0, 0, 0, 0
INVAR-52, Run: 065, P, 0, 0, 80, 0, 0, 0, 0
INVAR-52, Run: 066, P, 0, 0, 80, 0, 0, 0, 0
INVAR-52, Run: 067, P, 0, 0, 80, 0, 0, 0, 0
INVAR-52, Run: 068, P, 0, 0, 80, 0, 0, 0, 0
INVAR-52, Run: 069, P, 0, 0, 80, 0, 0, 0, 0
INVAR-52, Run: 070, P, 0, 0, 80, 0, 0, 0, 0
INVAR-52, Run: 071, P, 0, 0, 80, 0, 0, 0, 0
INVAR-52, Run: 072, P, 0, 0, 80, 0, 0, 0, 0
INVAR-52, Run: 073, P, 0, 0, 80, 0, 0, 0, 0
INVAR-52, Run: 074, P, 0, 0, 80, 0, 0, 0, 0
INVAR-52, Run: 075, P, 0, 0, 80, 0, 0, 0, 0
INVAR-52, Run: 076, P, 0, 0, 80, 0, 0, 0, 0
INVAR-52, Run: 077, P, 0, 0, 80, 0, 0, 0, 0
INVAR-52, Run: 078, P, 0, 0, 80, 0, 0, 0, 0
INVAR-52, Run: 079, P, 0, 0, 80, 0, 0, 0, 0
INVAR-52, Run: 080, P, 0, 0, 80, 0, 0, 0, 0
INVAR-52, Run: 081, P, 0, 0, 80, 0, 0, 0, 0
INVAR-52, Run: 082, P, 0, 0, 80, 0, 0, 0, 0
INVAR-52, Run: 083, P, 0, 0, 80, 0, 0, 0, 0
INVAR-52, Run: 084, P, 0, 0, 80, 0, 0, 0, 0
INVAR-52, Run: 085, P, 0, 0, 80, 0, 0, 0, 0
INVAR-52, Run: 086, P, 0, 0, 80, 0, 0, 0, 0
INVAR-52, Run: 087, P, 0, 0, 80, 0, 0, 0, 0
INVAR-52, Run: 088, P, 0, 0, 80, 0, 0, 0, 0
INVAR-52, Run: 089, P, 0, 0, 80, 0, 0, 0, 0
INVAR-52, Run: 090, P, 0, 0, 80, 0, 0, 0, 0
INVAR-52, Run: 091, P, 0, 0, 80, 0, 0, 0, 0
INVAR-52, Run: 092, P, 0, 0, 80, 0, 0, 0, 0
INVAR-52, Run: 093, P, 0, 0, 80, 0, 0, 0, 0
INVAR-52, Run: 094, P, 0, 0, 80, 0, 0, 0, 0
INVAR-52, Run: 095, P, 0, 0, 80, 0, 0, 0, 0
INVAR-52, Run: 096, P, 0, 0, 80, 0, 0, 0, 0
INVAR-52, Run: 097, P, 0, 0, 80, 0, 0, 0, 0
INVAR-52, Run: 098, P, 0, 0, 80, 0, 0, 0, 0
INVAR-52, Run: 099, P, 0, 0, 80, 0, 0, 0, 0
INVAR-52, Run: 100, P, 0, 0, 80, 0, 0, 0, 0
INVAR-53, Run: 001, P, 0, 0, 172, 0, 0, 0, 0
INVAR-53, Run: 002, P, 0, 0, 172, 0, 0, 0, 0
INVAR-53, Run: 003, P, 0, 0, 172, 0, 0, 0, 0
INVAR-53, Run: 004, P, 0, 0, 172, 0, 0, 0, 0
INVAR-53, Run: 005, P, 0, 0, 172, 0, 0, 0, 0
INVAR-53, Run: 006, P, 0, 0, 172, 0, 0, 0, 0
INVAR-53, Run: 007, P, 0, 0, 172, 0, 0, 0, 0
INVAR-53, Run: 008, P, 0, 0, 172, 0, 0, 0, 0
INVAR-53, Run: 009, P, 0, 0, 172, 0, 0, 0, 0
INVAR-53, Run: 010, P, 0, 0, 172, 0, 0, 0, 0
INVAR-53, Run: 011, P, 0, 0, 172, 0, 0, 0, 0
INVAR-53, Run: 012, P, 0, 0, 172, 0, 0, 0, 0
INVAR-53, Run: 013, P, 0, 0, 172, 0, 0, 0, 0
INVAR-53, Run: 014, P, 0, 0, 172, 0, 0, 0, 0
INVAR-53, Run: 015, P, 0, 0, 172, 0, 0, 0, 0
INVAR-53, Run: 016, P, 0, 0, 172, 0, 0, 0, 0
INVAR-53, Run: 017, P, 0, 0, 172, 0, 0, 0, 0
INVAR-53, Run: 018, P, 0, 0, 172, 0, 0, 0, 0
INVAR-53, Run: 019, P, 0, 0, 172, 0, 0, 0, 0
INVAR-53, Run: 020, P, 0, 0, 172, 0, 0, 0, 0
INVAR-53, Run: 021, P, 0, 0, 172, 0, 0, 0, 0
INVAR-53, Run: 022, P, 0, 0, 172, 0, 0, 0, 0
INVAR-53, Run: 023, P, 0, 0, 172, 0, 0, 0, 0
INVAR-53, Run: 024, P, 0, 0, 172, 0, 0, 0, 0
INVAR-53, Run: 025, P, 0, 0, 172, 0, 0, 0, 0
INVAR-53, Run: 026, P, 0, 0, 172, 0, 0, 0, 0
INVAR-53, Run: 027, P, 0, 0, 172, 0, 0, 0, 0
INVAR-53, Run: 028, P, 0, 0, 172, 0, 0, 0, 0
INVAR-53, Run: 029, P, 0, 0, 172, 0, 0, 0, 0
INVAR-53, Run: 030, P, 0, 0, 172, 0, 0, 0, 0
INVAR-53, Run: 031, P, 0, 0, 172, 0, 0, 0, 0
INVAR-53, Run: 032, P, 0, 0, 172, 0, 0, 0, 0
INVAR-53, Run: 033, P, 0, 0, 172, 0, 0, 0, 0
INVAR-53, Run: 034, P, 0, 0, 172, 0, 0, 0, 0
INVAR-53, Run: 035, P, 0, 0, 172, 0, 0, 0, 0
INVAR-53, Run: 036, P, 0, 0, 172, 0, 0, 0, 0
INVAR-53, Run: 037, P, 0, 0, 172, 0, 0, 0, 0
INVAR-53, Run: 038, P, 0, 0, 172, 0, 0, 0, 0
INVAR-53, Run: 039, P, 0, 0, 172, 0, 0, 0, 0
INVAR-53, Run: 040, P, 0, 0, 172, 0, 0, 0, 0
INVAR-53, Run: 041, P, 0, 0, 172, 0, 0, 0, 0
INVAR-53, Run: 042, P, 0, 0, 172, 0, 0, 0, 0
INVAR-53, Run: 043, P, 0, 0, 172, 0, 0, 0, 0
INVAR-53, Run: 044, P, 0, 0, 172, 0, 0, 0, 0
INVAR-53, Run: 045, P, 0, 0, 172, 0, 0, 0, 0
INVAR-53, Run: 046, P, 0, 0, 172, 0, 0, 0, 0
INVAR-53, Run: 047, P, 0, 0, 172, 0, 0, 0, 0
INVAR-53, Run: 048, P, 0, 0, 172, 0, 0, 0, 0
INVAR-53, Run: 049, P, 0, 0, 172, 0, 0, 0, 0
INVAR-53, Run: 050, P, 0, 0, 172, 0, 0, 0, 0
INVAR-53, Run: 051, P, 0, 0, 172, 0, 0, 0, 0
INVAR-53, Run: 052, P, 0, 0, 172, 0, 0, 0, 0
INVAR-53, Run: 053, P, 0, 0, 172, 0, 0, 0, 0
INVAR-53, Run: 054, P, 0, 0, 172, 0, 0, 0, 0
INVAR-53, Run: 055, P, 0, 0, 172, 0, 0, 0, 0
INVAR-53, Run: 056, P, 0, 0, 172, 0, 0, 0, 0
INVAR-53, Run: 057, P, 0, 0, 172, 0, 0, 0, 0
INVAR-53, Run: 058, P, 0, 0, 172, 0, 0, 0, 0
INVAR-53, Run: 059, P, 0, 0, 172, 0, 0, 0, 0
INVAR-53, Run: 060, P, 0, 0, 172, 0, 0, 0, 0
INVAR-53, Run: 061, P, 0, 0, 172, 0, 0, 0, 0
INVAR-53, Run: 062, P, 0, 0, 172, 0, 0, 0, 0
INVAR-53, Run: 063, P, 0, 0, 172, 0, 0, 0, 0
INVAR-53, Run: 064, P, 0, 0, 172, 0, 0, 0, 0
INVAR-53, Run: 065, P, 0, 0, 172, 0, 0, 0, 0
INVAR-53, Run: 066, P, 0, 0, 172, 0, 0, 0, 0
INVAR-53, Run: 067, P, 0, 0, 172, 0, 0, 0, 0
INVAR-53, Run: 068, P, 0, 0, 172, 0, 0, 0, 0
INVAR-53, Run: 069, P, 0, 0, 172, 0, 0, 0, 0
INVAR-53, Run: 070, P, 0, 0, 172, 0, 0, 0, 0
INVAR-53, Run: 071, P, 0, 0, 172, 0, 0, 0, 0
INVAR-53, Run: 072, P, 0, 0, 172, 0, 0, 0, 0
INVAR-53, Run: 073, P, 0, 0, 172, 0, 0, 0, 0
INVAR-53, Run: 074, P, 0, 0, 172, 0, 0, 0, 0
INVAR-53, Run: 075, P, 0, 0, 172, 0, 0, 0, 0
INVAR-53, Run: 076, P, 0, 0, 172, 0, 0, 0, 0
INVAR-53, Run: 077, P, 0, 0, 172, 0, 0, 0, 0
INVAR-53, Run: 078, P, 0, 0, 172, 0, 0, 0, 0
INVAR-53, Run: 079, P, 0, 0, 172, 0, 0, 0, 0
INVAR-53, Run: 080, P, 0, 0, 172, 0, 0, 0, 0
INVAR-53, Run: 081, P, 0, 0, 172, 0, 0, 0, 0
INVAR-53, Run: 082, P, 0, 0, 172, 0, 0, 0, 0
INVAR-53, Run: 083, P, 0, 0, 172, 0, 0, 0, 0
INVAR-53, Run: 084, P, 0, 0, 172, 0, 0, 0, 0
INVAR-53, Run: 085, P, 0, 0, 172, 0, 0, 0, 0
INVAR-53, Run: 086, P, 0, 0, 172, 0, 0, 0, 0
INVAR-53, Run: 087, P, 0, 0, 172, 0, 0, 0, 0
INVAR-53, Run: 088, P, 0, 0, 172, 0, 0, 0, 0
INVAR-53, Run: 089, P, 0, 0, 172, 0, 0, 0, 0
INVAR-53, Run: 090, P, 0, 0, 172, 0, 0, 0, 0
INVAR-53, Run: 091, P, 0, 0, 172, 0, 0, 0, 0
INVAR-53, Run: 092, P, 0, 0, 172, 0, 0, 0, 0
INVAR-53, Run: 093, P, 0, 0, 172, 0, 0, 0, 0
INVAR-53, Run: 094, P, 0, 0, 172, 0, 0, 0, 0
INVAR-53, Run: 095, P, 0, 0, 172, 0, 0, 0, 0
INVAR-53, Run: 096, P, 0, 0, 172, 0, 0, 0, 0
INVAR-53, Run: 097, P, 0, 0, 172, 0, 0, 0, 0
INVAR-53, Run: 098, P, 0, 0, 172, 0, 0, 0, 0
INVAR-53, Run: 099, P, 0, 0, 172, 0, 0, 0, 0
INVAR-53, Run: 100, P, 0, 0, 172, 0, 0, 0, 0
INVAR-54, Run: 001, F, 0, 51, 0, 317, 492, 366, 858
INVAR-54, Run: 002, F, 0, 0, 51, 17, 134, 15, 149
INVAR-54, Run: 003, F, 0, 0, 51, 503, 956, 501, 1457
INVAR-54, Run: 004, F, 0, 0, 51, 2, 21, 0, 21
INVAR-54, Run: 005, F, 0, 0, 51, 6, 112, 4, 116
INVAR-54, Run: 006, F, 0, 0, 51, 312, 873, 310, 1183
INVAR-54, Run: 007, F, 0, 0, 51, 4, 133, 2, 135
INVAR-54, Run: 008, F, 0, 0, 51, 2, 6, 0, 6
INVAR-54, Run: 009, F, 0, 0, 51, 9, 128, 7, 135
INVAR-54, Run: 010, F, 0, 0, 51, 7, 95, 5, 100
INVAR-54, Run: 011, F, 0, 0, 51, 24, 221, 22, 243
INVAR-54, Run: 012, F, 0, 0, 51, 37, 487, 35, 522
INVAR-54, Run: 013, F, 0, 0, 51, 2, 41, 0, 41
INVAR-54, Run: 014, F, 0, 0, 51, 3, 19, 1, 20
INVAR-54, Run: 015, F, 0, 0, 51, 619, 767, 617, 1384
INVAR-54, Run: 016, F, 0, 0, 51, 34, 375, 32, 407
INVAR-54, Run: 017, F, 0, 0, 51, 8, 111, 6, 117
INVAR-54, Run: 018, F, 0, 0, 51, 65, 470, 63, 533
INVAR-54, Run: 019, F, 0, 0, 51, 2, 31, 0, 31
INVAR-54, Run: 020, F, 0, 0, 51, 11, 165, 9, 174
INVAR-54, Run: 021, F, 0, 0, 51, 2, 42, 0, 42
INVAR-54, Run: 022, F, 0, 0, 51, 4, 82, 2, 84
INVAR-54, Run: 023, F, 0, 51, 0, 109, 117, 158, 275
INVAR-54, Run: 024, F, 0, 0, 51, 57, 555, 55, 610
INVAR-54, Run: 025, F, 0, 0, 51, 2, 52, 0, 52
INVAR-54, Run: 026, F, 0, 0, 51, 4, 24, 2, 26
INVAR-54, Run: 027, F, 0, 0, 51, 19, 274, 17, 291
INVAR-54, Run: 028, F, 0, 0, 51, 9, 281, 7, 288
INVAR-54, Run: 029, F, 0, 0, 51, 2, 31, 0, 31
INVAR-54, Run: 030, F, 0, 0, 51, 80, 455, 78, 533
INVAR-54, Run: 031, F, 0, 0, 51, 2, 24, 0, 24
INVAR-54, Run: 032, F, 0, 0, 51, 2, 119, 0, 119
INVAR-54, Run: 033, F, 0, 0, 51, 3, 73, 1, 74
INVAR-54, Run: 034, F, 0, 0, 51, 39, 443, 37, 480
INVAR-54, Run: 035, F, 0, 0, 51, 3, 74, 1, 75
INVAR-54, Run: 036, F, 0, 0, 51, 4, 90, 2, 92
INVAR-54, Run: 037, F, 0, 0, 51, 12, 228, 10, 238
INVAR-54, Run: 038, F, 0, 0, 51, 10, 245, 8, 253
INVAR-54, Run: 039, F, 0, 0, 51, 3, 49, 1, 50
INVAR-54, Run: 040, F, 0, 0, 51, 4, 69, 2, 71
INVAR-54, Run: 041, F, 0, 0, 51, 628, 1188, 626, 1814
INVAR-54, Run: 042, F, 0, 0, 51, 40, 249, 38, 287
INVAR-54, Run: 043, F, 0, 0, 51, 2, 83, 0, 83
INVAR-54, Run: 044, F, 0, 0, 51, 6, 108, 4, 112
INVAR-54, Run: 045, F, 0, 0, 51, 46, 457, 44, 501
INVAR-54, Run: 046, F, 0, 0, 51, 10, 88, 8, 96
INVAR-54, Run: 047, F, 0, 0, 51, 3, 28, 1, 29
INVAR-54, Run: 048, F, 0, 51, 0, 545, 561, 594, 1155
INVAR-54, Run: 049, F, 0, 0, 51, 3, 10, 1, 11
INVAR-54, Run: 050, F, 0, 0, 51, 2, 33, 0, 33
INVAR-54, Run: 051, F, 0, 0, 51, 2, 6, 0, 6
INVAR-54, Run: 052, F, 0, 0, 51, 25, 183, 23, 206
INVAR-54, Run: 053, F, 0, 0, 51, 2, 48, 0, 48
INVAR-54, Run: 054, F, 0, 0, 51, 2, 66, 0, 66
INVAR-54, Run: 055, F, 0, 0, 51, 3, 65, 1, 66
INVAR-54, Run: 056, F, 0, 0, 51, 4, 81, 2, 83
INVAR-54, Run: 057, F, 0, 0, 51, 53, 629, 51, 680
INVAR-54, Run: 058, F, 0, 0, 51, 3, 156, 1, 157
INVAR-54, Run: 059, F, 0, 0, 51, 2, 13, 0, 13
INVAR-54, Run: 060, F, 0, 0, 51, 3, 80, 1, 81
INVAR-54, Run: 061, F, 0, 0, 51, 7, 130, 5, 135
INVAR-54, Run: 062, F, 0, 0, 51, 3, 91, 1, 92
INVAR-54, Run: 063, F, 0, 0, 51, 11, 105, 9, 114
INVAR-54, Run: 064, F, 0, 0, 51, 17, 142, 15, 157
INVAR-54, Run: 065, F, 0, 0, 51, 8, 76, 6, 82
INVAR-54, Run: 066, F, 0, 0, 51, 6, 161, 4, 165
INVAR-54, Run: 067, F, 0, 0, 51, 3, 64, 1, 65
INVAR-54, Run: 068, F, 0, 0, 51, 47, 384, 45, 429
INVAR-54, Run: 069, F, 0, 0, 51, 23, 282, 21, 303
INVAR-54, Run: 070, F, 0, 0, 51, 70, 302, 68, 370
INVAR-54, Run: 071, F, 0, 0, 51, 4, 98, 2, 100
INVAR-54, Run: 072, F, 0, 0, 51, 3, 69, 1, 70
INVAR-54, Run: 073, F, 0, 0, 51, 29, 253, 27, 280
INVAR-54, Run: 074, F, 0, 0, 51, 48, 377, 46, 423
INVAR-54, Run: 075, F, 0, 0, 51, 2, 44, 0, 44
INVAR-54, Run: 076, F, 0, 0, 51, 10, 172, 8, 180
INVAR-54, Run: 077, F, 0, 0, 51, 3, 105, 1, 106
INVAR-54, Run: 078, F, 0, 0, 51, 3, 66, 1, 67
INVAR-54, Run: 079, F, 0, 0, 51, 5, 88, 3, 91
INVAR-54, Run: 080, F, 0, 0, 51, 4, 89, 2, 91
INVAR-54, Run: 081, F, 0, 0, 51, 2, 14, 0, 14
INVAR-54, Run: 082, F, 0, 0, 51, 3, 56, 1, 57
INVAR-54, Run: 083, F, 0, 0, 51, 2, 4, 0, 4
INVAR-54, Run: 084, F, 0, 0, 51, 4, 113, 2, 115
INVAR-54, Run: 085, F, 0, 0, 51, 55, 850, 53, 903
INVAR-54, Run: 086, F, 0, 0, 51, 19, 468, 17, 485
INVAR-54, Run: 087, F, 0, 0, 51, 4, 89, 2, 91
INVAR-54, Run: 088, F, 0, 0, 51, 30, 492, 28, 520
INVAR-54, Run: 089, F, 0, 0, 51, 2, 100, 0, 100
INVAR-54, Run: 090, F, 0, 0, 51, 55, 293, 53, 346
INVAR-54, Run: 091, F, 0, 0, 51, 73, 584, 71, 655
INVAR-54, Run: 092, F, 0, 0, 51, 64, 487, 62, 549
INVAR-54, Run: 093, F, 0, 0, 51, 13, 163, 11, 174
INVAR-54, Run: 094, F, 0, 0, 51, 12, 241, 10, 251
INVAR-54, Run: 095, F, 0, 0, 51, 19, 319, 17, 336
INVAR-54, Run: 096, F, 0, 0, 51, 5, 113, 3, 116
INVAR-54, Run: 097, F, 0, 0, 51, 3, 59, 1, 60
INVAR-54, Run: 098, F, 0, 0, 51, 6, 96, 4, 100
INVAR-54, Run: 099, F, 0, 0, 51, 212, 965, 210, 1175
INVAR-54, Run: 100, F, 0, 0, 51, 2, 213, 0, 213
INVAR-55, Run: 001, F, 0, 0, 99, 1163, 1710, 1133, 2843
INVAR-55, Run: 002, F, 0, 0, 99, 253, 2106, 223, 2329
INVAR-55, Run: 003, F, 0, 0, 99, 678, 1191, 648, 1839
INVAR-55, Run: 004, F, 0, 0, 99, 331, 917, 301, 1218
INVAR-55, Run: 005, F, 0, 0, 99, 483, 1940, 453, 2393
INVAR-55, Run: 006, F, 0, 99, 0, 528, 284, 597, 881
INVAR-55, Run: 007, F, 0, 99, 0, 1759, 1735, 1828, 3563
INVAR-55, Run: 008, F, 0, 0, 99, 492, 988, 462, 1450
INVAR-55, Run: 009, F, 0, 0, 99, 320, 2041, 290, 2331
INVAR-55, Run: 010, F, 0, 99, 0, 480, 357, 549, 906
INVAR-55, Run: 011, F, 0, 0, 99, 238, 1146, 208, 1354
INVAR-55, Run: 012, F, 0, 0, 99, 547, 1757, 517, 2274
INVAR-55, Run: 013, F, 0, 0, 99, 81, 347, 51, 398
INVAR-55, Run: 014, F, 0, 0, 99, 119, 624, 89, 713
INVAR-55, Run: 015, F, 0, 0, 99, 217, 1048, 187, 1235
INVAR-55, Run: 016, F, 0, 99, 0, 482, 234, 551, 785
INVAR-55, Run: 017, F, 0, 99, 0, 2834, 1430, 2903, 4333
INVAR-55, Run: 018, F, 0, 99, 0, 1476, 1178, 1545, 2723
INVAR-55, Run: 019, F, 0, 99, 0, 4350, 7931, 4419, 12350
INVAR-55, Run: 020, F, 0, 99, 0, 686, 286, 755, 1041
INVAR-55, Run: 021, F, 0, 0, 99, 552, 1968, 522, 2490
INVAR-55, Run: 022, F, 0, 0, 99, 270, 1309, 240, 1549
INVAR-55, Run: 023, F, 0, 0, 99, 862, 2036, 832, 2868
INVAR-55, Run: 024, F, 0, 0, 99, 1764, 4247, 1734, 5981
INVAR-55, Run: 025, F, 0, 0, 99, 152, 748, 122, 870
INVAR-55, Run: 026, F, 0, 0, 99, 816, 2663, 786, 3449
INVAR-55, Run: 027, F, 0, 99, 0, 399, 106, 468, 574
INVAR-55, Run: 028, F, 0, 0, 99, 1744, 3595, 1714, 5309
INVAR-55, Run: 029, F, 0, 0, 99, 179, 1513, 149, 1662
INVAR-55, Run: 030, F, 0, 0, 99, 1359, 4811, 1329, 6140
INVAR-55, Run: 031, F, 0, 0, 99, 385, 1114, 355, 1469
INVAR-55, Run: 032, F, 0, 0, 99, 147, 694, 117, 811
INVAR-55, Run: 033, F, 0, 99, 0, 1168, 655, 1237, 1892
INVAR-55, Run: 034, F, 0, 99, 0, 693, 432, 762, 1194
INVAR-55, Run: 035, F, 0, 99, 0, 823, 729, 892, 1621
INVAR-55, Run: 036, F, 0, 0, 99, 2100, 2834, 2070, 4904
INVAR-55, Run: 037, F, 0, 0, 99, 443, 1139, 413, 1552
INVAR-55, Run: 038, F, 0, 0, 99, 1244, 2442, 1214, 3656
INVAR-55, Run: 039, F, 0, 99, 0, 2911, 3987, 2980, 6967
INVAR-55, Run: 040, F, 0, 0, 99, 2415, 4127, 2385, 6512
INVAR-55, Run: 041, F, 0, 0, 99, 281, 1143, 251, 1394
INVAR-55, Run: 042, F, 0, 99, 0, 518, 607, 587, 1194
INVAR-55, Run: 043, F, 0, 0, 99, 537, 1062, 507, 1569
INVAR-55, Run: 044, F, 0, 0, 99, 780, 2075, 750, 2825
INVAR-55, Run: 045, F, 0, 99, 0, 1016, 531, 1085, 1616
INVAR-55, Run: 046, F, 0, 0, 99, 942, 1354, 912, 2266
INVAR-55, Run: 047, F, 0, 99, 0, 719, 233, 788, 1021
INVAR-55, Run: 048, F, 0, 0, 99, 367, 916, 337, 1253
INVAR-55, Run: 049, F, 0, 99, 0, 2464, 4214, 2533, 6747
INVAR-55, Run: 050, F, 0, 0, 99, 198, 1731, 168, 1899
INVAR-55, Run: 051, F, 0, 0, 99, 309, 857, 279, 1136
INVAR-55, Run: 052, F, 0, 0, 99, 940, 2902, 910, 3812
INVAR-55, Run: 053, F, 0, 0, 99, 516, 1483, 486, 1969
INVAR-55, Run: 054, F, 0, 99, 0, 1001, 730, 1070, 1800
INVAR-55, Run: 055, F, 0, 99, 0, 432, 198, 501, 699
INVAR-55, Run: 056, F, 0, 0, 99, 673, 1682, 643, 2325
INVAR-55, Run: 057, F, 0, 0, 99, 346, 2009, 316, 2325
INVAR-55, Run: 058, F, 0, 0, 99, 56, 339, 26, 365
INVAR-55, Run: 059, F, 0, 0, 99, 2445, 4084, 2415, 6499
INVAR-55, Run: 060, F, 0, 99, 0, 1702, 2285, 1771, 4056
INVAR-55, Run: 061, F, 0, 0, 99, 1122, 1401, 1092, 2493
INVAR-55, Run: 062, F, 0, 0, 99, 310, 1258, 280, 1538
INVAR-55, Run: 063, F, 0, 99, 0, 486, 242, 555, 797
INVAR-55, Run: 064, F, 0, 0, 99, 706, 1456, 676, 2132
INVAR-55, Run: 065, F, 0, 0, 99, 635, 3425, 605, 4030
INVAR-55, Run: 066, F, 0, 99, 0, 6087, 8192, 6156, 14348
INVAR-55, Run: 067, F, 0, 0, 99, 104, 953, 74, 1027
INVAR-55, Run: 068, F, 0, 0, 99, 1643, 4815, 1613, 6428
INVAR-55, Run: 069, F, 0, 0, 99, 297, 2654, 267, 2921
INVAR-55, Run: 070, F, 0, 0, 99, 295, 1025, 265, 1290
INVAR-55, Run: 071, F, 0, 99, 0, 360, 435, 429, 864
INVAR-55, Run: 072, F, 0, 0, 99, 2393, 4472, 2363, 6835
INVAR-55, Run: 073, F, 0, 0, 99, 205, 848, 175, 1023
INVAR-55, Run: 074, F, 0, 0, 99, 80, 436, 50, 486
INVAR-55, Run: 075, F, 0, 0, 99, 490, 1988, 460, 2448
INVAR-55, Run: 076, F, 0, 99, 0, 1155, 1692, 1224, 2916
INVAR-55, Run: 077, F, 0, 0, 99, 577, 1293, 547, 1840
INVAR-55, Run: 078, F, 0, 0, 99, 381, 1844, 351, 2195
INVAR-55, Run: 079, F, 0, 0, 99, 617, 1295, 587, 1882
INVAR-55, Run: 080, F, 0, 99, 0, 1151, 927, 1220, 2147
INVAR-55, Run: 081, F, 0, 0, 99, 510, 1461, 480, 1941
INVAR-55, Run: 082, F, 0, 0, 99, 138, 531, 108, 639
INVAR-55, Run: 083, F, 0, 99, 0, 2126, 1459, 2195, 3654
INVAR-55, Run: 084, F, 0, 99, 0, 2235, 2448, 2304, 4752
INVAR-55, Run: 085, F, 0, 99, 0, 253, 113, 322, 435
INVAR-55, Run: 086, F, 0, 99, 0, 1216, 2709, 1285, 3994
INVAR-55, Run: 087, F, 0, 0, 99, 75, 387, 45, 432
INVAR-55, Run: 088, F, 0, 0, 99, 192, 1155, 162, 1317
INVAR-55, Run: 089, F, 0, 0, 99, 201, 1147, 171, 1318
INVAR-55, Run: 090, F, 0, 99, 0, 367, 130, 436, 566
INVAR-55, Run: 091, F, 0, 0, 99, 330, 2016, 300, 2316
INVAR-55, Run: 092, F, 0, 0, 99, 352, 901, 322, 1223
INVAR-55, Run: 093, F, 0, 99, 0, 482, 165, 551, 716
INVAR-55, Run: 094, F, 0, 0, 99, 1153, 1878, 1123, 3001
INVAR-55, Run: 095, F, 0, 0, 99, 539, 1978, 509, 2487
INVAR-55, Run: 096, F, 0, 99, 0, 2142, 1644, 2211, 3855
INVAR-55, Run: 097, F, 0, 99, 0, 1617, 1734, 1686, 3420
INVAR-55, Run: 098, F, 0, 0, 99, 69, 252, 39, 291
INVAR-55, Run: 099, F, 0, 0, 99, 350, 936, 320, 1256
INVAR-55, Run: 100, F, 0, 0, 99, 1894, 1638, 1864, 3502
INVAR-56, Run: 001, F, 0, 0, 135, 56, 925, 54, 979
INVAR-56, Run: 002, F, 0, 0, 135, 4, 79, 2, 81
INVAR-56, Run: 003, F, 0, 0, 135, 2, 190, 0, 190
INVAR-56, Run: 004, F, 0, 0, 135, 2150, 4511, 2148, 6659
INVAR-56, Run: 005, F, 0, 0, 135, 3, 74, 1, 75
INVAR-56, Run: 006, F, 0, 0, 135, 5, 169, 3, 172
INVAR-56, Run: 007, F, 0, 0, 135, 2, 208, 0, 208
INVAR-56, Run: 008, F, 0, 0, 135, 6, 249, 4, 253
INVAR-56, Run: 009, F, 0, 0, 135, 2, 175, 0, 175
INVAR-56, Run: 010, F, 0, 0, 135, 2, 247, 0, 247
INVAR-56, Run: 011, F, 0, 0, 135, 9, 628, 7, 635
INVAR-56, Run: 012, F, 0, 0, 135, 46, 1117, 44, 1161
INVAR-56, Run: 013, F, 0, 0, 135, 3, 221, 1, 222
INVAR-56, Run: 014, F, 0, 0, 135, 4, 62, 2, 64
INVAR-56, Run: 015, F, 0, 0, 135, 45, 846, 43, 889
INVAR-56, Run: 016, F, 0, 0, 135, 6, 303, 4, 307
INVAR-56, Run: 017, F, 0, 0, 135, 13, 752, 11, 763
INVAR-56, Run: 018, F, 0, 0, 135, 22, 795, 20, 815
INVAR-56, Run: 019, F, 0, 0, 135, 2, 74, 0, 74
INVAR-56, Run: 020, F, 0, 0, 135, 2, 116, 0, 116
INVAR-56, Run: 021, F, 0, 0, 135, 4, 204, 2, 206
INVAR-56, Run: 022, F, 0, 0, 135, 10, 491, 8, 499
INVAR-56, Run: 023, F, 0, 0, 135, 2, 69, 0, 69
INVAR-56, Run: 024, F, 0, 0, 135, 2, 23, 0, 23
INVAR-56, Run: 025, F, 0, 0, 135, 2, 411, 0, 411
INVAR-56, Run: 026, F, 0, 0, 135, 32, 636, 30, 666
INVAR-56, Run: 027, F, 0, 0, 135, 89, 1640, 87, 1727
INVAR-56, Run: 028, F, 0, 0, 135, 12, 501, 10, 511
INVAR-56, Run: 029, F, 0, 0, 135, 2, 58, 0, 58
INVAR-56, Run: 030, F, 0, 0, 135, 2, 108, 0, 108
INVAR-56, Run: 031, F, 0, 0, 135, 2, 84, 0, 84
INVAR-56, Run: 032, F, 0, 0, 135, 44, 1230, 42, 1272
INVAR-56, Run: 033, F, 0, 0, 135, 4, 166, 2, 168
INVAR-56, Run: 034, F, 0, 0, 135, 11, 509, 9, 518
INVAR-56, Run: 035, F, 0, 0, 135, 16, 630, 14, 644
INVAR-56, Run: 036, F, 0, 0, 135, 3, 336, 1, 337
INVAR-56, Run: 037, F, 0, 0, 135, 312, 5586, 310, 5896
INVAR-56, Run: 038, F, 0, 0, 135, 2, 149, 0, 149
INVAR-56, Run: 039, F, 0, 0, 135, 11, 574, 9, 583
INVAR-56, Run: 040, F, 0, 0, 135, 11, 592, 9, 601
INVAR-56, Run: 041, F, 0, 0, 135, 15, 773, 13, 786
INVAR-56, Run: 042, F, 0, 0, 135, 8, 815, 6, 821
INVAR-56, Run: 043, F, 0, 0, 135, 4, 211, 2, 213
INVAR-56, Run: 044, F, 0, 0, 135, 63, 2075, 61, 2136
INVAR-56, Run: 045, F, 0, 0, 135, 2, 97, 0, 97
INVAR-56, Run: 046, F, 0, 0, 135, 18, 905, 16, 921
INVAR-56, Run: 047, F, 0, 0, 135, 6, 494, 4, 498
INVAR-56, Run: 048, F, 0, 0, 135, 2, 13, 0, 13
INVAR-56, Run: 049, F, 0, 0, 135, 45, 654, 43, 697
INVAR-56, Run: 050, F, 0, 0, 135, 562, 2592, 560, 3152
INVAR-56, Run: 051, F, 0, 0, 135, 5, 81, 3, 84
INVAR-56, Run: 052, F, 0, 0, 135, 23, 893, 21, 914
INVAR-56, Run: 053, F, 0, 0, 135, 31, 1262, 29, 1291
INVAR-56, Run: 054, F, 0, 0, 135, 31, 1115, 29, 1144
INVAR-56, Run: 055, F, 0, 0, 135, 2, 48, 0, 48
INVAR-56, Run: 056, F, 0, 0, 135, 14, 789, 12, 801
INVAR-56, Run: 057, F, 0, 0, 135, 3, 101, 1, 102
INVAR-56, Run: 058, F, 0, 135, 0, 1732, 3765, 1865, 5630
INVAR-56, Run: 059, F, 0, 0, 135, 11, 871, 9, 880
INVAR-56, Run: 060, F, 0, 0, 135, 2, 39, 0, 39
INVAR-56, Run: 061, F, 0, 0, 135, 2, 101, 0, 101
INVAR-56, Run: 062, F, 0, 0, 135, 94, 1959, 92, 2051
INVAR-56, Run: 063, F, 0, 135, 0, 1051, 1717, 1184, 2901
INVAR-56, Run: 064, F, 0, 0, 135, 3, 137, 1, 138
INVAR-56, Run: 065, F, 0, 0, 135, 3, 161, 1, 162
INVAR-56, Run: 066, F, 0, 0, 135, 311, 1944, 309, 2253
INVAR-56, Run: 067, F, 0, 0, 135, 5, 211, 3, 214
INVAR-56, Run: 068, F, 0, 0, 135, 2, 100, 0, 100
INVAR-56, Run: 069, F, 0, 0, 135, 16, 1060, 14, 1074
INVAR-56, Run: 070, F, 0, 0, 135, 31, 978, 29, 1007
INVAR-56, Run: 071, F, 0, 0, 135, 8, 414, 6, 420
INVAR-56, Run: 072, F, 0, 0, 135, 2, 69, 0, 69
INVAR-56, Run: 073, F, 0, 0, 135, 5, 907, 3, 910
INVAR-56, Run: 074, F, 0, 0, 135, 6, 431, 4, 435
INVAR-56, Run: 075, F, 0, 0, 135, 3, 348, 1, 349
INVAR-56, Run: 076, F, 0, 0, 135, 3, 187, 1, 188
INVAR-56, Run: 077, F, 0, 0, 135, 5, 275, 3, 278
INVAR-56, Run: 078, F, 0, 0, 135, 3, 140, 1, 141
INVAR-56, Run: 079, F, 0, 0, 135, 6, 297, 4, 301
INVAR-56, Run: 080, F, 0, 0, 135, 25, 765, 23, 788
INVAR-56, Run: 081, F, 0, 0, 135, 3, 213, 1, 214
INVAR-56, Run: 082, F, 0, 0, 135, 2, 107, 0, 107
INVAR-56, Run: 083, F, 0, 0, 135, 12, 564, 10, 574
INVAR-56, Run: 084, F, 0, 135, 0, 4322, 4926, 4455, 9381
INVAR-56, Run: 085, F, 0, 0, 135, 97, 1772, 95, 1867
INVAR-56, Run: 086, F, 0, 0, 135, 5, 218, 3, 221
INVAR-56, Run: 087, F, 0, 0, 135, 22, 604, 20, 624
INVAR-56, Run: 088, F, 0, 0, 135, 4, 189, 2, 191
INVAR-56, Run: 089, F, 0, 0, 135, 4, 343, 2, 345
INVAR-56, Run: 090, F, 0, 0, 135, 7, 582, 5, 587
INVAR-56, Run: 091, F, 0, 0, 135, 4, 295, 2, 297
INVAR-56, Run: 092, F, 0, 0, 135, 25, 668, 23, 691
INVAR-56, Run: 093, F, 0, 0, 135, 2, 23, 0, 23
INVAR-56, Run: 094, F, 0, 0, 135, 24, 689, 22, 711
INVAR-56, Run: 095, F, 0, 0, 135, 5, 196, 3, 199
INVAR-56, Run: 096, F, 0, 0, 135, 159, 2823, 157, 2980
INVAR-56, Run: 097, F, 0, 0, 135, 82, 2321, 80, 2401
INVAR-56, Run: 098, F, 0, 0, 135, 3, 148, 1, 149
INVAR-56, Run: 099, F, 0, 0, 135, 3, 407, 1, 408
INVAR-56, Run: 100, F, 0, 0, 135, 4, 359, 2, 361
INVAR-57, Run: 001, F, 0, 0, 36, 1, 23, 0, 23
INVAR-57, Run: 002, F, 0, 0, 36, 1, 26, 0, 26
INVAR-57, Run: 003, F, 0, 0, 36, 6, 121, 5, 126
INVAR-57, Run: 004, F, 0, 0, 36, 146, 186, 145, 331
INVAR-57, Run: 005, F, 0, 0, 36, 17, 161, 16, 177
INVAR-57, Run: 006, F, 0, 0, 36, 3, 40, 2, 42
INVAR-57, Run: 007, F, 0, 0, 36, 3, 34, 2, 36
INVAR-57, Run: 008, F, 0, 0, 36, 4, 58, 3, 61
INVAR-57, Run: 009, F, 0, 0, 36, 3, 80, 2, 82
INVAR-57, Run: 010, F, 0, 0, 36, 1, 2, 0, 2
INVAR-57, Run: 011, F, 0, 0, 36, 6, 119, 5, 124
INVAR-57, Run: 012, F, 0, 0, 36, 4, 82, 3, 85
INVAR-57, Run: 013, F, 0, 0, 36, 16, 98, 15, 113
INVAR-57, Run: 014, F, 0, 0, 36, 2, 23, 1, 24
INVAR-57, Run: 015, F, 0, 0, 36, 1, 26, 0, 26
INVAR-57, Run: 016, F, 0, 0, 36, 1, 11, 0, 11
INVAR-57, Run: 017, F, 0, 0, 36, 3, 48, 2, 50
INVAR-57, Run: 018, F, 0, 0, 36, 109, 455, 108, 563
INVAR-57, Run: 019, F, 0, 0, 36, 1, 4, 0, 4
INVAR-57, Run: 020, F, 0, 0, 36, 1, 2, 0, 2
INVAR-57, Run: 021, F, 0, 0, 36, 1, 35, 0, 35
INVAR-57, Run: 022, F, 0, 0, 36, 3, 78, 2, 80
INVAR-57, Run: 023, F, 0, 0, 36, 4, 108, 3, 111
INVAR-57, Run: 024, F, 0, 0, 36, 2, 90, 1, 91
INVAR-57, Run: 025, F, 0, 0, 36, 2, 108, 1, 109
INVAR-57, Run: 026, F, 0, 0, 36, 1, 26, 0, 26
INVAR-57, Run: 027, F, 0, 0, 36, 5, 125, 4, 129
INVAR-57, Run: 028, F, 0, 0, 36, 11, 98, 10, 108
INVAR-57, Run: 029, F, 0, 0, 36, 290, 721, 289, 1010
INVAR-57, Run: 030, F, 0, 0, 36, 19, 144, 18, 162
INVAR-57, Run: 031, F, 0, 0, 36, 1, 18, 0, 18
INVAR-57, Run: 032, F, 0, 0, 36, 1, 25, 0, 25
INVAR-57, Run: 033, F, 0, 0, 36, 14, 135, 13, 148
INVAR-57, Run: 034, F, 0, 0, 36, 6, 130, 5, 135
INVAR-57, Run: 035, F, 0, 0, 36, 4, 66, 3, 69
INVAR-57, Run: 036, F, 0, 0, 36, 1, 54, 0, 54
INVAR-57, Run: 037, F, 0, 0, 36, 1, 10, 0, 10
INVAR-57, Run: 038, F, 0, 0, 36, 8, 141, 7, 148
INVAR-57, Run: 039, F, 0, 0, 36, 2, 44, 1, 45
INVAR-57, Run: 040, F, 0, 0, 36, 1, 42, 0, 42
INVAR-57, Run: 041, F, 0, 0, 36, 8, 128, 7, 135
INVAR-57, Run: 042, F, 0, 0, 36, 338, 1012, 337, 1349
INVAR-57, Run: 043, F, 0, 0, 36, 22, 192, 21, 213
INVAR-57, Run: 044, F, 0, 0, 36, 1, 5, 0, 5
INVAR-57, Run: 045, F, 0, 0, 36, 23, 161, 22, 183
INVAR-57, Run: 046, F, 0, 0, 36, 1, 14, 0, 14
INVAR-57, Run: 047, F, 0, 0, 36, 3, 82, 2, 84
INVAR-57, Run: 048, F, 0, 36, 0, 121, 170, 156, 326
INVAR-57, Run: 049, F, 0, 0, 36, 1, 17, 0, 17
INVAR-57, Run: 050, F, 0, 0, 36, 28, 374, 27, 401
INVAR-57, Run: 051, F, 0, 0, 36, 1, 57, 0, 57
INVAR-57, Run: 052, F, 0, 0, 36, 1, 4, 0, 4
INVAR-57, Run: 053, F, 0, 0, 36, 1, 7, 0, 7
INVAR-57, Run: 054, F, 0, 0, 36, 2, 15, 1, 16
INVAR-57, Run: 055, F, 0, 0, 36, 27, 164, 26, 190
INVAR-57, Run: 056, F, 0, 0, 36, 1, 1, 0, 1
INVAR-57, Run: 057, F, 0, 0, 36, 6, 114, 5, 119
INVAR-57, Run: 058, F, 0, 0, 36, 1, 4, 0, 4
INVAR-57, Run: 059, F, 0, 0, 36, 1, 14, 0, 14
INVAR-57, Run: 060, F, 0, 0, 36, 1, 31, 0, 31
INVAR-57, Run: 061, F, 0, 0, 36, 14, 160, 13, 173
INVAR-57, Run: 062, F, 0, 0, 36, 224, 460, 223, 683
INVAR-57, Run: 063, F, 0, 0, 36, 4, 52, 3, 55
INVAR-57, Run: 064, F, 0, 0, 36, 1, 6, 0, 6
INVAR-57, Run: 065, F, 0, 0, 36, 4, 58, 3, 61
INVAR-57, Run: 066, F, 0, 0, 36, 1, 22, 0, 22
INVAR-57, Run: 067, F, 0, 0, 36, 2, 30, 1, 31
INVAR-57, Run: 068, F, 0, 0, 36, 2, 48, 1, 49
INVAR-57, Run: 069, F, 0, 0, 36, 4, 27, 3, 30
INVAR-57, Run: 070, F, 0, 0, 36, 1, 18, 0, 18
INVAR-57, Run: 071, F, 0, 0, 36, 1, 13, 0, 13
INVAR-57, Run: 072, F, 0, 0, 36, 1, 8, 0, 8
INVAR-57, Run: 073, F, 0, 0, 36, 3, 38, 2, 40
INVAR-57, Run: 074, F, 0, 0, 36, 1, 24, 0, 24
INVAR-57, Run: 075, F, 0, 0, 36, 1, 12, 0, 12
INVAR-57, Run: 076, F, 0, 0, 36, 5, 72, 4, 76
INVAR-57, Run: 077, F, 0, 0, 36, 143, 557, 142, 699
INVAR-57, Run: 078, F, 0, 0, 36, 1, 20, 0, 20
INVAR-57, Run: 079, F, 0, 0, 36, 222, 499, 221, 720
INVAR-57, Run: 080, F, 0, 0, 36, 1, 17, 0, 17
INVAR-57, Run: 081, F, 0, 0, 36, 1, 91, 0, 91
INVAR-57, Run: 082, F, 0, 0, 36, 1, 28, 0, 28
INVAR-57, Run: 083, F, 0, 0, 36, 1, 16, 0, 16
INVAR-57, Run: 084, F, 0, 0, 36, 1, 13, 0, 13
INVAR-57, Run: 085, F, 0, 0, 36, 1, 16, 0, 16
INVAR-57, Run: 086, F, 0, 0, 36, 53, 273, 52, 325
INVAR-57, Run: 087, F, 0, 0, 36, 1, 10, 0, 10
INVAR-57, Run: 088, F, 0, 0, 36, 5, 116, 4, 120
INVAR-57, Run: 089, F, 0, 0, 36, 1, 12, 0, 12
INVAR-57, Run: 090, F, 0, 0, 36, 2, 40, 1, 41
INVAR-57, Run: 091, F, 0, 0, 36, 1, 8, 0, 8
INVAR-57, Run: 092, F, 0, 0, 36, 1, 5, 0, 5
INVAR-57, Run: 093, F, 0, 0, 36, 4, 166, 3, 169
INVAR-57, Run: 094, F, 0, 0, 36, 3, 36, 2, 38
INVAR-57, Run: 095, F, 0, 0, 36, 3, 97, 2, 99
INVAR-57, Run: 096, F, 0, 0, 36, 7, 54, 6, 60
INVAR-57, Run: 097, F, 0, 0, 36, 13, 134, 12, 146
INVAR-57, Run: 098, F, 0, 0, 36, 1, 33, 0, 33
INVAR-57, Run: 099, F, 0, 36, 0, 260, 235, 295, 530
INVAR-57, Run: 100, F, 0, 0, 36, 1, 16, 0, 16
INVAR-58, Run: 001, F, 0, 0, 70, 9, 158, 6, 164
INVAR-58, Run: 002, F, 0, 0, 70, 3, 63, 0, 63
INVAR-58, Run: 003, F, 0, 0, 70, 41, 697, 38, 735
INVAR-58, Run: 004, F, 0, 0, 70, 31, 780, 28, 808
INVAR-58, Run: 005, F, 0, 0, 70, 3, 41, 0, 41
INVAR-58, Run: 006, F, 0, 0, 70, 28, 215, 25, 240
INVAR-58, Run: 007, F, 0, 0, 70, 5, 184, 2, 186
INVAR-58, Run: 008, F, 0, 0, 70, 36, 245, 33, 278
INVAR-58, Run: 009, F, 0, 0, 70, 4, 59, 1, 60
INVAR-58, Run: 010, F, 0, 0, 70, 6, 52, 3, 55
INVAR-58, Run: 011, F, 0, 0, 70, 425, 2794, 422, 3216
INVAR-58, Run: 012, F, 0, 70, 0, 1129, 782, 1196, 1978
INVAR-58, Run: 013, F, 0, 0, 70, 24, 293, 21, 314
INVAR-58, Run: 014, F, 0, 0, 70, 556, 3750, 553, 4303
INVAR-58, Run: 015, F, 0, 0, 70, 5, 157, 2, 159
INVAR-58, Run: 016, F, 0, 0, 70, 161, 1247, 158, 1405
INVAR-58, Run: 017, F, 0, 0, 70, 5, 165, 2, 167
INVAR-58, Run: 018, F, 0, 0, 70, 17, 326, 14, 340
INVAR-58, Run: 019, F, 0, 0, 70, 3, 128, 0, 128
INVAR-58, Run: 020, F, 0, 0, 70, 4, 224, 1, 225
INVAR-58, Run: 021, F, 0, 0, 70, 72, 870, 69, 939
INVAR-58, Run: 022, F, 0, 0, 70, 144, 1472, 141, 1613
INVAR-58, Run: 023, F, 0, 70, 0, 996, 2688, 1063, 3751
INVAR-58, Run: 024, F, 0, 0, 70, 61, 889, 58, 947
INVAR-58, Run: 025, F, 0, 0, 70, 113, 957, 110, 1067
INVAR-58, Run: 026, F, 0, 0, 70, 50, 575, 47, 622
INVAR-58, Run: 027, F, 0, 0, 70, 239, 1440, 236, 1676
INVAR-58, Run: 028, F, 0, 0, 70, 5, 24, 2, 26
INVAR-58, Run: 029, F, 0, 0, 70, 829, 2018, 826, 2844
INVAR-58, Run: 030, F, 0, 0, 70, 134, 1048, 131, 1179
INVAR-58, Run: 031, F, 0, 0, 70, 14, 422, 11, 433
INVAR-58, Run: 032, F, 0, 0, 70, 20, 534, 17, 551
INVAR-58, Run: 033, F, 0, 0, 70, 4, 71, 1, 72
INVAR-58, Run: 034, F, 0, 0, 70, 4, 76, 1, 77
INVAR-58, Run: 035, F, 0, 0, 70, 44, 410, 41, 451
INVAR-58, Run: 036, F, 0, 0, 70, 7, 96, 4, 100
INVAR-58, Run: 037, F, 0, 0, 70, 5, 163, 2, 165
INVAR-58, Run: 038, F, 0, 0, 70, 9, 341, 6, 347
INVAR-58, Run: 039, F, 0, 0, 70, 5, 94, 2, 96
INVAR-58, Run: 040, F, 0, 70, 0, 1248, 1243, 1315, 2558
INVAR-58, Run: 041, F, 0, 0, 70, 7, 159, 4, 163
INVAR-58, Run: 042, F, 0, 0, 70, 19, 401, 16, 417
INVAR-58, Run: 043, F, 0, 0, 70, 40, 517, 37, 554
INVAR-58, Run: 044, F, 0, 0, 70, 8, 278, 5, 283
INVAR-58, Run: 045, F, 0, 0, 70, 40, 733, 37, 770
INVAR-58, Run: 046, F, 0, 0, 70, 35, 513, 32, 545
INVAR-58, Run: 047, F, 0, 0, 70, 15, 271, 12, 283
INVAR-58, Run: 048, F, 0, 0, 70, 17, 299, 14, 313
INVAR-58, Run: 049, F, 0, 0, 70, 5, 101, 2, 103
INVAR-58, Run: 050, F, 0, 0, 70, 15, 499, 12, 511
INVAR-58, Run: 051, F, 0, 0, 70, 29, 392, 26, 418
INVAR-58, Run: 052, F, 0, 0, 70, 461, 2512, 458, 2970
INVAR-58, Run: 053, F, 0, 0, 70, 19, 562, 16, 578
INVAR-58, Run: 054, F, 0, 0, 70, 3, 33, 0, 33
INVAR-58, Run: 055, F, 0, 0, 70, 4, 61, 1, 62
INVAR-58, Run: 056, F, 0, 0, 70, 5, 67, 2, 69
INVAR-58, Run: 057, F, 0, 0, 70, 4, 57, 1, 58
INVAR-58, Run: 058, F, 0, 0, 70, 39, 652, 36, 688
INVAR-58, Run: 059, F, 0, 0, 70, 99, 1091, 96, 1187
INVAR-58, Run: 060, F, 0, 0, 70, 3, 32, 0, 32
INVAR-58, Run: 061, F, 0, 0, 70, 21, 192, 18, 210
INVAR-58, Run: 062, F, 0, 0, 70, 5, 213, 2, 215
INVAR-58, Run: 063, F, 0, 0, 70, 171, 1007, 168, 1175
INVAR-58, Run: 064, F, 0, 0, 70, 219, 2186, 216, 2402
INVAR-58, Run: 065, F, 0, 0, 70, 6, 96, 3, 99
INVAR-58, Run: 066, F, 0, 0, 70, 45, 952, 42, 994
INVAR-58, Run: 067, F, 0, 0, 70, 5, 76, 2, 78
INVAR-58, Run: 068, F, 0, 0, 70, 232, 930, 229, 1159
INVAR-58, Run: 069, F, 0, 0, 70, 10, 240, 7, 247
INVAR-58, Run: 070, F, 0, 0, 70, 24, 545, 21, 566
INVAR-58, Run: 071, F, 0, 0, 70, 16, 191, 13, 204
INVAR-58, Run: 072, F, 0, 0, 70, 270, 1015, 267, 1282
INVAR-58, Run: 073, F, 0, 0, 70, 83, 1042, 80, 1122
INVAR-58, Run: 074, F, 0, 0, 70, 3, 10, 0, 10
INVAR-58, Run: 075, F, 0, 0, 70, 850, 1162, 847, 2009
INVAR-58, Run: 076, F, 0, 0, 70, 46, 475, 43, 518
INVAR-58, Run: 077, F, 0, 0, 70, 5, 119, 2, 121
INVAR-58, Run: 078, F, 0, 0, 70, 5, 80, 2, 82
INVAR-58, Run: 079, F, 0, 0, 70, 19, 481, 16, 497
INVAR-58, Run: 080, F, 0, 0, 70, 34, 498, 31, 529
INVAR-58, Run: 081, F, 0, 0, 70, 11, 224, 8, 232
INVAR-58, Run: 082, F, 0, 0, 70, 14, 243, 11, 254
INVAR-58, Run: 083, F, 0, 0, 70, 3, 136, 0, 136
INVAR-58, Run: 084, F, 0, 0, 70, 1032, 1674, 1029, 2703
INVAR-58, Run: 085, F, 0, 0, 70, 10, 227, 7, 234
INVAR-58, Run: 086, F, 0, 0, 70, 27, 692, 24, 716
INVAR-58, Run: 087, F, 0, 0, 70, 4, 124, 1, 125
INVAR-58, Run: 088, F, 0, 0, 70, 9, 169, 6, 175
INVAR-58, Run: 089, F, 0, 0, 70, 9, 168, 6, 174
INVAR-58, Run: 090, F, 0, 0, 70, 12, 224, 9, 233
INVAR-58, Run: 091, F, 0, 0, 70, 6, 78, 3, 81
INVAR-58, Run: 092, F, 0, 0, 70, 30, 368, 27, 395
INVAR-58, Run: 093, F, 0, 0, 70, 8, 62, 5, 67
INVAR-58, Run: 094, F, 0, 0, 70, 20, 485, 17, 502
INVAR-58, Run: 095, F, 0, 0, 70, 3, 15, 0, 15
INVAR-58, Run: 096, F, 0, 70, 0, 4461, 5440, 4528, 9968
INVAR-58, Run: 097, F, 0, 0, 70, 4, 26, 1, 27
INVAR-58, Run: 098, F, 0, 0, 70, 8, 381, 5, 386
INVAR-58, Run: 099, F, 0, 0, 70, 6, 87, 3, 90
INVAR-58, Run: 100, F, 0, 0, 70, 14, 317, 11, 328
INVAR-59, Run: 001, F, 0, 0, 204, 3198, 9285, 3143, 12428
INVAR-59, Run: 002, F, 0, 0, 204, 2375, 8433, 2320, 10753
INVAR-59, Run: 003, F, 0, 0, 204, 3332, 10430, 3277, 13707
INVAR-59, Run: 004, F, 0, 0, 204, 5478, 13016, 5423, 18439
INVAR-59, Run: 005, F, 0, 0, 204, 895, 7833, 840, 8673
INVAR-59, Run: 006, F, 0, 204, 0, 8283, 8735, 8432, 17167
INVAR-59, Run: 007, F, 0, 0, 204, 415, 2964, 360, 3324
INVAR-59, Run: 008, F, 0, 0, 204, 2619, 14594, 2564, 17158
INVAR-59, Run: 009, F, 0, 0, 204, 3451, 9495, 3396, 12891
INVAR-59, Run: 010, F, 0, 204, 0, 9044, 12514, 9193, 21707
INVAR-59, Run: 011, F, 0, 0, 204, 1956, 5861, 1901, 7762
INVAR-59, Run: 012, F, 0, 0, 204, 5827, 19316, 5772, 25088
INVAR-59, Run: 013, F, 0, 204, 0, 5998, 5102, 6147, 11249
INVAR-59, Run: 014, F, 0, 204, 0, 3196, 4139, 3345, 7484
INVAR-59, Run: 015, F, 0, 0, 204, 899, 3769, 844, 4613
INVAR-59, Run: 016, F, 0, 204, 0, 3375, 3057, 3524, 6581
INVAR-59, Run: 017, F, 0, 0, 204, 12385, 28832, 12330, 41162
INVAR-59, Run: 018, F, 0, 204, 0, 6314, 5315, 6463, 11778
INVAR-59, Run: 019, F, 0, 0, 204, 5045, 8253, 4990, 13243
INVAR-59, Run: 020, F, 0, 0, 204, 951, 3187, 896, 4083
INVAR-59, Run: 021, F, 0, 0, 204, 203, 1962, 148, 2110
INVAR-59, Run: 022, F, 0, 204, 0, 4793, 5163, 4942, 10105
INVAR-59, Run: 023, F, 0, 0, 204, 574, 3697, 519, 4216
INVAR-59, Run: 024, F, 0, 0, 204, 1002, 4737, 947, 5684
INVAR-59, Run: 025, F, 0, 204, 0, 8084, 11988, 8233, 20221
INVAR-59, Run: 026, F, 0, 0, 204, 1996, 15215, 1941, 17156
INVAR-59, Run: 027, F, 0, 204, 0, 2458, 2042, 2607, 4649
INVAR-59, Run: 028, F, 0, 204, 0, 6528, 4605, 6677, 11282
INVAR-59, Run: 029, F, 0, 0, 204, 5893, 12445, 5838, 18283
INVAR-59, Run: 030, F, 0, 0, 204, 1214, 4369, 1159, 5528
INVAR-59, Run: 031, F, 0, 0, 204, 12781, 17330, 12726, 30056
INVAR-59, Run: 032, F, 0, 0, 204, 689, 6833, 634, 7467
INVAR-59, Run: 033, F, 0, 204, 0, 2999, 2278, 3148, 5426
INVAR-59, Run: 034, F, 0, 0, 204, 803, 5225, 748, 5973
INVAR-59, Run: 035, F, 0, 204, 0, 11623, 8644, 11772, 20416
INVAR-59, Run: 036, F, 0, 204, 0, 2799, 3153, 2948, 6101
INVAR-59, Run: 037, F, 0, 0, 204, 5423, 12465, 5368, 17833
INVAR-59, Run: 038, F, 0, 0, 204, 506, 6001, 451, 6452
INVAR-59, Run: 039, F, 0, 204, 0, 7419, 5909, 7568, 13477
INVAR-59, Run: 040, F, 0, 0, 204, 2160, 6161, 2105, 8266
INVAR-59, Run: 041, F, 0, 0, 204, 15758, 26328, 15703, 42031
INVAR-59, Run: 042, F, 0, 0, 204, 8537, 18945, 8482, 27427
INVAR-59, Run: 043, F, 0, 0, 204, 1588, 3970, 1533, 5503
INVAR-59, Run: 044, F, 0, 0, 204, 411, 4156, 356, 4512
INVAR-59, Run: 045, F, 0, 204, 0, 14908, 24383, 15057, 39440
INVAR-59, Run: 046, F, 0, 204, 0, 10865, 11280, 11014, 22294
INVAR-59, Run: 047, F, 0, 204, 0, 5874, 5797, 6023, 11820
INVAR-59, Run: 048, F, 0, 0, 204, 815, 5502, 760, 6262
INVAR-59, Run: 049, F, 0, 204, 0, 6900, 6023, 7049, 13072
INVAR-59, Run: 050, F, 0, 204, 0, 5639, 3949, 5788, 9737
INVAR-59, Run: 051, F, 0, 0, 204, 2049, 7921, 1994, 9915
INVAR-59, Run: 052, F, 0, 204, 0, 10405, 3674, 10554, 14228
INVAR-59, Run: 053, F, 0, 204, 0, 7120, 6855, 7269, 14124
INVAR-59, Run: 054, F, 0, 0, 204, 2459, 12899, 2404, 15303
INVAR-59, Run: 055, F, 0, 0, 204, 796, 3189, 741, 3930
INVAR-59, Run: 056, F, 0, 204, 0, 2476, 3110, 2625, 5735
INVAR-59, Run: 057, F, 0, 204, 0, 6725, 4543, 6874, 11417
INVAR-59, Run: 058, F, 0, 0, 204, 8161, 11978, 8106, 20084
INVAR-59, Run: 059, F, 0, 204, 0, 4645, 7900, 4794, 12694
INVAR-59, Run: 060, F, 0, 204, 0, 8142, 6831, 8291, 15122
INVAR-59, Run: 061, F, 0, 0, 204, 6280, 9774, 6225, 15999
INVAR-59, Run: 062, F, 0, 0, 204, 410, 4520, 355, 4875
INVAR-59, Run: 063, F, 0, 0, 204, 2481, 21736, 2426, 24162
INVAR-59, Run: 064, F, 0, 0, 204, 343, 3102, 288, 3390
INVAR-59, Run: 065, F, 0, 204, 0, 4656, 2580, 4805, 7385
INVAR-59, Run: 066, F, 0, 0, 204, 4875, 15156, 4820, 19976
INVAR-59, Run: 067, F, 0, 0, 204, 7042, 18369, 6987, 25356
INVAR-59, Run: 068, F, 0, 0, 204, 814, 8590, 759, 9349
INVAR-59, Run: 069, F, 0, 0, 204, 4938, 18183, 4883, 23066
INVAR-59, Run: 070, F, 0, 204, 0, 5739, 6508, 5888, 12396
INVAR-59, Run: 071, F, 0, 0, 204, 10713, 18800, 10658, 29458
INVAR-59, Run: 072, F, 0, 0, 204, 2065, 9340, 2010, 11350
INVAR-59, Run: 073, F, 0, 0, 204, 886, 7893, 831, 8724
INVAR-59, Run: 074, F, 0, 204, 0, 3816, 2487, 3965, 6452
INVAR-59, Run: 075, F, 0, 0, 204, 392, 2967, 337, 3304
INVAR-59, Run: 076, F, 0, 0, 204, 1508, 6486, 1453, 7939
INVAR-59, Run: 077, F, 0, 204, 0, 11708, 26525, 11857, 38382
INVAR-59, Run: 078, F, 0, 0, 204, 508, 3433, 453, 3886
INVAR-59, Run: 079, F, 0, 0, 204, 970, 3419, 915, 4334
INVAR-59, Run: 080, F, 0, 0, 204, 2555, 6166, 2500, 8666
INVAR-59, Run: 081, F, 0, 0, 204, 1160, 6509, 1105, 7614
INVAR-59, Run: 082, F, 0, 0, 204, 1153, 3816, 1098, 4914
INVAR-59, Run: 083, F, 0, 0, 204, 5112, 8286, 5057, 13343
INVAR-59, Run: 084, F, 0, 0, 204, 427, 5767, 372, 6139
INVAR-59, Run: 085, F, 0, 0, 204, 3724, 10270, 3669, 13939
INVAR-59, Run: 086, F, 0, 0, 204, 423, 2005, 368, 2373
INVAR-59, Run: 087, F, 0, 0, 204, 3330, 9866, 3275, 13141
INVAR-59, Run: 088, F, 0, 0, 204, 809, 4938, 754, 5692
INVAR-59, Run: 089, F, 0, 0, 204, 633, 4172, 578, 4750
INVAR-59, Run: 090, F, 0, 204, 0, 2807, 3369, 2956, 6325
INVAR-59, Run: 091, F, 0, 0, 204, 1262, 5967, 1207, 7174
INVAR-59, Run: 092, F, 0, 204, 0, 6419, 4138, 6568, 10706
INVAR-59, Run: 093, F, 0, 0, 204, 4231, 15590, 4176, 19766
INVAR-59, Run: 094, F, 0, 0, 204, 1695, 6652, 1640, 8292
INVAR-59, Run: 095, F, 0, 0, 204, 5536, 12494, 5481, 17975
INVAR-59, Run: 096, F, 0, 204, 0, 3927, 5361, 4076, 9437
INVAR-59, Run: 097, F, 0, 0, 204, 6543, 15178, 6488, 21666
INVAR-59, Run: 098, F, 0, 0, 204, 7920, 8796, 7865, 16661
INVAR-59, Run: 099, F, 0, 204, 0, 6905, 8814, 7054, 15868
INVAR-59, Run: 100, F, 0, 0, 204, 566, 3823, 511, 4334
INVAR-6, Run: 001, P, 0, 0, 12, 0, 0, 0, 0
INVAR-6, Run: 002, P, 0, 0, 12, 0, 0, 0, 0
INVAR-6, Run: 003, P, 0, 0, 12, 0, 0, 0, 0
INVAR-6, Run: 004, P, 0, 0, 12, 0, 0, 0, 0
INVAR-6, Run: 005, P, 0, 0, 12, 0, 0, 0, 0
INVAR-6, Run: 006, P, 0, 0, 12, 0, 0, 0, 0
INVAR-6, Run: 007, P, 0, 0, 12, 0, 0, 0, 0
INVAR-6, Run: 008, P, 0, 0, 12, 0, 0, 0, 0
INVAR-6, Run: 009, P, 0, 0, 12, 0, 0, 0, 0
INVAR-6, Run: 010, P, 0, 0, 12, 0, 0, 0, 0
INVAR-6, Run: 011, P, 0, 0, 12, 0, 0, 0, 0
INVAR-6, Run: 012, P, 0, 0, 12, 0, 0, 0, 0
INVAR-6, Run: 013, P, 0, 0, 12, 0, 0, 0, 0
INVAR-6, Run: 014, P, 0, 0, 12, 0, 0, 0, 0
INVAR-6, Run: 015, P, 0, 0, 12, 0, 0, 0, 0
INVAR-6, Run: 016, P, 0, 0, 12, 0, 0, 0, 0
INVAR-6, Run: 017, P, 0, 0, 12, 0, 0, 0, 0
INVAR-6, Run: 018, P, 0, 0, 12, 0, 0, 0, 0
INVAR-6, Run: 019, P, 0, 0, 12, 0, 0, 0, 0
INVAR-6, Run: 020, P, 0, 0, 12, 0, 0, 0, 0
INVAR-6, Run: 021, P, 0, 0, 12, 0, 0, 0, 0
INVAR-6, Run: 022, P, 0, 0, 12, 0, 0, 0, 0
INVAR-6, Run: 023, P, 0, 0, 12, 0, 0, 0, 0
INVAR-6, Run: 024, P, 0, 0, 12, 0, 0, 0, 0
INVAR-6, Run: 025, P, 0, 0, 12, 0, 0, 0, 0
INVAR-6, Run: 026, P, 0, 0, 12, 0, 0, 0, 0
INVAR-6, Run: 027, P, 0, 0, 12, 0, 0, 0, 0
INVAR-6, Run: 028, P, 0, 0, 12, 0, 0, 0, 0
INVAR-6, Run: 029, P, 0, 0, 12, 0, 0, 0, 0
INVAR-6, Run: 030, P, 0, 0, 12, 0, 0, 0, 0
INVAR-6, Run: 031, P, 0, 0, 12, 0, 0, 0, 0
INVAR-6, Run: 032, P, 0, 0, 12, 0, 0, 0, 0
INVAR-6, Run: 033, P, 0, 0, 12, 0, 0, 0, 0
INVAR-6, Run: 034, P, 0, 0, 12, 0, 0, 0, 0
INVAR-6, Run: 035, P, 0, 0, 12, 0, 0, 0, 0
INVAR-6, Run: 036, P, 0, 0, 12, 0, 0, 0, 0
INVAR-6, Run: 037, P, 0, 0, 12, 0, 0, 0, 0
INVAR-6, Run: 038, P, 0, 0, 12, 0, 0, 0, 0
INVAR-6, Run: 039, P, 0, 0, 12, 0, 0, 0, 0
INVAR-6, Run: 040, P, 0, 0, 12, 0, 0, 0, 0
INVAR-6, Run: 041, P, 0, 0, 12, 0, 0, 0, 0
INVAR-6, Run: 042, P, 0, 0, 12, 0, 0, 0, 0
INVAR-6, Run: 043, P, 0, 0, 12, 0, 0, 0, 0
INVAR-6, Run: 044, P, 0, 0, 12, 0, 0, 0, 0
INVAR-6, Run: 045, P, 0, 0, 12, 0, 0, 0, 0
INVAR-6, Run: 046, P, 0, 0, 12, 0, 0, 0, 0
INVAR-6, Run: 047, P, 0, 0, 12, 0, 0, 0, 0
INVAR-6, Run: 048, P, 0, 0, 12, 0, 0, 0, 0
INVAR-6, Run: 049, P, 0, 0, 12, 0, 0, 0, 0
INVAR-6, Run: 050, P, 0, 0, 12, 0, 0, 0, 0
INVAR-6, Run: 051, P, 0, 0, 12, 0, 0, 0, 0
INVAR-6, Run: 052, P, 0, 0, 12, 0, 0, 0, 0
INVAR-6, Run: 053, P, 0, 0, 12, 0, 0, 0, 0
INVAR-6, Run: 054, P, 0, 0, 12, 0, 0, 0, 0
INVAR-6, Run: 055, P, 0, 0, 12, 0, 0, 0, 0
INVAR-6, Run: 056, P, 0, 0, 12, 0, 0, 0, 0
INVAR-6, Run: 057, P, 0, 0, 12, 0, 0, 0, 0
INVAR-6, Run: 058, P, 0, 0, 12, 0, 0, 0, 0
INVAR-6, Run: 059, P, 0, 0, 12, 0, 0, 0, 0
INVAR-6, Run: 060, P, 0, 0, 12, 0, 0, 0, 0
INVAR-6, Run: 061, P, 0, 0, 12, 0, 0, 0, 0
INVAR-6, Run: 062, P, 0, 0, 12, 0, 0, 0, 0
INVAR-6, Run: 063, P, 0, 0, 12, 0, 0, 0, 0
INVAR-6, Run: 064, P, 0, 0, 12, 0, 0, 0, 0
INVAR-6, Run: 065, P, 0, 0, 12, 0, 0, 0, 0
INVAR-6, Run: 066, P, 0, 0, 12, 0, 0, 0, 0
INVAR-6, Run: 067, P, 0, 0, 12, 0, 0, 0, 0
INVAR-6, Run: 068, P, 0, 0, 12, 0, 0, 0, 0
INVAR-6, Run: 069, P, 0, 0, 12, 0, 0, 0, 0
INVAR-6, Run: 070, P, 0, 0, 12, 0, 0, 0, 0
INVAR-6, Run: 071, P, 0, 0, 12, 0, 0, 0, 0
INVAR-6, Run: 072, P, 0, 0, 12, 0, 0, 0, 0
INVAR-6, Run: 073, P, 0, 0, 12, 0, 0, 0, 0
INVAR-6, Run: 074, P, 0, 0, 12, 0, 0, 0, 0
INVAR-6, Run: 075, P, 0, 0, 12, 0, 0, 0, 0
INVAR-6, Run: 076, P, 0, 0, 12, 0, 0, 0, 0
INVAR-6, Run: 077, P, 0, 0, 12, 0, 0, 0, 0
INVAR-6, Run: 078, P, 0, 0, 12, 0, 0, 0, 0
INVAR-6, Run: 079, P, 0, 0, 12, 0, 0, 0, 0
INVAR-6, Run: 080, P, 0, 0, 12, 0, 0, 0, 0
INVAR-6, Run: 081, P, 0, 0, 12, 0, 0, 0, 0
INVAR-6, Run: 082, P, 0, 0, 12, 0, 0, 0, 0
INVAR-6, Run: 083, P, 0, 0, 12, 0, 0, 0, 0
INVAR-6, Run: 084, P, 0, 0, 12, 0, 0, 0, 0
INVAR-6, Run: 085, P, 0, 0, 12, 0, 0, 0, 0
INVAR-6, Run: 086, P, 0, 0, 12, 0, 0, 0, 0
INVAR-6, Run: 087, P, 0, 0, 12, 0, 0, 0, 0
INVAR-6, Run: 088, P, 0, 0, 12, 0, 0, 0, 0
INVAR-6, Run: 089, P, 0, 0, 12, 0, 0, 0, 0
INVAR-6, Run: 090, P, 0, 0, 12, 0, 0, 0, 0
INVAR-6, Run: 091, P, 0, 0, 12, 0, 0, 0, 0
INVAR-6, Run: 092, P, 0, 0, 12, 0, 0, 0, 0
INVAR-6, Run: 093, P, 0, 0, 12, 0, 0, 0, 0
INVAR-6, Run: 094, P, 0, 0, 12, 0, 0, 0, 0
INVAR-6, Run: 095, P, 0, 0, 12, 0, 0, 0, 0
INVAR-6, Run: 096, P, 0, 0, 12, 0, 0, 0, 0
INVAR-6, Run: 097, P, 0, 0, 12, 0, 0, 0, 0
INVAR-6, Run: 098, P, 0, 0, 12, 0, 0, 0, 0
INVAR-6, Run: 099, P, 0, 0, 12, 0, 0, 0, 0
INVAR-6, Run: 100, P, 0, 0, 12, 0, 0, 0, 0
INVAR-60, Run: 001, F, 0, 0, 79, 407, 1294, 375, 1669
INVAR-60, Run: 002, F, 0, 79, 0, 432, 352, 479, 831
INVAR-60, Run: 003, F, 0, 79, 0, 469, 180, 516, 696
INVAR-60, Run: 004, F, 0, 79, 0, 484, 303, 531, 834
INVAR-60, Run: 005, F, 0, 0, 79, 571, 1275, 539, 1814
INVAR-60, Run: 006, F, 0, 0, 79, 465, 1071, 433, 1504
INVAR-60, Run: 007, F, 0, 79, 0, 1554, 775, 1601, 2376
INVAR-60, Run: 008, F, 0, 0, 79, 662, 2075, 630, 2705
INVAR-60, Run: 009, F, 0, 0, 79, 1139, 1689, 1107, 2796
INVAR-60, Run: 010, F, 0, 79, 0, 191, 51, 238, 289
INVAR-60, Run: 011, F, 0, 0, 79, 427, 1174, 395, 1569
INVAR-60, Run: 012, F, 0, 79, 0, 651, 662, 698, 1360
INVAR-60, Run: 013, F, 0, 0, 79, 286, 1238, 254, 1492
INVAR-60, Run: 014, F, 0, 79, 0, 801, 867, 848, 1715
INVAR-60, Run: 015, F, 0, 0, 79, 174, 807, 142, 949
INVAR-60, Run: 016, F, 0, 0, 79, 328, 583, 296, 879
INVAR-60, Run: 017, F, 0, 79, 0, 288, 135, 335, 470
INVAR-60, Run: 018, F, 0, 79, 0, 1254, 2053, 1301, 3354
INVAR-60, Run: 019, F, 0, 0, 79, 263, 614, 231, 845
INVAR-60, Run: 020, F, 0, 0, 79, 793, 2025, 761, 2786
INVAR-60, Run: 021, F, 0, 0, 79, 260, 932, 228, 1160
INVAR-60, Run: 022, F, 0, 0, 79, 169, 975, 137, 1112
INVAR-60, Run: 023, F, 0, 79, 0, 554, 434, 601, 1035
INVAR-60, Run: 024, F, 0, 79, 0, 518, 203, 565, 768
INVAR-60, Run: 025, F, 0, 0, 79, 1423, 4218, 1391, 5609
INVAR-60, Run: 026, F, 0, 0, 79, 773, 1272, 741, 2013
INVAR-60, Run: 027, F, 0, 79, 0, 522, 131, 569, 700
INVAR-60, Run: 028, F, 0, 0, 79, 613, 1755, 581, 2336
INVAR-60, Run: 029, F, 0, 0, 79, 1752, 4700, 1720, 6420
INVAR-60, Run: 030, F, 0, 0, 79, 652, 1862, 620, 2482
INVAR-60, Run: 031, F, 0, 0, 79, 789, 1412, 757, 2169
INVAR-60, Run: 032, F, 0, 0, 79, 700, 1591, 668, 2259
INVAR-60, Run: 033, F, 0, 0, 79, 875, 1837, 843, 2680
INVAR-60, Run: 034, F, 0, 79, 0, 366, 206, 413, 619
INVAR-60, Run: 035, F, 0, 79, 0, 1140, 1516, 1187, 2703
INVAR-60, Run: 036, F, 0, 79, 0, 1871, 1511, 1918, 3429
INVAR-60, Run: 037, F, 0, 0, 79, 197, 650, 165, 815
INVAR-60, Run: 038, F, 0, 0, 79, 298, 880, 266, 1146
INVAR-60, Run: 039, F, 0, 0, 79, 1247, 1601, 1215, 2816
INVAR-60, Run: 040, F, 0, 0, 79, 300, 1614, 268, 1882
INVAR-60, Run: 041, F, 0, 0, 79, 592, 1521, 560, 2081
INVAR-60, Run: 042, F, 0, 79, 0, 494, 366, 541, 907
INVAR-60, Run: 043, F, 0, 79, 0, 705, 388, 752, 1140
INVAR-60, Run: 044, F, 0, 0, 79, 555, 1976, 523, 2499
INVAR-60, Run: 045, F, 0, 0, 79, 155, 422, 123, 545
INVAR-60, Run: 046, F, 0, 79, 0, 836, 479, 883, 1362
INVAR-60, Run: 047, F, 0, 79, 0, 1089, 552, 1136, 1688
INVAR-60, Run: 048, F, 0, 0, 79, 1596, 1851, 1564, 3415
INVAR-60, Run: 049, F, 0, 79, 0, 829, 509, 876, 1385
INVAR-60, Run: 050, F, 0, 0, 79, 548, 1146, 516, 1662
INVAR-60, Run: 051, F, 0, 0, 79, 1427, 2178, 1395, 3573
INVAR-60, Run: 052, F, 0, 79, 0, 171, 92, 218, 310
INVAR-60, Run: 053, F, 0, 0, 79, 259, 752, 227, 979
INVAR-60, Run: 054, F, 0, 0, 79, 734, 2076, 702, 2778
INVAR-60, Run: 055, F, 0, 0, 79, 620, 828, 588, 1416
INVAR-60, Run: 056, F, 0, 79, 0, 669, 380, 716, 1096
INVAR-60, Run: 057, F, 0, 0, 79, 254, 1048, 222, 1270
INVAR-60, Run: 058, F, 0, 0, 79, 134, 632, 102, 734
INVAR-60, Run: 059, F, 0, 0, 79, 526, 1299, 494, 1793
INVAR-60, Run: 060, F, 0, 0, 79, 988, 2428, 956, 3384
INVAR-60, Run: 061, F, 0, 0, 79, 398, 1262, 366, 1628
INVAR-60, Run: 062, F, 0, 0, 79, 989, 2682, 957, 3639
INVAR-60, Run: 063, F, 0, 0, 79, 617, 1998, 585, 2583
INVAR-60, Run: 064, F, 0, 0, 79, 172, 1090, 140, 1230
INVAR-60, Run: 065, F, 0, 0, 79, 541, 942, 509, 1451
INVAR-60, Run: 066, F, 0, 0, 79, 558, 1350, 526, 1876
INVAR-60, Run: 067, F, 0, 79, 0, 504, 199, 551, 750
INVAR-60, Run: 068, F, 0, 79, 0, 1515, 1236, 1562, 2798
INVAR-60, Run: 069, F, 0, 79, 0, 290, 149, 337, 486
INVAR-60, Run: 070, F, 0, 0, 79, 129, 1185, 97, 1282
INVAR-60, Run: 071, F, 0, 0, 79, 162, 968, 130, 1098
INVAR-60, Run: 072, F, 0, 79, 0, 154, 45, 201, 246
INVAR-60, Run: 073, F, 0, 0, 79, 530, 1709, 498, 2207
INVAR-60, Run: 074, F, 0, 79, 0, 1073, 1481, 1120, 2601
INVAR-60, Run: 075, F, 0, 0, 79, 549, 1509, 517, 2026
INVAR-60, Run: 076, F, 0, 0, 79, 507, 1283, 475, 1758
INVAR-60, Run: 077, F, 0, 79, 0, 756, 329, 803, 1132
INVAR-60, Run: 078, F, 0, 79, 0, 278, 89, 325, 414
INVAR-60, Run: 079, F, 0, 79, 0, 299, 198, 346, 544
INVAR-60, Run: 080, F, 0, 0, 79, 313, 1888, 281, 2169
INVAR-60, Run: 081, F, 0, 79, 0, 688, 563, 735, 1298
INVAR-60, Run: 082, F, 0, 79, 0, 889, 1135, 936, 2071
INVAR-60, Run: 083, F, 0, 0, 79, 781, 1487, 749, 2236
INVAR-60, Run: 084, F, 0, 79, 0, 1473, 1302, 1520, 2822
INVAR-60, Run: 085, F, 0, 0, 79, 263, 1056, 231, 1287
INVAR-60, Run: 086, F, 0, 79, 0, 369, 318, 416, 734
INVAR-60, Run: 087, F, 0, 0, 79, 506, 796, 474, 1270
INVAR-60, Run: 088, F, 0, 79, 0, 381, 199, 428, 627
INVAR-60, Run: 089, F, 0, 79, 0, 461, 205, 508, 713
INVAR-60, Run: 090, F, 0, 79, 0, 791, 400, 838, 1238
INVAR-60, Run: 091, F, 0, 0, 79, 256, 1088, 224, 1312
INVAR-60, Run: 092, F, 0, 0, 79, 213, 1065, 181, 1246
INVAR-60, Run: 093, F, 0, 79, 0, 993, 509, 1040, 1549
INVAR-60, Run: 094, F, 0, 0, 79, 316, 1455, 284, 1739
INVAR-60, Run: 095, F, 0, 0, 79, 239, 1179, 207, 1386
INVAR-60, Run: 096, F, 0, 0, 79, 613, 1850, 581, 2431
INVAR-60, Run: 097, F, 0, 0, 79, 375, 1299, 343, 1642
INVAR-60, Run: 098, F, 0, 79, 0, 1225, 2335, 1272, 3607
INVAR-60, Run: 099, F, 0, 79, 0, 1683, 546, 1730, 2276
INVAR-60, Run: 100, F, 0, 0, 79, 772, 2898, 740, 3638
INVAR-61, Run: 001, F, 0, 0, 113, 505, 1608, 465, 2073
INVAR-61, Run: 002, F, 0, 0, 113, 200, 1478, 160, 1638
INVAR-61, Run: 003, F, 0, 0, 113, 199, 1390, 159, 1549
INVAR-61, Run: 004, F, 0, 0, 113, 176, 637, 136, 773
INVAR-61, Run: 005, F, 0, 0, 113, 985, 3330, 945, 4275
INVAR-61, Run: 006, F, 0, 113, 0, 1832, 2253, 1905, 4158
INVAR-61, Run: 007, F, 0, 113, 0, 1993, 824, 2066, 2890
INVAR-61, Run: 008, F, 0, 0, 113, 2435, 4986, 2395, 7381
INVAR-61, Run: 009, F, 0, 0, 113, 616, 1597, 576, 2173
INVAR-61, Run: 010, F, 0, 0, 113, 551, 2145, 511, 2656
INVAR-61, Run: 011, F, 0, 0, 113, 803, 1459, 763, 2222
INVAR-61, Run: 012, F, 0, 0, 113, 788, 2291, 748, 3039
INVAR-61, Run: 013, F, 0, 0, 113, 816, 2463, 776, 3239
INVAR-61, Run: 014, F, 0, 0, 113, 1610, 3296, 1570, 4866
INVAR-61, Run: 015, F, 0, 0, 113, 1508, 2690, 1468, 4158
INVAR-61, Run: 016, F, 0, 113, 0, 1568, 1433, 1641, 3074
INVAR-61, Run: 017, F, 0, 113, 0, 559, 202, 632, 834
INVAR-61, Run: 018, F, 0, 0, 113, 383, 1501, 343, 1844
INVAR-61, Run: 019, F, 0, 0, 113, 3507, 10226, 3467, 13693
INVAR-61, Run: 020, F, 0, 0, 113, 602, 2703, 562, 3265
INVAR-61, Run: 021, F, 0, 0, 113, 181, 1058, 141, 1199
INVAR-61, Run: 022, F, 0, 113, 0, 1564, 692, 1637, 2329
INVAR-61, Run: 023, F, 0, 113, 0, 1316, 663, 1389, 2052
INVAR-61, Run: 024, F, 0, 113, 0, 1180, 783, 1253, 2036
INVAR-61, Run: 025, F, 0, 0, 113, 1931, 5044, 1891, 6935
INVAR-61, Run: 026, F, 0, 0, 113, 1065, 4730, 1025, 5755
INVAR-61, Run: 027, F, 0, 0, 113, 760, 2620, 720, 3340
INVAR-61, Run: 028, F, 0, 0, 113, 495, 1351, 455, 1806
INVAR-61, Run: 029, F, 0, 0, 113, 826, 1654, 786, 2440
INVAR-61, Run: 030, F, 0, 0, 113, 2452, 4083, 2412, 6495
INVAR-61, Run: 031, F, 0, 0, 113, 537, 1924, 497, 2421
INVAR-61, Run: 032, F, 0, 0, 113, 431, 2598, 391, 2989
INVAR-61, Run: 033, F, 0, 0, 113, 2526, 3767, 2486, 6253
INVAR-61, Run: 034, F, 0, 113, 0, 962, 283, 1035, 1318
INVAR-61, Run: 035, F, 0, 0, 113, 1401, 2920, 1361, 4281
INVAR-61, Run: 036, F, 0, 0, 113, 913, 2208, 873, 3081
INVAR-61, Run: 037, F, 0, 0, 113, 699, 2509, 659, 3168
INVAR-61, Run: 038, F, 0, 0, 113, 926, 2653, 886, 3539
INVAR-61, Run: 039, F, 0, 113, 0, 1339, 363, 1412, 1775
INVAR-61, Run: 040, F, 0, 0, 113, 1962, 3889, 1922, 5811
INVAR-61, Run: 041, F, 0, 0, 113, 313, 1614, 273, 1887
INVAR-61, Run: 042, F, 0, 0, 113, 903, 2454, 863, 3317
INVAR-61, Run: 043, F, 0, 0, 113, 193, 885, 153, 1038
INVAR-61, Run: 044, F, 0, 0, 113, 206, 1067, 166, 1233
INVAR-61, Run: 045, F, 0, 0, 113, 1287, 4908, 1247, 6155
INVAR-61, Run: 046, F, 0, 113, 0, 973, 623, 1046, 1669
INVAR-61, Run: 047, F, 0, 113, 0, 2297, 3367, 2370, 5737
INVAR-61, Run: 048, F, 0, 0, 113, 1180, 3831, 1140, 4971
INVAR-61, Run: 049, F, 0, 113, 0, 3068, 2413, 3141, 5554
INVAR-61, Run: 050, F, 0, 113, 0, 2544, 2004, 2617, 4621
INVAR-61, Run: 051, F, 0, 0, 113, 2061, 3975, 2021, 5996
INVAR-61, Run: 052, F, 0, 0, 113, 1652, 4498, 1612, 6110
INVAR-61, Run: 053, F, 0, 113, 0, 687, 339, 760, 1099
INVAR-61, Run: 054, F, 0, 0, 113, 807, 2613, 767, 3380
INVAR-61, Run: 055, F, 0, 0, 113, 3828, 4633, 3788, 8421
INVAR-61, Run: 056, F, 0, 0, 113, 451, 1732, 411, 2143
INVAR-61, Run: 057, F, 0, 0, 113, 1226, 5120, 1186, 6306
INVAR-61, Run: 058, F, 0, 0, 113, 4460, 7091, 4420, 11511
INVAR-61, Run: 059, F, 0, 0, 113, 4785, 7311, 4745, 12056
INVAR-61, Run: 060, F, 0, 0, 113, 694, 2256, 654, 2910
INVAR-61, Run: 061, F, 0, 0, 113, 180, 760, 140, 900
INVAR-61, Run: 062, F, 0, 0, 113, 1671, 3263, 1631, 4894
INVAR-61, Run: 063, F, 0, 0, 113, 342, 1106, 302, 1408
INVAR-61, Run: 064, F, 0, 0, 113, 266, 1094, 226, 1320
INVAR-61, Run: 065, F, 0, 0, 113, 766, 1529, 726, 2255
INVAR-61, Run: 066, F, 0, 113, 0, 593, 239, 666, 905
INVAR-61, Run: 067, F, 0, 113, 0, 3682, 5559, 3755, 9314
INVAR-61, Run: 068, F, 0, 0, 113, 2993, 4087, 2953, 7040
INVAR-61, Run: 069, F, 0, 113, 0, 3672, 3089, 3745, 6834
INVAR-61, Run: 070, F, 0, 0, 113, 257, 791, 217, 1008
INVAR-61, Run: 071, F, 0, 0, 113, 645, 1699, 605, 2304
INVAR-61, Run: 072, F, 0, 113, 0, 1601, 1028, 1674, 2702
INVAR-61, Run: 073, F, 0, 0, 113, 3609, 4407, 3569, 7976
INVAR-61, Run: 074, F, 0, 113, 0, 797, 690, 870, 1560
INVAR-61, Run: 075, F, 0, 113, 0, 295, 150, 368, 518
INVAR-61, Run: 076, F, 0, 0, 113, 1907, 3644, 1867, 5511
INVAR-61, Run: 077, F, 0, 0, 113, 1346, 3507, 1306, 4813
INVAR-61, Run: 078, F, 0, 0, 113, 285, 942, 245, 1187
INVAR-61, Run: 079, F, 0, 0, 113, 2084, 3318, 2044, 5362
INVAR-61, Run: 080, F, 0, 0, 113, 1191, 5658, 1151, 6809
INVAR-61, Run: 081, F, 0, 0, 113, 69, 625, 29, 654
INVAR-61, Run: 082, F, 0, 113, 0, 1363, 1277, 1436, 2713
INVAR-61, Run: 083, F, 0, 0, 113, 485, 2523, 445, 2968
INVAR-61, Run: 084, F, 0, 0, 113, 589, 4203, 549, 4752
INVAR-61, Run: 085, F, 0, 0, 113, 1034, 4449, 994, 5443
INVAR-61, Run: 086, F, 0, 0, 113, 1273, 2367, 1233, 3600
INVAR-61, Run: 087, F, 0, 0, 113, 1215, 2984, 1175, 4159
INVAR-61, Run: 088, F, 0, 0, 113, 1610, 3146, 1570, 4716
INVAR-61, Run: 089, F, 0, 0, 113, 2120, 2751, 2080, 4831
INVAR-61, Run: 090, F, 0, 0, 113, 4154, 4125, 4114, 8239
INVAR-61, Run: 091, F, 0, 0, 113, 441, 4000, 401, 4401
INVAR-61, Run: 092, F, 0, 113, 0, 3130, 908, 3203, 4111
INVAR-61, Run: 093, F, 0, 113, 0, 1370, 1104, 1443, 2547
INVAR-61, Run: 094, F, 0, 0, 113, 631, 2018, 591, 2609
INVAR-61, Run: 095, F, 0, 0, 113, 740, 2882, 700, 3582
INVAR-61, Run: 096, F, 0, 0, 113, 4176, 7745, 4136, 11881
INVAR-61, Run: 097, F, 0, 0, 113, 1937, 3490, 1897, 5387
INVAR-61, Run: 098, F, 0, 0, 113, 646, 2032, 606, 2638
INVAR-61, Run: 099, F, 0, 0, 113, 358, 2003, 318, 2321
INVAR-61, Run: 100, F, 0, 113, 0, 2329, 2067, 2402, 4469
INVAR-62, Run: 001, F, 0, 0, 271, 8062, 18004, 7954, 25958
INVAR-62, Run: 002, F, 0, 271, 0, 22357, 16288, 22520, 38808
INVAR-62, Run: 003, F, 0, 0, 271, 3029, 12379, 2921, 15300
INVAR-62, Run: 004, F, 0, 0, 271, 3747, 17894, 3639, 21533
INVAR-62, Run: 005, F, 0, 0, 271, 7205, 17774, 7097, 24871
INVAR-62, Run: 006, F, 0, 271, 0, 4008, 4159, 4171, 8330
INVAR-62, Run: 007, F, 0, 0, 271, 7692, 13801, 7584, 21385
INVAR-62, Run: 008, F, 0, 271, 0, 8602, 6149, 8765, 14914
INVAR-62, Run: 009, F, 0, 0, 271, 3551, 18528, 3443, 21971
INVAR-62, Run: 010, F, 0, 271, 0, 14717, 14268, 14880, 29148
INVAR-62, Run: 011, F, 0, 271, 0, 4473, 2544, 4636, 7180
INVAR-62, Run: 012, F, 0, 0, 271, 6267, 13702, 6159, 19861
INVAR-62, Run: 013, F, 0, 271, 0, 9578, 4865, 9741, 14606
INVAR-62, Run: 014, F, 0, 271, 0, 6349, 3504, 6512, 10016
INVAR-62, Run: 015, F, 0, 0, 271, 5752, 20420, 5644, 26064
INVAR-62, Run: 016, F, 0, 0, 271, 5056, 13529, 4948, 18477
INVAR-62, Run: 017, F, 0, 0, 271, 23515, 15992, 23407, 39399
INVAR-62, Run: 018, F, 0, 0, 271, 2600, 13212, 2492, 15704
INVAR-62, Run: 019, F, 0, 0, 271, 18180, 20400, 18072, 38472
INVAR-62, Run: 020, F, 0, 271, 0, 8421, 2509, 8584, 11093
INVAR-62, Run: 021, F, 0, 271, 0, 2362, 844, 2525, 3369
INVAR-62, Run: 022, F, 0, 271, 0, 2799, 2022, 2962, 4984
INVAR-62, Run: 023, F, 0, 271, 0, 18962, 21208, 19125, 40333
INVAR-62, Run: 024, F, 0, 271, 0, 11158, 8469, 11321, 19790
INVAR-62, Run: 025, F, 0, 0, 271, 4245, 18115, 4137, 22252
INVAR-62, Run: 026, F, 0, 271, 0, 12977, 12460, 13140, 25600
INVAR-62, Run: 027, F, 0, 0, 271, 9290, 16380, 9182, 25562
INVAR-62, Run: 028, F, 0, 271, 0, 7967, 5816, 8130, 13946
INVAR-62, Run: 029, F, 0, 271, 0, 18998, 14191, 19161, 33352
INVAR-62, Run: 030, F, 0, 0, 271, 2780, 11602, 2672, 14274
INVAR-62, Run: 031, F, 0, 0, 271, 9433, 21800, 9325, 31125
INVAR-62, Run: 032, F, 0, 0, 271, 7038, 9406, 6930, 16336
INVAR-62, Run: 033, F, 0, 271, 0, 9820, 4719, 9983, 14702
INVAR-62, Run: 034, F, 0, 271, 0, 5551, 3809, 5714, 9523
INVAR-62, Run: 035, F, 0, 0, 271, 1256, 10238, 1148, 11386
INVAR-62, Run: 036, F, 0, 0, 271, 5451, 17100, 5343, 22443
INVAR-62, Run: 037, F, 0, 0, 271, 13195, 28964, 13087, 42051
INVAR-62, Run: 038, F, 0, 271, 0, 3014, 2115, 3177, 5292
INVAR-62, Run: 039, F, 0, 0, 271, 7061, 23914, 6953, 30867
INVAR-62, Run: 040, F, 0, 271, 0, 2716, 1312, 2879, 4191
INVAR-62, Run: 041, F, 0, 0, 271, 3818, 9279, 3710, 12989
INVAR-62, Run: 042, F, 0, 271, 0, 12615, 5352, 12778, 18130
INVAR-62, Run: 043, F, 0, 0, 271, 10246, 16883, 10138, 27021
INVAR-62, Run: 044, F, 0, 271, 0, 11429, 4714, 11592, 16306
INVAR-62, Run: 045, F, 0, 0, 271, 5576, 27127, 5468, 32595
INVAR-62, Run: 046, F, 0, 0, 271, 23500, 22381, 23392, 45773
INVAR-62, Run: 047, F, 0, 0, 271, 3990, 12544, 3882, 16426
INVAR-62, Run: 048, F, 0, 0, 271, 5038, 8233, 4930, 13163
INVAR-62, Run: 049, F, 0, 0, 271, 1612, 12480, 1504, 13984
INVAR-62, Run: 050, F, 0, 271, 0, 11242, 19610, 11405, 31015
INVAR-62, Run: 051, F, 0, 0, 271, 22315, 23663, 22207, 45870
INVAR-62, Run: 052, F, 0, 0, 271, 4725, 15288, 4617, 19905
INVAR-62, Run: 053, F, 0, 271, 0, 3374, 858, 3537, 4395
INVAR-62, Run: 054, F, 0, 0, 271, 8024, 22450, 7916, 30366
INVAR-62, Run: 055, F, 0, 0, 271, 8861, 20926, 8753, 29679
INVAR-62, Run: 056, F, 0, 271, 0, 16338, 12275, 16501, 28776
INVAR-62, Run: 057, F, 0, 271, 0, 25170, 16657, 25333, 41990
INVAR-62, Run: 058, F, 0, 0, 271, 2994, 8025, 2886, 10911
INVAR-62, Run: 059, F, 0, 0, 271, 1348, 5207, 1240, 6447
INVAR-62, Run: 060, F, 0, 0, 271, 2600, 10235, 2492, 12727
INVAR-62, Run: 061, F, 0, 271, 0, 8323, 3377, 8486, 11863
INVAR-62, Run: 062, F, 0, 0, 271, 7373, 15820, 7265, 23085
INVAR-62, Run: 063, F, 0, 0, 271, 5125, 12770, 5017, 17787
INVAR-62, Run: 064, F, 0, 0, 271, 7494, 16677, 7386, 24063
INVAR-62, Run: 065, F, 0, 0, 271, 17152, 22118, 17044, 39162
INVAR-62, Run: 066, F, 0, 0, 271, 10554, 19710, 10446, 30156
INVAR-62, Run: 067, F, 0, 0, 271, 3467, 14095, 3359, 17454
INVAR-62, Run: 068, F, 0, 271, 0, 15380, 7904, 15543, 23447
INVAR-62, Run: 069, F, 0, 0, 271, 10766, 13735, 10658, 24393
INVAR-62, Run: 070, F, 0, 271, 0, 11657, 6788, 11820, 18608
INVAR-62, Run: 071, F, 0, 0, 271, 12055, 17829, 11947, 29776
INVAR-62, Run: 072, F, 0, 0, 271, 4411, 10742, 4303, 15045
INVAR-62, Run: 073, F, 0, 0, 271, 1716, 12072, 1608, 13680
INVAR-62, Run: 074, F, 0, 0, 271, 4725, 8569, 4617, 13186
INVAR-62, Run: 075, F, 0, 271, 0, 5253, 1455, 5416, 6871
INVAR-62, Run: 076, F, 0, 0, 271, 16748, 42452, 16640, 59092
INVAR-62, Run: 077, F, 0, 271, 0, 18980, 6218, 19143, 25361
INVAR-62, Run: 078, F, 0, 0, 271, 8126, 22834, 8018, 30852
INVAR-62, Run: 079, F, 0, 0, 271, 14736, 26670, 14628, 41298
INVAR-62, Run: 080, F, 0, 271, 0, 10175, 8522, 10338, 18860
INVAR-62, Run: 081, F, 0, 0, 271, 9307, 13785, 9199, 22984
INVAR-62, Run: 082, F, 0, 0, 271, 3907, 17136, 3799, 20935
INVAR-62, Run: 083, F, 0, 0, 271, 5628, 8477, 5520, 13997
INVAR-62, Run: 084, F, 0, 0, 271, 3476, 9078, 3368, 12446
INVAR-62, Run: 085, F, 0, 0, 271, 6564, 17940, 6456, 24396
INVAR-62, Run: 086, F, 0, 0, 271, 18725, 59661, 18617, 78278
INVAR-62, Run: 087, F, 0, 271, 0, 22656, 25750, 22819, 48569
INVAR-62, Run: 088, F, 0, 271, 0, 6168, 8076, 6331, 14407
INVAR-62, Run: 089, F, 0, 0, 271, 7328, 13094, 7220, 20314
INVAR-62, Run: 090, F, 0, 0, 271, 11261, 24438, 11153, 35591
INVAR-62, Run: 091, F, 0, 0, 271, 3001, 11401, 2893, 14294
INVAR-62, Run: 092, F, 0, 0, 271, 6106, 16732, 5998, 22730
INVAR-62, Run: 093, F, 0, 0, 271, 3661, 7996, 3553, 11549
INVAR-62, Run: 094, F, 0, 0, 271, 13307, 27265, 13199, 40464
INVAR-62, Run: 095, F, 0, 271, 0, 12474, 6564, 12637, 19201
INVAR-62, Run: 096, F, 0, 0, 271, 18935, 28182, 18827, 47009
INVAR-62, Run: 097, F, 0, 0, 271, 5499, 14150, 5391, 19541
INVAR-62, Run: 098, F, 0, 271, 0, 13292, 7752, 13455, 21207
INVAR-62, Run: 099, F, 0, 0, 271, 916, 5695, 808, 6503
INVAR-62, Run: 100, F, 0, 0, 271, 12669, 35962, 12561, 48523
INVAR-63, Run: 001, F, 0, 60, 0, 167, 59, 202, 261
INVAR-63, Run: 002, F, 0, 0, 60, 205, 504, 180, 684
INVAR-63, Run: 003, F, 0, 0, 60, 471, 629, 446, 1075
INVAR-63, Run: 004, F, 0, 60, 0, 1389, 579, 1424, 2003
INVAR-63, Run: 005, F, 0, 0, 60, 228, 887, 203, 1090
INVAR-63, Run: 006, F, 0, 0, 60, 265, 1413, 240, 1653
INVAR-63, Run: 007, F, 0, 0, 60, 136, 335, 111, 446
INVAR-63, Run: 008, F, 0, 60, 0, 594, 412, 629, 1041
INVAR-63, Run: 009, F, 0, 0, 60, 194, 679, 169, 848
INVAR-63, Run: 010, F, 0, 0, 60, 299, 421, 274, 695
INVAR-63, Run: 011, F, 0, 0, 60, 313, 702, 288, 990
INVAR-63, Run: 012, F, 0, 0, 60, 90, 308, 65, 373
INVAR-63, Run: 013, F, 0, 60, 0, 347, 136, 382, 518
INVAR-63, Run: 014, F, 0, 0, 60, 220, 570, 195, 765
INVAR-63, Run: 015, F, 0, 0, 60, 87, 518, 62, 580
INVAR-63, Run: 016, F, 0, 0, 60, 213, 353, 188, 541
INVAR-63, Run: 017, F, 0, 60, 0, 455, 267, 490, 757
INVAR-63, Run: 018, F, 0, 60, 0, 490, 920, 525, 1445
INVAR-63, Run: 019, F, 0, 60, 0, 486, 135, 521, 656
INVAR-63, Run: 020, F, 0, 60, 0, 410, 312, 445, 757
INVAR-63, Run: 021, F, 0, 0, 60, 72, 409, 47, 456
INVAR-63, Run: 022, F, 0, 0, 60, 62, 203, 37, 240
INVAR-63, Run: 023, F, 0, 60, 0, 757, 813, 792, 1605
INVAR-63, Run: 024, F, 0, 0, 60, 160, 966, 135, 1101
INVAR-63, Run: 025, F, 0, 0, 60, 166, 686, 141, 827
INVAR-63, Run: 026, F, 0, 60, 0, 172, 57, 207, 264
INVAR-63, Run: 027, F, 0, 0, 60, 806, 1111, 781, 1892
INVAR-63, Run: 028, F, 0, 0, 60, 159, 789, 134, 923
INVAR-63, Run: 029, F, 0, 0, 60, 347, 810, 322, 1132
INVAR-63, Run: 030, F, 0, 0, 60, 282, 737, 257, 994
INVAR-63, Run: 031, F, 0, 0, 60, 221, 811, 196, 1007
INVAR-63, Run: 032, F, 0, 60, 0, 685, 625, 720, 1345
INVAR-63, Run: 033, F, 0, 0, 60, 104, 366, 79, 445
INVAR-63, Run: 034, F, 0, 0, 60, 152, 722, 127, 849
INVAR-63, Run: 035, F, 0, 0, 60, 641, 860, 616, 1476
INVAR-63, Run: 036, F, 0, 60, 0, 378, 131, 413, 544
INVAR-63, Run: 037, F, 0, 0, 60, 787, 3796, 762, 4558
INVAR-63, Run: 038, F, 0, 60, 0, 323, 240, 358, 598
INVAR-63, Run: 039, F, 0, 0, 60, 724, 992, 699, 1691
INVAR-63, Run: 040, F, 0, 60, 0, 172, 125, 207, 332
INVAR-63, Run: 041, F, 0, 0, 60, 258, 646, 233, 879
INVAR-63, Run: 042, F, 0, 60, 0, 182, 109, 217, 326
INVAR-63, Run: 043, F, 0, 60, 0, 236, 106, 271, 377
INVAR-63, Run: 044, F, 0, 0, 60, 211, 304, 186, 490
INVAR-63, Run: 045, F, 0, 0, 60, 176, 514, 151, 665
INVAR-63, Run: 046, F, 0, 0, 60, 364, 580, 339, 919
INVAR-63, Run: 047, F, 0, 0, 60, 126, 505, 101, 606
INVAR-63, Run: 048, F, 0, 0, 60, 114, 317, 89, 406
INVAR-63, Run: 049, F, 0, 0, 60, 320, 526, 295, 821
INVAR-63, Run: 050, F, 0, 60, 0, 133, 56, 168, 224
INVAR-63, Run: 051, F, 0, 0, 60, 733, 1098, 708, 1806
INVAR-63, Run: 052, F, 0, 60, 0, 203, 203, 238, 441
INVAR-63, Run: 053, F, 0, 60, 0, 574, 883, 609, 1492
INVAR-63, Run: 054, F, 0, 0, 60, 417, 580, 392, 972
INVAR-63, Run: 055, F, 0, 0, 60, 295, 653, 270, 923
INVAR-63, Run: 056, F, 0, 60, 0, 1013, 700, 1048, 1748
INVAR-63, Run: 057, F, 0, 0, 60, 310, 616, 285, 901
INVAR-63, Run: 058, F, 0, 0, 60, 741, 1177, 716, 1893
INVAR-63, Run: 059, F, 0, 0, 60, 410, 653, 385, 1038
INVAR-63, Run: 060, F, 0, 60, 0, 370, 270, 405, 675
INVAR-63, Run: 061, F, 0, 60, 0, 294, 251, 329, 580
INVAR-63, Run: 062, F, 0, 60, 0, 384, 118, 419, 537
INVAR-63, Run: 063, F, 0, 0, 60, 2282, 2503, 2257, 4760
INVAR-63, Run: 064, F, 0, 0, 60, 210, 634, 185, 819
INVAR-63, Run: 065, F, 0, 0, 60, 606, 1595, 581, 2176
INVAR-63, Run: 066, F, 0, 60, 0, 438, 736, 473, 1209
INVAR-63, Run: 067, F, 0, 60, 0, 607, 263, 642, 905
INVAR-63, Run: 068, F, 0, 60, 0, 511, 267, 546, 813
INVAR-63, Run: 069, F, 0, 0, 60, 333, 527, 308, 835
INVAR-63, Run: 070, F, 0, 60, 0, 699, 707, 734, 1441
INVAR-63, Run: 071, F, 0, 0, 60, 273, 497, 248, 745
INVAR-63, Run: 072, F, 0, 0, 60, 160, 465, 135, 600
INVAR-63, Run: 073, F, 0, 60, 0, 797, 764, 832, 1596
INVAR-63, Run: 074, F, 0, 60, 0, 177, 56, 212, 268
INVAR-63, Run: 075, F, 0, 0, 60, 303, 953, 278, 1231
INVAR-63, Run: 076, F, 0, 60, 0, 482, 437, 517, 954
INVAR-63, Run: 077, F, 0, 0, 60, 115, 326, 90, 416
INVAR-63, Run: 078, F, 0, 60, 0, 121, 29, 156, 185
INVAR-63, Run: 079, F, 0, 60, 0, 438, 157, 473, 630
INVAR-63, Run: 080, F, 0, 0, 60, 536, 661, 511, 1172
INVAR-63, Run: 081, F, 0, 0, 60, 310, 708, 285, 993
INVAR-63, Run: 082, F, 0, 0, 60, 199, 1065, 174, 1239
INVAR-63, Run: 083, F, 0, 60, 0, 434, 221, 469, 690
INVAR-63, Run: 084, F, 0, 0, 60, 820, 759, 795, 1554
INVAR-63, Run: 085, F, 0, 0, 60, 599, 676, 574, 1250
INVAR-63, Run: 086, F, 0, 0, 60, 688, 1476, 663, 2139
INVAR-63, Run: 087, F, 0, 60, 0, 424, 644, 459, 1103
INVAR-63, Run: 088, F, 0, 60, 0, 193, 120, 228, 348
INVAR-63, Run: 089, F, 0, 0, 60, 141, 443, 116, 559
INVAR-63, Run: 090, F, 0, 0, 60, 243, 788, 218, 1006
INVAR-63, Run: 091, F, 0, 0, 60, 285, 503, 260, 763
INVAR-63, Run: 092, F, 0, 0, 60, 80, 358, 55, 413
INVAR-63, Run: 093, F, 0, 0, 60, 101, 414, 76, 490
INVAR-63, Run: 094, F, 0, 60, 0, 327, 206, 362, 568
INVAR-63, Run: 095, F, 0, 60, 0, 203, 90, 238, 328
INVAR-63, Run: 096, F, 0, 0, 60, 54, 144, 29, 173
INVAR-63, Run: 097, F, 0, 0, 60, 598, 963, 573, 1536
INVAR-63, Run: 098, F, 0, 60, 0, 195, 50, 230, 280
INVAR-63, Run: 099, F, 0, 60, 0, 386, 127, 421, 548
INVAR-63, Run: 100, F, 0, 60, 0, 1866, 2531, 1901, 4432
INVAR-64, Run: 001, F, 0, 0, 132, 1573, 3062, 1520, 4582
INVAR-64, Run: 002, F, 0, 132, 0, 1851, 1176, 1930, 3106
INVAR-64, Run: 003, F, 0, 0, 132, 3253, 6778, 3200, 9978
INVAR-64, Run: 004, F, 0, 0, 132, 629, 4204, 576, 4780
INVAR-64, Run: 005, F, 0, 0, 132, 1271, 4299, 1218, 5517
INVAR-64, Run: 006, F, 0, 0, 132, 327, 1230, 274, 1504
INVAR-64, Run: 007, F, 0, 0, 132, 6339, 9867, 6286, 16153
INVAR-64, Run: 008, F, 0, 132, 0, 1512, 600, 1591, 2191
INVAR-64, Run: 009, F, 0, 0, 132, 1066, 4450, 1013, 5463
INVAR-64, Run: 010, F, 0, 0, 132, 3271, 5150, 3218, 8368
INVAR-64, Run: 011, F, 0, 0, 132, 3850, 4687, 3797, 8484
INVAR-64, Run: 012, F, 0, 0, 132, 1037, 2388, 984, 3372
INVAR-64, Run: 013, F, 0, 0, 132, 316, 1630, 263, 1893
INVAR-64, Run: 014, F, 0, 132, 0, 1276, 819, 1355, 2174
INVAR-64, Run: 015, F, 0, 132, 0, 2958, 4304, 3037, 7341
INVAR-64, Run: 016, F, 0, 0, 132, 367, 1713, 314, 2027
INVAR-64, Run: 017, F, 0, 0, 132, 408, 1756, 355, 2111
INVAR-64, Run: 018, F, 0, 0, 132, 4218, 6932, 4165, 11097
INVAR-64, Run: 019, F, 0, 132, 0, 7517, 5837, 7596, 13433
INVAR-64, Run: 020, F, 0, 132, 0, 3309, 1730, 3388, 5118
INVAR-64, Run: 021, F, 0, 132, 0, 8469, 11617, 8548, 20165
INVAR-64, Run: 022, F, 0, 0, 132, 1273, 5442, 1220, 6662
INVAR-64, Run: 023, F, 0, 0, 132, 1287, 2212, 1234, 3446
INVAR-64, Run: 024, F, 0, 0, 132, 977, 5174, 924, 6098
INVAR-64, Run: 025, F, 0, 132, 0, 894, 321, 973, 1294
INVAR-64, Run: 026, F, 0, 132, 0, 1591, 1411, 1670, 3081
INVAR-64, Run: 027, F, 0, 0, 132, 208, 928, 155, 1083
INVAR-64, Run: 028, F, 0, 132, 0, 2065, 2436, 2144, 4580
INVAR-64, Run: 029, F, 0, 0, 132, 1185, 2393, 1132, 3525
INVAR-64, Run: 030, F, 0, 0, 132, 4556, 6852, 4503, 11355
INVAR-64, Run: 031, F, 0, 132, 0, 5901, 2978, 5980, 8958
INVAR-64, Run: 032, F, 0, 132, 0, 1090, 583, 1169, 1752
INVAR-64, Run: 033, F, 0, 0, 132, 422, 1440, 369, 1809
INVAR-64, Run: 034, F, 0, 0, 132, 801, 6674, 748, 7422
INVAR-64, Run: 035, F, 0, 132, 0, 1862, 1455, 1941, 3396
INVAR-64, Run: 036, F, 0, 0, 132, 4515, 4044, 4462, 8506
INVAR-64, Run: 037, F, 0, 0, 132, 1197, 6148, 1144, 7292
INVAR-64, Run: 038, F, 0, 0, 132, 831, 1844, 778, 2622
INVAR-64, Run: 039, F, 0, 0, 132, 2873, 2684, 2820, 5504
INVAR-64, Run: 040, F, 0, 0, 132, 2137, 12263, 2084, 14347
INVAR-64, Run: 041, F, 0, 132, 0, 2717, 1429, 2796, 4225
INVAR-64, Run: 042, F, 0, 0, 132, 665, 2202, 612, 2814
INVAR-64, Run: 043, F, 0, 132, 0, 757, 388, 836, 1224
INVAR-64, Run: 044, F, 0, 0, 132, 771, 3421, 718, 4139
INVAR-64, Run: 045, F, 0, 0, 132, 3129, 4118, 3076, 7194
INVAR-64, Run: 046, F, 0, 132, 0, 5716, 3697, 5795, 9492
INVAR-64, Run: 047, F, 0, 0, 132, 990, 2100, 937, 3037
INVAR-64, Run: 048, F, 0, 132, 0, 1657, 1579, 1736, 3315
INVAR-64, Run: 049, F, 0, 0, 132, 4270, 7936, 4217, 12153
INVAR-64, Run: 050, F, 0, 132, 0, 1367, 773, 1446, 2219
INVAR-64, Run: 051, F, 0, 132, 0, 3643, 3816, 3722, 7538
INVAR-64, Run: 052, F, 0, 0, 132, 2942, 9148, 2889, 12037
INVAR-64, Run: 053, F, 0, 0, 132, 1630, 2949, 1577, 4526
INVAR-64, Run: 054, F, 0, 0, 132, 716, 3644, 663, 4307
INVAR-64, Run: 055, F, 0, 0, 132, 1295, 3796, 1242, 5038
INVAR-64, Run: 056, F, 0, 0, 132, 6434, 7037, 6381, 13418
INVAR-64, Run: 057, F, 0, 0, 132, 788, 2546, 735, 3281
INVAR-64, Run: 058, F, 0, 132, 0, 787, 297, 866, 1163
INVAR-64, Run: 059, F, 0, 0, 132, 1433, 3596, 1380, 4976
INVAR-64, Run: 060, F, 0, 0, 132, 4373, 9793, 4320, 14113
INVAR-64, Run: 061, F, 0, 0, 132, 2477, 6166, 2424, 8590
INVAR-64, Run: 062, F, 0, 0, 132, 1714, 6399, 1661, 8060
INVAR-64, Run: 063, F, 0, 0, 132, 1488, 4783, 1435, 6218
INVAR-64, Run: 064, F, 0, 0, 132, 672, 4027, 619, 4646
INVAR-64, Run: 065, F, 0, 0, 132, 169, 1059, 116, 1175
INVAR-64, Run: 066, F, 0, 0, 132, 295, 1623, 242, 1865
INVAR-64, Run: 067, F, 0, 132, 0, 1134, 317, 1213, 1530
INVAR-64, Run: 068, F, 0, 132, 0, 514, 121, 593, 714
INVAR-64, Run: 069, F, 0, 0, 132, 974, 4218, 921, 5139
INVAR-64, Run: 070, F, 0, 0, 132, 2090, 5677, 2037, 7714
INVAR-64, Run: 071, F, 0, 132, 0, 3904, 5086, 3983, 9069
INVAR-64, Run: 072, F, 0, 0, 132, 8738, 7295, 8685, 15980
INVAR-64, Run: 073, F, 0, 132, 0, 1410, 1340, 1489, 2829
INVAR-64, Run: 074, F, 0, 0, 132, 2161, 6034, 2108, 8142
INVAR-64, Run: 075, F, 0, 132, 0, 786, 364, 865, 1229
INVAR-64, Run: 076, F, 0, 0, 132, 1045, 3499, 992, 4491
INVAR-64, Run: 077, F, 0, 132, 0, 1733, 819, 1812, 2631
INVAR-64, Run: 078, F, 0, 0, 132, 673, 3364, 620, 3984
INVAR-64, Run: 079, F, 0, 0, 132, 3689, 6916, 3636, 10552
INVAR-64, Run: 080, F, 0, 0, 132, 526, 2979, 473, 3452
INVAR-64, Run: 081, F, 0, 132, 0, 5168, 5223, 5247, 10470
INVAR-64, Run: 082, F, 0, 132, 0, 1348, 956, 1427, 2383
INVAR-64, Run: 083, F, 0, 0, 132, 1146, 5091, 1093, 6184
INVAR-64, Run: 084, F, 0, 132, 0, 592, 287, 671, 958
INVAR-64, Run: 085, F, 0, 132, 0, 2171, 1739, 2250, 3989
INVAR-64, Run: 086, F, 0, 0, 132, 1015, 1798, 962, 2760
INVAR-64, Run: 087, F, 0, 132, 0, 3513, 2100, 3592, 5692
INVAR-64, Run: 088, F, 0, 132, 0, 328, 165, 407, 572
INVAR-64, Run: 089, F, 0, 132, 0, 717, 369, 796, 1165
INVAR-64, Run: 090, F, 0, 132, 0, 1974, 1243, 2053, 3296
INVAR-64, Run: 091, F, 0, 0, 132, 2761, 6691, 2708, 9399
INVAR-64, Run: 092, F, 0, 0, 132, 1254, 5098, 1201, 6299
INVAR-64, Run: 093, F, 0, 0, 132, 347, 976, 294, 1270
INVAR-64, Run: 094, F, 0, 0, 132, 508, 2457, 455, 2912
INVAR-64, Run: 095, F, 0, 132, 0, 2914, 1893, 2993, 4886
INVAR-64, Run: 096, F, 0, 0, 132, 623, 3686, 570, 4256
INVAR-64, Run: 097, F, 0, 0, 132, 1097, 3421, 1044, 4465
INVAR-64, Run: 098, F, 0, 0, 132, 1944, 4368, 1891, 6259
INVAR-64, Run: 099, F, 0, 0, 132, 4697, 10130, 4644, 14774
INVAR-64, Run: 100, F, 0, 132, 0, 2276, 1614, 2355, 3969
INVAR-65, Run: 001, F, 0, 0, 330, 12663, 29717, 12532, 42249
INVAR-65, Run: 002, F, 0, 0, 330, 4844, 25228, 4713, 29941
INVAR-65, Run: 003, F, 0, 330, 0, 31534, 34956, 31733, 66689
INVAR-65, Run: 004, F, 0, 0, 330, 4685, 12244, 4554, 16798
INVAR-65, Run: 005, F, 0, 330, 0, 5522, 5317, 5721, 11038
INVAR-65, Run: 006, F, 0, 0, 330, 7615, 23505, 7484, 30989
INVAR-65, Run: 007, F, 0, 0, 330, 2797, 6868, 2666, 9534
INVAR-65, Run: 008, F, 0, 0, 330, 7490, 16604, 7359, 23963
INVAR-65, Run: 009, F, 0, 0, 330, 24119, 30451, 23988, 54439
INVAR-65, Run: 010, F, 0, 330, 0, 3000, 890, 3199, 4089
INVAR-65, Run: 011, F, 0, 0, 330, 7528, 30836, 7397, 38233
INVAR-65, Run: 012, F, 0, 0, 330, 6572, 9180, 6441, 15621
INVAR-65, Run: 013, F, 0, 0, 330, 44129, 58687, 43998, 102685
INVAR-65, Run: 014, F, 0, 330, 0, 10269, 2458, 10468, 12926
INVAR-65, Run: 015, F, 0, 330, 0, 13322, 6322, 13521, 19843
INVAR-65, Run: 016, F, 0, 0, 330, 2076, 7429, 1945, 9374
INVAR-65, Run: 017, F, 0, 330, 0, 23115, 18190, 23314, 41504
INVAR-65, Run: 018, F, 0, 330, 0, 40855, 81619, 41054, 122673
INVAR-65, Run: 019, F, 0, 0, 330, 2227, 18612, 2096, 20708
INVAR-65, Run: 020, F, 0, 330, 0, 11465, 11893, 11664, 23557
INVAR-65, Run: 021, F, 0, 0, 330, 16192, 68607, 16061, 84668
INVAR-65, Run: 022, F, 0, 0, 330, 15539, 28623, 15408, 44031
INVAR-65, Run: 023, F, 0, 330, 0, 7009, 1901, 7208, 9109
INVAR-65, Run: 024, F, 0, 0, 330, 23596, 35343, 23465, 58808
INVAR-65, Run: 025, F, 0, 330, 0, 2934, 1193, 3133, 4326
INVAR-65, Run: 026, F, 0, 330, 0, 8971, 3921, 9170, 13091
INVAR-65, Run: 027, F, 0, 0, 330, 11668, 44594, 11537, 56131
INVAR-65, Run: 028, F, 0, 0, 330, 4811, 12994, 4680, 17674
INVAR-65, Run: 029, F, 0, 0, 330, 17764, 36091, 17633, 53724
INVAR-65, Run: 030, F, 0, 0, 330, 7739, 7262, 7608, 14870
INVAR-65, Run: 031, F, 0, 330, 0, 3414, 1019, 3613, 4632
INVAR-65, Run: 032, F, 0, 330, 0, 7000, 3704, 7199, 10903
INVAR-65, Run: 033, F, 0, 0, 330, 16715, 23160, 16584, 39744
INVAR-65, Run: 034, F, 0, 330, 0, 5580, 1881, 5779, 7660
INVAR-65, Run: 035, F, 0, 330, 0, 3713, 1580, 3912, 5492
INVAR-65, Run: 036, F, 0, 0, 330, 35920, 52793, 35789, 88582
INVAR-65, Run: 037, F, 0, 330, 0, 8098, 6587, 8297, 14884
INVAR-65, Run: 038, F, 0, 0, 330, 3289, 14940, 3158, 18098
INVAR-65, Run: 039, F, 0, 0, 330, 3051, 15861, 2920, 18781
INVAR-65, Run: 040, F, 0, 0, 330, 31414, 89895, 31283, 121178
INVAR-65, Run: 041, F, 0, 330, 0, 10456, 9577, 10655, 20232
INVAR-65, Run: 042, F, 0, 0, 330, 2938, 20987, 2807, 23794
INVAR-65, Run: 043, F, 0, 330, 0, 4584, 2204, 4783, 6987
INVAR-65, Run: 044, F, 0, 0, 330, 10287, 43831, 10156, 53987
INVAR-65, Run: 045, F, 0, 0, 330, 20948, 33253, 20817, 54070
INVAR-65, Run: 046, F, 0, 330, 0, 18070, 17421, 18269, 35690
INVAR-65, Run: 047, F, 0, 0, 330, 6562, 10604, 6431, 17035
INVAR-65, Run: 048, F, 0, 330, 0, 11415, 3814, 11614, 15428
INVAR-65, Run: 049, F, 0, 330, 0, 14297, 6713, 14496, 21209
INVAR-65, Run: 050, F, 0, 0, 330, 2477, 9906, 2346, 12252
INVAR-65, Run: 051, F, 0, 0, 330, 1437, 12577, 1306, 13883
INVAR-65, Run: 052, F, 0, 330, 0, 7639, 5660, 7838, 13498
INVAR-65, Run: 053, F, 0, 330, 0, 11938, 19387, 12137, 31524
INVAR-65, Run: 054, F, 0, 0, 330, 2122, 9936, 1991, 11927
INVAR-65, Run: 055, F, 0, 0, 330, 3353, 15092, 3222, 18314
INVAR-65, Run: 056, F, 0, 0, 330, 5534, 9877, 5403, 15280
INVAR-65, Run: 057, F, 0, 0, 330, 2228, 11305, 2097, 13402
INVAR-65, Run: 058, F, 0, 0, 330, 26714, 82880, 26583, 109463
INVAR-65, Run: 059, F, 0, 0, 330, 2715, 10851, 2584, 13435
INVAR-65, Run: 060, F, 0, 330, 0, 3236, 1718, 3435, 5153
INVAR-65, Run: 061, F, 0, 330, 0, 7510, 5930, 7709, 13639
INVAR-65, Run: 062, F, 0, 330, 0, 17160, 10450, 17359, 27809
INVAR-65, Run: 063, F, 0, 330, 0, 13155, 7460, 13354, 20814
INVAR-65, Run: 064, F, 0, 0, 330, 2676, 12454, 2545, 14999
INVAR-65, Run: 065, F, 0, 330, 0, 3474, 1728, 3673, 5401
INVAR-65, Run: 066, F, 0, 330, 0, 5946, 1519, 6145, 7664
INVAR-65, Run: 067, F, 0, 0, 330, 7633, 19032, 7502, 26534
INVAR-65, Run: 068, F, 0, 0, 330, 25989, 51107, 25858, 76965
INVAR-65, Run: 069, F, 0, 0, 330, 10065, 31054, 9934, 40988
INVAR-65, Run: 070, F, 0, 0, 330, 2571, 10379, 2440, 12819
INVAR-65, Run: 071, F, 0, 330, 0, 4829, 2543, 5028, 7571
INVAR-65, Run: 072, F, 0, 0, 330, 1067, 9097, 936, 10033
INVAR-65, Run: 073, F, 0, 330, 0, 7662, 1892, 7861, 9753
INVAR-65, Run: 074, F, 0, 330, 0, 21382, 22290, 21581, 43871
INVAR-65, Run: 075, F, 0, 0, 330, 19626, 24465, 19495, 43960
INVAR-65, Run: 076, F, 0, 0, 330, 19424, 35781, 19293, 55074
INVAR-65, Run: 077, F, 0, 330, 0, 11560, 5146, 11759, 16905
INVAR-65, Run: 078, F, 0, 330, 0, 13651, 5415, 13850, 19265
INVAR-65, Run: 079, F, 0, 0, 330, 2875, 16400, 2744, 19144
INVAR-65, Run: 080, F, 0, 0, 330, 24696, 33611, 24565, 58176
INVAR-65, Run: 081, F, 0, 0, 330, 7878, 36729, 7747, 44476
INVAR-65, Run: 082, F, 0, 0, 330, 4232, 13839, 4101, 17940
INVAR-65, Run: 083, F, 0, 330, 0, 4299, 3489, 4498, 7987
INVAR-65, Run: 084, F, 0, 0, 330, 7274, 11869, 7143, 19012
INVAR-65, Run: 085, F, 0, 0, 330, 2403, 11542, 2272, 13814
INVAR-65, Run: 086, F, 0, 330, 0, 51880, 56928, 52079, 109007
INVAR-65, Run: 087, F, 0, 0, 330, 12025, 51124, 11894, 63018
INVAR-65, Run: 088, F, 0, 0, 330, 13937, 23479, 13806, 37285
INVAR-65, Run: 089, F, 0, 330, 0, 30654, 11231, 30853, 42084
INVAR-65, Run: 090, F, 0, 0, 330, 1456, 5273, 1325, 6598
INVAR-65, Run: 091, F, 0, 0, 330, 7364, 23630, 7233, 30863
INVAR-65, Run: 092, F, 0, 330, 0, 25161, 12337, 25360, 37697
INVAR-65, Run: 093, F, 0, 0, 330, 1828, 15512, 1697, 17209
INVAR-65, Run: 094, F, 0, 330, 0, 11313, 4811, 11512, 16323
INVAR-65, Run: 095, F, 0, 0, 330, 10829, 17811, 10698, 28509
INVAR-65, Run: 096, F, 0, 330, 0, 8407, 3515, 8606, 12121
INVAR-65, Run: 097, F, 0, 0, 330, 21483, 48611, 21352, 69963
INVAR-65, Run: 098, F, 0, 330, 0, 49882, 67208, 50081, 117289
INVAR-65, Run: 099, F, 0, 0, 330, 8181, 12873, 8050, 20923
INVAR-65, Run: 100, F, 0, 330, 0, 26206, 49423, 26405, 75828
INVAR-66, Run: 001, F, 0, 0, 315, 1645, 6053, 1499, 7552
INVAR-66, Run: 002, F, 0, 0, 315, 4411, 13757, 4265, 18022
INVAR-66, Run: 003, F, 0, 0, 315, 26414, 31893, 26268, 58161
INVAR-66, Run: 004, F, 0, 0, 315, 4297, 27748, 4151, 31899
INVAR-66, Run: 005, F, 0, 0, 315, 10365, 21229, 10219, 31448
INVAR-66, Run: 006, F, 0, 0, 315, 8153, 12007, 8007, 20014
INVAR-66, Run: 007, F, 0, 315, 0, 38646, 39040, 38815, 77855
INVAR-66, Run: 008, F, 0, 0, 315, 12069, 16390, 11923, 28313
INVAR-66, Run: 009, F, 0, 315, 0, 25445, 40499, 25614, 66113
INVAR-66, Run: 010, F, 0, 315, 0, 15262, 7711, 15431, 23142
INVAR-66, Run: 011, F, 0, 0, 315, 7359, 18154, 7213, 25367
INVAR-66, Run: 012, F, 0, 0, 315, 10439, 30901, 10293, 41194
INVAR-66, Run: 013, F, 0, 315, 0, 4259, 1464, 4428, 5892
INVAR-66, Run: 014, F, 0, 315, 0, 13141, 5366, 13310, 18676
INVAR-66, Run: 015, F, 0, 315, 0, 17359, 7871, 17528, 25399
INVAR-66, Run: 016, F, 0, 0, 315, 5419, 10919, 5273, 16192
INVAR-66, Run: 017, F, 0, 315, 0, 22266, 7128, 22435, 29563
INVAR-66, Run: 018, F, 0, 315, 0, 36603, 21890, 36772, 58662
INVAR-66, Run: 019, F, 0, 0, 315, 3688, 11151, 3542, 14693
INVAR-66, Run: 020, F, 0, 0, 315, 21913, 73275, 21767, 95042
INVAR-66, Run: 021, F, 0, 315, 0, 3793, 1458, 3962, 5420
INVAR-66, Run: 022, F, 0, 0, 315, 14780, 33639, 14634, 48273
INVAR-66, Run: 023, F, 0, 315, 0, 10522, 8436, 10691, 19127
INVAR-66, Run: 024, F, 0, 0, 315, 4018, 12498, 3872, 16370
INVAR-66, Run: 025, F, 0, 0, 315, 4448, 24332, 4302, 28634
INVAR-66, Run: 026, F, 0, 0, 315, 13085, 17972, 12939, 30911
INVAR-66, Run: 027, F, 0, 315, 0, 24598, 53919, 24767, 78686
INVAR-66, Run: 028, F, 0, 0, 315, 32160, 65308, 32014, 97322
INVAR-66, Run: 029, F, 0, 0, 315, 8667, 24787, 8521, 33308
INVAR-66, Run: 030, F, 0, 315, 0, 21831, 21475, 22000, 43475
INVAR-66, Run: 031, F, 0, 315, 0, 2303, 780, 2472, 3252
INVAR-66, Run: 032, F, 0, 0, 315, 31742, 41668, 31596, 73264
INVAR-66, Run: 033, F, 0, 315, 0, 2652, 915, 2821, 3736
INVAR-66, Run: 034, F, 0, 315, 0, 13898, 19877, 14067, 33944
INVAR-66, Run: 035, F, 0, 0, 315, 4938, 7761, 4792, 12553
INVAR-66, Run: 036, F, 0, 0, 315, 5429, 11674, 5283, 16957
INVAR-66, Run: 037, F, 0, 0, 315, 2370, 8785, 2224, 11009
INVAR-66, Run: 038, F, 0, 315, 0, 5260, 5633, 5429, 11062
INVAR-66, Run: 039, F, 0, 0, 315, 1828, 8726, 1682, 10408
INVAR-66, Run: 040, F, 0, 0, 315, 4996, 17289, 4850, 22139
INVAR-66, Run: 041, F, 0, 0, 315, 2064, 9276, 1918, 11194
INVAR-66, Run: 042, F, 0, 0, 315, 19122, 52013, 18976, 70989
INVAR-66, Run: 043, F, 0, 0, 315, 29164, 46092, 29018, 75110
INVAR-66, Run: 044, F, 0, 0, 315, 15410, 35533, 15264, 50797
INVAR-66, Run: 045, F, 0, 315, 0, 6014, 2878, 6183, 9061
INVAR-66, Run: 046, F, 0, 315, 0, 12465, 3717, 12634, 16351
INVAR-66, Run: 047, F, 0, 315, 0, 4944, 1374, 5113, 6487
INVAR-66, Run: 048, F, 0, 0, 315, 56757, 117104, 56611, 173715
INVAR-66, Run: 049, F, 0, 0, 315, 3226, 14260, 3080, 17340
INVAR-66, Run: 050, F, 0, 0, 315, 2310, 12128, 2164, 14292
INVAR-66, Run: 051, F, 0, 0, 315, 11017, 16810, 10871, 27681
INVAR-66, Run: 052, F, 0, 0, 315, 6674, 21273, 6528, 27801
INVAR-66, Run: 053, F, 0, 315, 0, 8192, 2876, 8361, 11237
INVAR-66, Run: 054, F, 0, 0, 315, 4576, 9737, 4430, 14167
INVAR-66, Run: 055, F, 0, 0, 315, 14842, 61151, 14696, 75847
INVAR-66, Run: 056, F, 0, 0, 315, 5383, 15854, 5237, 21091
INVAR-66, Run: 057, F, 0, 0, 315, 4823, 11393, 4677, 16070
INVAR-66, Run: 058, F, 0, 0, 315, 10382, 26360, 10236, 36596
INVAR-66, Run: 059, F, 0, 0, 315, 4096, 10061, 3950, 14011
INVAR-66, Run: 060, F, 0, 315, 0, 6239, 2188, 6408, 8596
INVAR-66, Run: 061, F, 0, 0, 315, 16066, 22892, 15920, 38812
INVAR-66, Run: 062, F, 0, 0, 315, 2518, 15006, 2372, 17378
INVAR-66, Run: 063, F, 0, 0, 315, 2046, 7009, 1900, 8909
INVAR-66, Run: 064, F, 0, 315, 0, 11881, 6182, 12050, 18232
INVAR-66, Run: 065, F, 0, 315, 0, 17384, 35243, 17553, 52796
INVAR-66, Run: 066, F, 0, 0, 315, 4088, 9366, 3942, 13308
INVAR-66, Run: 067, F, 0, 315, 0, 7862, 4699, 8031, 12730
INVAR-66, Run: 068, F, 0, 0, 315, 18271, 39532, 18125, 57657
INVAR-66, Run: 069, F, 0, 0, 315, 9834, 27646, 9688, 37334
INVAR-66, Run: 070, F, 0, 0, 315, 2667, 6755, 2521, 9276
INVAR-66, Run: 071, F, 0, 315, 0, 16088, 8410, 16257, 24667
INVAR-66, Run: 072, F, 0, 315, 0, 10515, 4071, 10684, 14755
INVAR-66, Run: 073, F, 0, 0, 315, 4289, 9467, 4143, 13610
INVAR-66, Run: 074, F, 0, 0, 315, 9005, 17907, 8859, 26766
INVAR-66, Run: 075, F, 0, 315, 0, 35732, 23673, 35901, 59574
INVAR-66, Run: 076, F, 0, 0, 315, 4881, 16482, 4735, 21217
INVAR-66, Run: 077, F, 0, 0, 315, 27744, 40279, 27598, 67877
INVAR-66, Run: 078, F, 0, 0, 315, 5060, 13424, 4914, 18338
INVAR-66, Run: 079, F, 0, 315, 0, 3645, 979, 3814, 4793
INVAR-66, Run: 080, F, 0, 315, 0, 17961, 10599, 18130, 28729
INVAR-66, Run: 081, F, 0, 0, 315, 14000, 25841, 13854, 39695
INVAR-66, Run: 082, F, 0, 0, 315, 37711, 26076, 37565, 63641
INVAR-66, Run: 083, F, 0, 0, 315, 12278, 33852, 12132, 45984
INVAR-66, Run: 084, F, 0, 0, 315, 14205, 26785, 14059, 40844
INVAR-66, Run: 085, F, 0, 315, 0, 14708, 11525, 14877, 26402
INVAR-66, Run: 086, F, 0, 315, 0, 18211, 9156, 18380, 27536
INVAR-66, Run: 087, F, 0, 0, 315, 10802, 28574, 10656, 39230
INVAR-66, Run: 088, F, 0, 0, 315, 3548, 6672, 3402, 10074
INVAR-66, Run: 089, F, 0, 315, 0, 7631, 2065, 7800, 9865
INVAR-66, Run: 090, F, 0, 0, 315, 41079, 59756, 40933, 100689
INVAR-66, Run: 091, F, 0, 0, 315, 10307, 25710, 10161, 35871
INVAR-66, Run: 092, F, 0, 0, 315, 2467, 9308, 2321, 11629
INVAR-66, Run: 093, F, 0, 315, 0, 9059, 3551, 9228, 12779
INVAR-66, Run: 094, F, 0, 315, 0, 17021, 13482, 17190, 30672
INVAR-66, Run: 095, F, 0, 315, 0, 6759, 5292, 6928, 12220
INVAR-66, Run: 096, F, 0, 0, 315, 2860, 7578, 2714, 10292
INVAR-66, Run: 097, F, 0, 0, 315, 45944, 77143, 45798, 122941
INVAR-66, Run: 098, F, 0, 315, 0, 12042, 8628, 12211, 20839
INVAR-66, Run: 099, F, 0, 0, 315, 7456, 36287, 7310, 43597
INVAR-66, Run: 100, F, 0, 315, 0, 8784, 4324, 8953, 13277
INVAR-67, Run: 001, F, 0, 0, 84, 191, 958, 156, 1114
INVAR-67, Run: 002, F, 0, 84, 0, 399, 141, 448, 589
INVAR-67, Run: 003, F, 0, 84, 0, 423, 159, 472, 631
INVAR-67, Run: 004, F, 0, 84, 0, 669, 249, 718, 967
INVAR-67, Run: 005, F, 0, 84, 0, 1297, 748, 1346, 2094
INVAR-67, Run: 006, F, 0, 84, 0, 274, 60, 323, 383
INVAR-67, Run: 007, F, 0, 84, 0, 636, 134, 685, 819
INVAR-67, Run: 008, F, 0, 84, 0, 1290, 1912, 1339, 3251
INVAR-67, Run: 009, F, 0, 0, 84, 211, 724, 176, 900
INVAR-67, Run: 010, F, 0, 84, 0, 2597, 1354, 2646, 4000
INVAR-67, Run: 011, F, 0, 84, 0, 564, 248, 613, 861
INVAR-67, Run: 012, F, 0, 0, 84, 2986, 5193, 2951, 8144
INVAR-67, Run: 013, F, 0, 0, 84, 825, 2152, 790, 2942
INVAR-67, Run: 014, F, 0, 0, 84, 1637, 1664, 1602, 3266
INVAR-67, Run: 015, F, 0, 0, 84, 802, 1001, 767, 1768
INVAR-67, Run: 016, F, 0, 0, 84, 256, 802, 221, 1023
INVAR-67, Run: 017, F, 0, 84, 0, 2133, 2259, 2182, 4441
INVAR-67, Run: 018, F, 0, 84, 0, 2877, 2441, 2926, 5367
INVAR-67, Run: 019, F, 0, 84, 0, 1905, 1550, 1954, 3504
INVAR-67, Run: 020, F, 0, 84, 0, 937, 1067, 986, 2053
INVAR-67, Run: 021, F, 0, 0, 84, 1582, 1653, 1547, 3200
INVAR-67, Run: 022, F, 0, 84, 0, 669, 258, 718, 976
INVAR-67, Run: 023, F, 0, 0, 84, 354, 991, 319, 1310
INVAR-67, Run: 024, F, 0, 0, 84, 307, 969, 272, 1241
INVAR-67, Run: 025, F, 0, 0, 84, 714, 2451, 679, 3130
INVAR-67, Run: 026, F, 0, 84, 0, 2056, 772, 2105, 2877
INVAR-67, Run: 027, F, 0, 0, 84, 1290, 2277, 1255, 3532
INVAR-67, Run: 028, F, 0, 84, 0, 518, 126, 567, 693
INVAR-67, Run: 029, F, 0, 0, 84, 559, 818, 524, 1342
INVAR-67, Run: 030, F, 0, 0, 84, 1376, 1667, 1341, 3008
INVAR-67, Run: 031, F, 0, 0, 84, 914, 1941, 879, 2820
INVAR-67, Run: 032, F, 0, 0, 84, 1148, 2316, 1113, 3429
INVAR-67, Run: 033, F, 0, 0, 84, 1382, 6403, 1347, 7750
INVAR-67, Run: 034, F, 0, 84, 0, 272, 95, 321, 416
INVAR-67, Run: 035, F, 0, 84, 0, 1062, 819, 1111, 1930
INVAR-67, Run: 036, F, 0, 0, 84, 1913, 3922, 1878, 5800
INVAR-67, Run: 037, F, 0, 84, 0, 438, 142, 487, 629
INVAR-67, Run: 038, F, 0, 0, 84, 1822, 2195, 1787, 3982
INVAR-67, Run: 039, F, 0, 84, 0, 705, 183, 754, 937
INVAR-67, Run: 040, F, 0, 0, 84, 837, 1092, 802, 1894
INVAR-67, Run: 041, F, 0, 84, 0, 1961, 1616, 2010, 3626
INVAR-67, Run: 042, F, 0, 0, 84, 197, 482, 162, 644
INVAR-67, Run: 043, F, 0, 84, 0, 438, 116, 487, 603
INVAR-67, Run: 044, F, 0, 84, 0, 2092, 553, 2141, 2694
INVAR-67, Run: 045, F, 0, 0, 84, 904, 2067, 869, 2936
INVAR-67, Run: 046, F, 0, 0, 84, 530, 1174, 495, 1669
INVAR-67, Run: 047, F, 0, 0, 84, 1164, 2540, 1129, 3669
INVAR-67, Run: 048, F, 0, 0, 84, 632, 1907, 597, 2504
INVAR-67, Run: 049, F, 0, 0, 84, 480, 2004, 445, 2449
INVAR-67, Run: 050, F, 0, 0, 84, 547, 1917, 512, 2429
INVAR-67, Run: 051, F, 0, 0, 84, 1701, 2049, 1666, 3715
INVAR-67, Run: 052, F, 0, 0, 84, 167, 690, 132, 822
INVAR-67, Run: 053, F, 0, 84, 0, 1243, 296, 1292, 1588
INVAR-67, Run: 054, F, 0, 84, 0, 982, 505, 1031, 1536
INVAR-67, Run: 055, F, 0, 0, 84, 1015, 1450, 980, 2430
INVAR-67, Run: 056, F, 0, 0, 84, 772, 2087, 737, 2824
INVAR-67, Run: 057, F, 0, 0, 84, 1974, 3108, 1939, 5047
INVAR-67, Run: 058, F, 0, 84, 0, 2084, 1887, 2133, 4020
INVAR-67, Run: 059, F, 0, 0, 84, 99, 418, 64, 482
INVAR-67, Run: 060, F, 0, 0, 84, 1899, 2256, 1864, 4120
INVAR-67, Run: 061, F, 0, 0, 84, 283, 675, 248, 923
INVAR-67, Run: 062, F, 0, 0, 84, 1576, 2934, 1541, 4475
INVAR-67, Run: 063, F, 0, 84, 0, 429, 207, 478, 685
INVAR-67, Run: 064, F, 0, 84, 0, 592, 462, 641, 1103
INVAR-67, Run: 065, F, 0, 84, 0, 2852, 2634, 2901, 5535
INVAR-67, Run: 066, F, 0, 84, 0, 1272, 1564, 1321, 2885
INVAR-67, Run: 067, F, 0, 0, 84, 298, 679, 263, 942
INVAR-67, Run: 068, F, 0, 84, 0, 150, 103, 199, 302
INVAR-67, Run: 069, F, 0, 84, 0, 551, 313, 600, 913
INVAR-67, Run: 070, F, 0, 0, 84, 482, 1803, 447, 2250
INVAR-67, Run: 071, F, 0, 84, 0, 320, 130, 369, 499
INVAR-67, Run: 072, F, 0, 0, 84, 457, 1332, 422, 1754
INVAR-67, Run: 073, F, 0, 0, 84, 725, 1102, 690, 1792
INVAR-67, Run: 074, F, 0, 84, 0, 659, 289, 708, 997
INVAR-67, Run: 075, F, 0, 84, 0, 375, 201, 424, 625
INVAR-67, Run: 076, F, 0, 0, 84, 425, 1633, 390, 2023
INVAR-67, Run: 077, F, 0, 0, 84, 287, 1045, 252, 1297
INVAR-67, Run: 078, F, 0, 84, 0, 1626, 1608, 1675, 3283
INVAR-67, Run: 079, F, 0, 84, 0, 923, 352, 972, 1324
INVAR-67, Run: 080, F, 0, 0, 84, 336, 1532, 301, 1833
INVAR-67, Run: 081, F, 0, 84, 0, 284, 116, 333, 449
INVAR-67, Run: 082, F, 0, 84, 0, 478, 295, 527, 822
INVAR-67, Run: 083, F, 0, 0, 84, 98, 411, 63, 474
INVAR-67, Run: 084, F, 0, 0, 84, 156, 908, 121, 1029
INVAR-67, Run: 085, F, 0, 0, 84, 728, 1278, 693, 1971
INVAR-67, Run: 086, F, 0, 0, 84, 689, 1730, 654, 2384
INVAR-67, Run: 087, F, 0, 0, 84, 1128, 2145, 1093, 3238
INVAR-67, Run: 088, F, 0, 0, 84, 320, 1130, 285, 1415
INVAR-67, Run: 089, F, 0, 84, 0, 1821, 1490, 1870, 3360
INVAR-67, Run: 090, F, 0, 84, 0, 521, 263, 570, 833
INVAR-67, Run: 091, F, 0, 84, 0, 957, 900, 1006, 1906
INVAR-67, Run: 092, F, 0, 0, 84, 1294, 1399, 1259, 2658
INVAR-67, Run: 093, F, 0, 0, 84, 341, 740, 306, 1046
INVAR-67, Run: 094, F, 0, 0, 84, 509, 2172, 474, 2646
INVAR-67, Run: 095, F, 0, 84, 0, 2496, 1818, 2545, 4363
INVAR-67, Run: 096, F, 0, 0, 84, 232, 648, 197, 845
INVAR-67, Run: 097, F, 0, 0, 84, 2760, 5626, 2725, 8351
INVAR-67, Run: 098, F, 0, 0, 84, 1757, 1663, 1722, 3385
INVAR-67, Run: 099, F, 0, 0, 84, 340, 781, 305, 1086
INVAR-67, Run: 100, F, 0, 0, 84, 1152, 2206, 1117, 3323
INVAR-68, Run: 001, F, 0, 0, 162, 3896, 10853, 3829, 14682
INVAR-68, Run: 002, F, 0, 0, 162, 1272, 5261, 1205, 6466
INVAR-68, Run: 003, F, 0, 0, 162, 1954, 4391, 1887, 6278
INVAR-68, Run: 004, F, 0, 0, 162, 2735, 9530, 2668, 12198
INVAR-68, Run: 005, F, 0, 162, 0, 6168, 4190, 6263, 10453
INVAR-68, Run: 006, F, 0, 0, 162, 4026, 7296, 3959, 11255
INVAR-68, Run: 007, F, 0, 0, 162, 3492, 4372, 3425, 7797
INVAR-68, Run: 008, F, 0, 0, 162, 3884, 8842, 3817, 12659
INVAR-68, Run: 009, F, 0, 162, 0, 5773, 3484, 5868, 9352
INVAR-68, Run: 010, F, 0, 162, 0, 1826, 704, 1921, 2625
INVAR-68, Run: 011, F, 0, 162, 0, 1611, 577, 1706, 2283
INVAR-68, Run: 012, F, 0, 162, 0, 6233, 11190, 6328, 17518
INVAR-68, Run: 013, F, 0, 0, 162, 528, 2086, 461, 2547
INVAR-68, Run: 014, F, 0, 0, 162, 1211, 3656, 1144, 4800
INVAR-68, Run: 015, F, 0, 0, 162, 466, 1476, 399, 1875
INVAR-68, Run: 016, F, 0, 0, 162, 499, 1879, 432, 2311
INVAR-68, Run: 017, F, 0, 0, 162, 3935, 5495, 3868, 9363
INVAR-68, Run: 018, F, 0, 162, 0, 5707, 6910, 5802, 12712
INVAR-68, Run: 019, F, 0, 0, 162, 6020, 14576, 5953, 20529
INVAR-68, Run: 020, F, 0, 162, 0, 1001, 575, 1096, 1671
INVAR-68, Run: 021, F, 0, 0, 162, 13493, 13487, 13426, 26913
INVAR-68, Run: 022, F, 0, 0, 162, 892, 4291, 825, 5116
INVAR-68, Run: 023, F, 0, 0, 162, 874, 2061, 807, 2868
INVAR-68, Run: 024, F, 0, 162, 0, 2642, 1179, 2737, 3916
INVAR-68, Run: 025, F, 0, 0, 162, 768, 2551, 701, 3252
INVAR-68, Run: 026, F, 0, 0, 162, 1911, 2343, 1844, 4187
INVAR-68, Run: 027, F, 0, 0, 162, 3168, 9334, 3101, 12435
INVAR-68, Run: 028, F, 0, 0, 162, 4185, 5657, 4118, 9775
INVAR-68, Run: 029, F, 0, 162, 0, 2741, 498, 2836, 3334
INVAR-68, Run: 030, F, 0, 0, 162, 670, 2714, 603, 3317
INVAR-68, Run: 031, F, 0, 0, 162, 3108, 4919, 3041, 7960
INVAR-68, Run: 032, F, 0, 0, 162, 907, 2609, 840, 3449
INVAR-68, Run: 033, F, 0, 162, 0, 2017, 700, 2112, 2812
INVAR-68, Run: 034, F, 0, 162, 0, 2013, 1666, 2108, 3774
INVAR-68, Run: 035, F, 0, 0, 162, 6220, 12173, 6153, 18326
INVAR-68, Run: 036, F, 0, 162, 0, 4537, 3846, 4632, 8478
INVAR-68, Run: 037, F, 0, 0, 162, 372, 1423, 305, 1728
INVAR-68, Run: 038, F, 0, 0, 162, 6712, 11285, 6645, 17930
INVAR-68, Run: 039, F, 0, 0, 162, 10334, 13447, 10267, 23714
INVAR-68, Run: 040, F, 0, 0, 162, 623, 3325, 556, 3881
INVAR-68, Run: 041, F, 0, 0, 162, 2253, 3454, 2186, 5640
INVAR-68, Run: 042, F, 0, 0, 162, 3990, 6577, 3923, 10500
INVAR-68, Run: 043, F, 0, 0, 162, 4425, 4325, 4358, 8683
INVAR-68, Run: 044, F, 0, 162, 0, 793, 212, 888, 1100
INVAR-68, Run: 045, F, 0, 0, 162, 686, 2674, 619, 3293
INVAR-68, Run: 046, F, 0, 162, 0, 4878, 4348, 4973, 9321
INVAR-68, Run: 047, F, 0, 0, 162, 2715, 5798, 2648, 8446
INVAR-68, Run: 048, F, 0, 0, 162, 5888, 5281, 5821, 11102
INVAR-68, Run: 049, F, 0, 162, 0, 4303, 2392, 4398, 6790
INVAR-68, Run: 050, F, 0, 0, 162, 10113, 14981, 10046, 25027
INVAR-68, Run: 051, F, 0, 0, 162, 1157, 7416, 1090, 8506
INVAR-68, Run: 052, F, 0, 0, 162, 1419, 7678, 1352, 9030
INVAR-68, Run: 053, F, 0, 0, 162, 2632, 6475, 2565, 9040
INVAR-68, Run: 054, F, 0, 0, 162, 2138, 4847, 2071, 6918
INVAR-68, Run: 055, F, 0, 162, 0, 1481, 640, 1576, 2216
INVAR-68, Run: 056, F, 0, 0, 162, 4114, 8462, 4047, 12509
INVAR-68, Run: 057, F, 0, 162, 0, 12765, 13147, 12860, 26007
INVAR-68, Run: 058, F, 0, 0, 162, 1156, 2865, 1089, 3954
INVAR-68, Run: 059, F, 0, 0, 162, 1022, 2362, 955, 3317
INVAR-68, Run: 060, F, 0, 162, 0, 6340, 3446, 6435, 9881
INVAR-68, Run: 061, F, 0, 162, 0, 812, 390, 907, 1297
INVAR-68, Run: 062, F, 0, 0, 162, 2006, 4459, 1939, 6398
INVAR-68, Run: 063, F, 0, 0, 162, 2175, 6823, 2108, 8931
INVAR-68, Run: 064, F, 0, 162, 0, 7361, 13948, 7456, 21404
INVAR-68, Run: 065, F, 0, 162, 0, 3213, 4096, 3308, 7404
INVAR-68, Run: 066, F, 0, 0, 162, 3409, 10014, 3342, 13356
INVAR-68, Run: 067, F, 0, 162, 0, 4491, 1848, 4586, 6434
INVAR-68, Run: 068, F, 0, 162, 0, 3382, 1568, 3477, 5045
INVAR-68, Run: 069, F, 0, 0, 162, 1544, 6542, 1477, 8019
INVAR-68, Run: 070, F, 0, 162, 0, 1758, 362, 1853, 2215
INVAR-68, Run: 071, F, 0, 162, 0, 1550, 745, 1645, 2390
INVAR-68, Run: 072, F, 0, 162, 0, 1093, 388, 1188, 1576
INVAR-68, Run: 073, F, 0, 0, 162, 913, 2511, 846, 3357
INVAR-68, Run: 074, F, 0, 0, 162, 4950, 6040, 4883, 10923
INVAR-68, Run: 075, F, 0, 162, 0, 1725, 584, 1820, 2404
INVAR-68, Run: 076, F, 0, 0, 162, 1516, 3372, 1449, 4821
INVAR-68, Run: 077, F, 0, 162, 0, 3656, 3227, 3751, 6978
INVAR-68, Run: 078, F, 0, 162, 0, 2650, 1297, 2745, 4042
INVAR-68, Run: 079, F, 0, 0, 162, 4936, 5097, 4869, 9966
INVAR-68, Run: 080, F, 0, 0, 162, 2027, 4829, 1960, 6789
INVAR-68, Run: 081, F, 0, 0, 162, 1651, 3216, 1584, 4800
INVAR-68, Run: 082, F, 0, 0, 162, 659, 4377, 592, 4969
INVAR-68, Run: 083, F, 0, 0, 162, 1074, 4758, 1007, 5765
INVAR-68, Run: 084, F, 0, 162, 0, 2484, 1370, 2579, 3949
INVAR-68, Run: 085, F, 0, 0, 162, 6049, 6769, 5982, 12751
INVAR-68, Run: 086, F, 0, 162, 0, 3894, 2036, 3989, 6025
INVAR-68, Run: 087, F, 0, 0, 162, 2404, 5516, 2337, 7853
INVAR-68, Run: 088, F, 0, 162, 0, 1746, 473, 1841, 2314
INVAR-68, Run: 089, F, 0, 0, 162, 9668, 16598, 9601, 26199
INVAR-68, Run: 090, F, 0, 0, 162, 869, 5701, 802, 6503
INVAR-68, Run: 091, F, 0, 0, 162, 3500, 4335, 3433, 7768
INVAR-68, Run: 092, F, 0, 0, 162, 1341, 3439, 1274, 4713
INVAR-68, Run: 093, F, 0, 0, 162, 6507, 12363, 6440, 18803
INVAR-68, Run: 094, F, 0, 0, 162, 3002, 7408, 2935, 10343
INVAR-68, Run: 095, F, 0, 0, 162, 1431, 3000, 1364, 4364
INVAR-68, Run: 096, F, 0, 0, 162, 4690, 4715, 4623, 9338
INVAR-68, Run: 097, F, 0, 0, 162, 1076, 6722, 1009, 7731
INVAR-68, Run: 098, F, 0, 162, 0, 1281, 398, 1376, 1774
INVAR-68, Run: 099, F, 0, 0, 162, 2094, 7290, 2027, 9317
INVAR-68, Run: 100, F, 0, 0, 162, 5794, 6579, 5727, 12306
INVAR-69, Run: 001, F, 0, 0, 330, 2260, 13424, 2109, 15533
INVAR-69, Run: 002, F, 0, 0, 330, 22608, 36442, 22457, 58899
INVAR-69, Run: 003, F, 0, 330, 0, 11219, 4822, 11398, 16220
INVAR-69, Run: 004, F, 0, 330, 0, 20760, 10257, 20939, 31196
INVAR-69, Run: 005, F, 0, 0, 330, 12092, 35719, 11941, 47660
INVAR-69, Run: 006, F, 0, 330, 0, 24122, 15517, 24301, 39818
INVAR-69, Run: 007, F, 0, 0, 330, 4389, 6469, 4238, 10707
INVAR-69, Run: 008, F, 0, 0, 330, 5930, 15772, 5779, 21551
INVAR-69, Run: 009, F, 0, 330, 0, 6263, 2297, 6442, 8739
INVAR-69, Run: 010, F, 0, 330, 0, 30417, 50055, 30596, 80651
INVAR-69, Run: 011, F, 0, 330, 0, 14822, 20632, 15001, 35633
INVAR-69, Run: 012, F, 0, 0, 330, 3053, 10015, 2902, 12917
INVAR-69, Run: 013, F, 0, 0, 330, 24506, 24153, 24355, 48508
INVAR-69, Run: 014, F, 0, 0, 330, 1768, 9597, 1617, 11214
INVAR-69, Run: 015, F, 0, 330, 0, 8001, 1460, 8180, 9640
INVAR-69, Run: 016, F, 0, 0, 330, 3719, 18981, 3568, 22549
INVAR-69, Run: 017, F, 0, 0, 330, 6367, 14513, 6216, 20729
INVAR-69, Run: 018, F, 0, 330, 0, 9034, 3825, 9213, 13038
INVAR-69, Run: 019, F, 0, 0, 330, 13448, 34538, 13297, 47835
INVAR-69, Run: 020, F, 0, 330, 0, 12162, 8122, 12341, 20463
INVAR-69, Run: 021, F, 0, 0, 330, 3457, 15863, 3306, 19169
INVAR-69, Run: 022, F, 0, 330, 0, 11566, 9598, 11745, 21343
INVAR-69, Run: 023, F, 0, 0, 330, 10031, 12900, 9880, 22780
INVAR-69, Run: 024, F, 0, 0, 330, 12635, 20223, 12484, 32707
INVAR-69, Run: 025, F, 0, 0, 330, 6049, 22276, 5898, 28174
INVAR-69, Run: 026, F, 0, 330, 0, 10043, 3189, 10222, 13411
INVAR-69, Run: 027, F, 0, 330, 0, 22441, 10647, 22620, 33267
INVAR-69, Run: 028, F, 0, 0, 330, 20907, 40128, 20756, 60884
INVAR-69, Run: 029, F, 0, 0, 330, 1760, 5621, 1609, 7230
INVAR-69, Run: 030, F, 0, 0, 330, 5581, 25550, 5430, 30980
INVAR-69, Run: 031, F, 0, 330, 0, 9368, 4624, 9547, 14171
INVAR-69, Run: 032, F, 0, 330, 0, 5792, 2091, 5971, 8062
INVAR-69, Run: 033, F, 0, 330, 0, 13422, 10758, 13601, 24359
INVAR-69, Run: 034, F, 0, 0, 330, 21171, 34574, 21020, 55594
INVAR-69, Run: 035, F, 0, 0, 330, 3957, 11666, 3806, 15472
INVAR-69, Run: 036, F, 0, 0, 330, 28115, 41683, 27964, 69647
INVAR-69, Run: 037, F, 0, 330, 0, 13514, 6301, 13693, 19994
INVAR-69, Run: 038, F, 0, 330, 0, 5738, 4429, 5917, 10346
INVAR-69, Run: 039, F, 0, 0, 330, 15723, 26415, 15572, 41987
INVAR-69, Run: 040, F, 0, 330, 0, 3525, 1640, 3704, 5344
INVAR-69, Run: 041, F, 0, 0, 330, 5497, 19361, 5346, 24707
INVAR-69, Run: 042, F, 0, 330, 0, 7572, 4843, 7751, 12594
INVAR-69, Run: 043, F, 0, 330, 0, 27956, 26841, 28135, 54976
INVAR-69, Run: 044, F, 0, 330, 0, 2281, 557, 2460, 3017
INVAR-69, Run: 045, F, 0, 0, 330, 14535, 26021, 14384, 40405
INVAR-69, Run: 046, F, 0, 0, 330, 16795, 30922, 16644, 47566
INVAR-69, Run: 047, F, 0, 330, 0, 16362, 7199, 16541, 23740
INVAR-69, Run: 048, F, 0, 330, 0, 17646, 4946, 17825, 22771
INVAR-69, Run: 049, F, 0, 0, 330, 10687, 23799, 10536, 34335
INVAR-69, Run: 050, F, 0, 330, 0, 10481, 3402, 10660, 14062
INVAR-69, Run: 051, F, 0, 0, 330, 3527, 19014, 3376, 22390
INVAR-69, Run: 052, F, 0, 0, 330, 14665, 42621, 14514, 57135
INVAR-69, Run: 053, F, 0, 0, 330, 28270, 28910, 28119, 57029
INVAR-69, Run: 054, F, 0, 0, 330, 4700, 12709, 4549, 17258
INVAR-69, Run: 055, F, 0, 0, 330, 20189, 27809, 20038, 47847
INVAR-69, Run: 056, F, 0, 330, 0, 7601, 3388, 7780, 11168
INVAR-69, Run: 057, F, 0, 330, 0, 15376, 7345, 15555, 22900
INVAR-69, Run: 058, F, 0, 0, 330, 14453, 17140, 14302, 31442
INVAR-69, Run: 059, F, 0, 330, 0, 8969, 2084, 9148, 11232
INVAR-69, Run: 060, F, 0, 0, 330, 21459, 25273, 21308, 46581
INVAR-69, Run: 061, F, 0, 0, 330, 9655, 31600, 9504, 41104
INVAR-69, Run: 062, F, 0, 0, 330, 4259, 10199, 4108, 14307
INVAR-69, Run: 063, F, 0, 0, 330, 26390, 40638, 26239, 66877
INVAR-69, Run: 064, F, 0, 330, 0, 13977, 9108, 14156, 23264
INVAR-69, Run: 065, F, 0, 330, 0, 17394, 6135, 17573, 23708
INVAR-69, Run: 066, F, 0, 330, 0, 5565, 1125, 5744, 6869
INVAR-69, Run: 067, F, 0, 0, 330, 5641, 16491, 5490, 21981
INVAR-69, Run: 068, F, 0, 330, 0, 28037, 52915, 28216, 81131
INVAR-69, Run: 069, F, 0, 0, 330, 9415, 25529, 9264, 34793
INVAR-69, Run: 070, F, 0, 330, 0, 3906, 2029, 4085, 6114
INVAR-69, Run: 071, F, 0, 0, 330, 36982, 50940, 36831, 87771
INVAR-69, Run: 072, F, 0, 0, 330, 25743, 61515, 25592, 87107
INVAR-69, Run: 073, F, 0, 330, 0, 35896, 51788, 36075, 87863
INVAR-69, Run: 074, F, 0, 330, 0, 8345, 2400, 8524, 10924
INVAR-69, Run: 075, F, 0, 0, 330, 22484, 46328, 22333, 68661
INVAR-69, Run: 076, F, 0, 330, 0, 7413, 3845, 7592, 11437
INVAR-69, Run: 077, F, 0, 0, 330, 4450, 14773, 4299, 19072
INVAR-69, Run: 078, F, 0, 0, 330, 11764, 17937, 11613, 29550
INVAR-69, Run: 079, F, 0, 0, 330, 23708, 31407, 23557, 54964
INVAR-69, Run: 080, F, 0, 0, 330, 18821, 25843, 18670, 44513
INVAR-69, Run: 081, F, 0, 0, 330, 2766, 10225, 2615, 12840
INVAR-69, Run: 082, F, 0, 0, 330, 11460, 23035, 11309, 34344
INVAR-69, Run: 083, F, 0, 330, 0, 14492, 7318, 14671, 21989
INVAR-69, Run: 084, F, 0, 0, 330, 7135, 24240, 6984, 31224
INVAR-69, Run: 085, F, 0, 0, 330, 7229, 26980, 7078, 34058
INVAR-69, Run: 086, F, 0, 330, 0, 50404, 21273, 50583, 71856
INVAR-69, Run: 087, F, 0, 330, 0, 9650, 3282, 9829, 13111
INVAR-69, Run: 088, F, 0, 330, 0, 20700, 5662, 20879, 26541
INVAR-69, Run: 089, F, 0, 0, 330, 7215, 37577, 7064, 44641
INVAR-69, Run: 090, F, 0, 330, 0, 3662, 695, 3841, 4536
INVAR-69, Run: 091, F, 0, 0, 330, 1502, 6361, 1351, 7712
INVAR-69, Run: 092, F, 0, 330, 0, 5210, 1389, 5389, 6778
INVAR-69, Run: 093, F, 0, 0, 330, 11910, 38424, 11759, 50183
INVAR-69, Run: 094, F, 0, 0, 330, 4900, 20747, 4749, 25496
INVAR-69, Run: 095, F, 0, 330, 0, 12964, 10422, 13143, 23565
INVAR-69, Run: 096, F, 0, 330, 0, 9348, 3751, 9527, 13278
INVAR-69, Run: 097, F, 0, 0, 330, 6198, 7762, 6047, 13809
INVAR-69, Run: 098, F, 0, 330, 0, 11044, 2631, 11223, 13854
INVAR-69, Run: 099, F, 0, 330, 0, 5627, 1748, 5806, 7554
INVAR-69, Run: 100, F, 0, 330, 0, 3973, 1306, 4152, 5458
INVAR-7, Run: 001, P, 0, 0, 10, 0, 0, 0, 0
INVAR-7, Run: 002, P, 0, 0, 10, 0, 0, 0, 0
INVAR-7, Run: 003, P, 0, 0, 10, 0, 0, 0, 0
INVAR-7, Run: 004, P, 0, 0, 10, 0, 0, 0, 0
INVAR-7, Run: 005, P, 0, 0, 10, 0, 0, 0, 0
INVAR-7, Run: 006, P, 0, 0, 10, 0, 0, 0, 0
INVAR-7, Run: 007, P, 0, 0, 10, 0, 0, 0, 0
INVAR-7, Run: 008, P, 0, 0, 10, 0, 0, 0, 0
INVAR-7, Run: 009, P, 0, 0, 10, 0, 0, 0, 0
INVAR-7, Run: 010, P, 0, 0, 10, 0, 0, 0, 0
INVAR-7, Run: 011, P, 0, 0, 10, 0, 0, 0, 0
INVAR-7, Run: 012, P, 0, 0, 10, 0, 0, 0, 0
INVAR-7, Run: 013, P, 0, 0, 10, 0, 0, 0, 0
INVAR-7, Run: 014, P, 0, 0, 10, 0, 0, 0, 0
INVAR-7, Run: 015, P, 0, 0, 10, 0, 0, 0, 0
INVAR-7, Run: 016, P, 0, 0, 10, 0, 0, 0, 0
INVAR-7, Run: 017, P, 0, 0, 10, 0, 0, 0, 0
INVAR-7, Run: 018, P, 0, 0, 10, 0, 0, 0, 0
INVAR-7, Run: 019, P, 0, 0, 10, 0, 0, 0, 0
INVAR-7, Run: 020, P, 0, 0, 10, 0, 0, 0, 0
INVAR-7, Run: 021, P, 0, 0, 10, 0, 0, 0, 0
INVAR-7, Run: 022, P, 0, 0, 10, 0, 0, 0, 0
INVAR-7, Run: 023, P, 0, 0, 10, 0, 0, 0, 0
INVAR-7, Run: 024, P, 0, 0, 10, 0, 0, 0, 0
INVAR-7, Run: 025, P, 0, 0, 10, 0, 0, 0, 0
INVAR-7, Run: 026, P, 0, 0, 10, 0, 0, 0, 0
INVAR-7, Run: 027, P, 0, 0, 10, 0, 0, 0, 0
INVAR-7, Run: 028, P, 0, 0, 10, 0, 0, 0, 0
INVAR-7, Run: 029, P, 0, 0, 10, 0, 0, 0, 0
INVAR-7, Run: 030, P, 0, 0, 10, 0, 0, 0, 0
INVAR-7, Run: 031, P, 0, 0, 10, 0, 0, 0, 0
INVAR-7, Run: 032, P, 0, 0, 10, 0, 0, 0, 0
INVAR-7, Run: 033, P, 0, 0, 10, 0, 0, 0, 0
INVAR-7, Run: 034, P, 0, 0, 10, 0, 0, 0, 0
INVAR-7, Run: 035, P, 0, 0, 10, 0, 0, 0, 0
INVAR-7, Run: 036, P, 0, 0, 10, 0, 0, 0, 0
INVAR-7, Run: 037, P, 0, 0, 10, 0, 0, 0, 0
INVAR-7, Run: 038, P, 0, 0, 10, 0, 0, 0, 0
INVAR-7, Run: 039, P, 0, 0, 10, 0, 0, 0, 0
INVAR-7, Run: 040, P, 0, 0, 10, 0, 0, 0, 0
INVAR-7, Run: 041, P, 0, 0, 10, 0, 0, 0, 0
INVAR-7, Run: 042, P, 0, 0, 10, 0, 0, 0, 0
INVAR-7, Run: 043, P, 0, 0, 10, 0, 0, 0, 0
INVAR-7, Run: 044, P, 0, 0, 10, 0, 0, 0, 0
INVAR-7, Run: 045, P, 0, 0, 10, 0, 0, 0, 0
INVAR-7, Run: 046, P, 0, 0, 10, 0, 0, 0, 0
INVAR-7, Run: 047, P, 0, 0, 10, 0, 0, 0, 0
INVAR-7, Run: 048, P, 0, 0, 10, 0, 0, 0, 0
INVAR-7, Run: 049, P, 0, 0, 10, 0, 0, 0, 0
INVAR-7, Run: 050, P, 0, 0, 10, 0, 0, 0, 0
INVAR-7, Run: 051, P, 0, 0, 10, 0, 0, 0, 0
INVAR-7, Run: 052, P, 0, 0, 10, 0, 0, 0, 0
INVAR-7, Run: 053, P, 0, 0, 10, 0, 0, 0, 0
INVAR-7, Run: 054, P, 0, 0, 10, 0, 0, 0, 0
INVAR-7, Run: 055, P, 0, 0, 10, 0, 0, 0, 0
INVAR-7, Run: 056, P, 0, 0, 10, 0, 0, 0, 0
INVAR-7, Run: 057, P, 0, 0, 10, 0, 0, 0, 0
INVAR-7, Run: 058, P, 0, 0, 10, 0, 0, 0, 0
INVAR-7, Run: 059, P, 0, 0, 10, 0, 0, 0, 0
INVAR-7, Run: 060, P, 0, 0, 10, 0, 0, 0, 0
INVAR-7, Run: 061, P, 0, 0, 10, 0, 0, 0, 0
INVAR-7, Run: 062, P, 0, 0, 10, 0, 0, 0, 0
INVAR-7, Run: 063, P, 0, 0, 10, 0, 0, 0, 0
INVAR-7, Run: 064, P, 0, 0, 10, 0, 0, 0, 0
INVAR-7, Run: 065, P, 0, 0, 10, 0, 0, 0, 0
INVAR-7, Run: 066, P, 0, 0, 10, 0, 0, 0, 0
INVAR-7, Run: 067, P, 0, 0, 10, 0, 0, 0, 0
INVAR-7, Run: 068, P, 0, 0, 10, 0, 0, 0, 0
INVAR-7, Run: 069, P, 0, 0, 10, 0, 0, 0, 0
INVAR-7, Run: 070, P, 0, 0, 10, 0, 0, 0, 0
INVAR-7, Run: 071, P, 0, 0, 10, 0, 0, 0, 0
INVAR-7, Run: 072, P, 0, 0, 10, 0, 0, 0, 0
INVAR-7, Run: 073, P, 0, 0, 10, 0, 0, 0, 0
INVAR-7, Run: 074, P, 0, 0, 10, 0, 0, 0, 0
INVAR-7, Run: 075, P, 0, 0, 10, 0, 0, 0, 0
INVAR-7, Run: 076, P, 0, 0, 10, 0, 0, 0, 0
INVAR-7, Run: 077, P, 0, 0, 10, 0, 0, 0, 0
INVAR-7, Run: 078, P, 0, 0, 10, 0, 0, 0, 0
INVAR-7, Run: 079, P, 0, 0, 10, 0, 0, 0, 0
INVAR-7, Run: 080, P, 0, 0, 10, 0, 0, 0, 0
INVAR-7, Run: 081, P, 0, 0, 10, 0, 0, 0, 0
INVAR-7, Run: 082, P, 0, 0, 10, 0, 0, 0, 0
INVAR-7, Run: 083, P, 0, 0, 10, 0, 0, 0, 0
INVAR-7, Run: 084, P, 0, 0, 10, 0, 0, 0, 0
INVAR-7, Run: 085, P, 0, 0, 10, 0, 0, 0, 0
INVAR-7, Run: 086, P, 0, 0, 10, 0, 0, 0, 0
INVAR-7, Run: 087, P, 0, 0, 10, 0, 0, 0, 0
INVAR-7, Run: 088, P, 0, 0, 10, 0, 0, 0, 0
INVAR-7, Run: 089, P, 0, 0, 10, 0, 0, 0, 0
INVAR-7, Run: 090, P, 0, 0, 10, 0, 0, 0, 0
INVAR-7, Run: 091, P, 0, 0, 10, 0, 0, 0, 0
INVAR-7, Run: 092, P, 0, 0, 10, 0, 0, 0, 0
INVAR-7, Run: 093, P, 0, 0, 10, 0, 0, 0, 0
INVAR-7, Run: 094, P, 0, 0, 10, 0, 0, 0, 0
INVAR-7, Run: 095, P, 0, 0, 10, 0, 0, 0, 0
INVAR-7, Run: 096, P, 0, 0, 10, 0, 0, 0, 0
INVAR-7, Run: 097, P, 0, 0, 10, 0, 0, 0, 0
INVAR-7, Run: 098, P, 0, 0, 10, 0, 0, 0, 0
INVAR-7, Run: 099, P, 0, 0, 10, 0, 0, 0, 0
INVAR-7, Run: 100, P, 0, 0, 10, 0, 0, 0, 0
INVAR-70, Run: 001, P, 0, 0, 35, 0, 0, 0, 0
INVAR-70, Run: 002, P, 0, 0, 35, 0, 0, 0, 0
INVAR-70, Run: 003, P, 0, 0, 35, 0, 0, 0, 0
INVAR-70, Run: 004, P, 0, 0, 35, 0, 0, 0, 0
INVAR-70, Run: 005, P, 0, 0, 35, 0, 0, 0, 0
INVAR-70, Run: 006, P, 0, 0, 35, 0, 0, 0, 0
INVAR-70, Run: 007, P, 0, 0, 35, 0, 0, 0, 0
INVAR-70, Run: 008, P, 0, 0, 35, 0, 0, 0, 0
INVAR-70, Run: 009, P, 0, 0, 35, 0, 0, 0, 0
INVAR-70, Run: 010, P, 0, 0, 35, 0, 0, 0, 0
INVAR-70, Run: 011, P, 0, 0, 35, 0, 0, 0, 0
INVAR-70, Run: 012, P, 0, 0, 35, 0, 0, 0, 0
INVAR-70, Run: 013, P, 0, 0, 35, 0, 0, 0, 0
INVAR-70, Run: 014, P, 0, 0, 35, 0, 0, 0, 0
INVAR-70, Run: 015, P, 0, 0, 35, 0, 0, 0, 0
INVAR-70, Run: 016, P, 0, 0, 35, 0, 0, 0, 0
INVAR-70, Run: 017, P, 0, 0, 35, 0, 0, 0, 0
INVAR-70, Run: 018, P, 0, 0, 35, 0, 0, 0, 0
INVAR-70, Run: 019, P, 0, 0, 35, 0, 0, 0, 0
INVAR-70, Run: 020, P, 0, 0, 35, 0, 0, 0, 0
INVAR-70, Run: 021, P, 0, 0, 35, 0, 0, 0, 0
INVAR-70, Run: 022, P, 0, 0, 35, 0, 0, 0, 0
INVAR-70, Run: 023, P, 0, 0, 35, 0, 0, 0, 0
INVAR-70, Run: 024, P, 0, 0, 35, 0, 0, 0, 0
INVAR-70, Run: 025, P, 0, 0, 35, 0, 0, 0, 0
INVAR-70, Run: 026, P, 0, 0, 35, 0, 0, 0, 0
INVAR-70, Run: 027, P, 0, 0, 35, 0, 0, 0, 0
INVAR-70, Run: 028, P, 0, 0, 35, 0, 0, 0, 0
INVAR-70, Run: 029, P, 0, 0, 35, 0, 0, 0, 0
INVAR-70, Run: 030, P, 0, 0, 35, 0, 0, 0, 0
INVAR-70, Run: 031, P, 0, 0, 35, 0, 0, 0, 0
INVAR-70, Run: 032, P, 0, 0, 35, 0, 0, 0, 0
INVAR-70, Run: 033, P, 0, 0, 35, 0, 0, 0, 0
INVAR-70, Run: 034, P, 0, 0, 35, 0, 0, 0, 0
INVAR-70, Run: 035, P, 0, 0, 35, 0, 0, 0, 0
INVAR-70, Run: 036, P, 0, 0, 35, 0, 0, 0, 0
INVAR-70, Run: 037, P, 0, 0, 35, 0, 0, 0, 0
INVAR-70, Run: 038, P, 0, 0, 35, 0, 0, 0, 0
INVAR-70, Run: 039, P, 0, 0, 35, 0, 0, 0, 0
INVAR-70, Run: 040, P, 0, 0, 35, 0, 0, 0, 0
INVAR-70, Run: 041, P, 0, 0, 35, 0, 0, 0, 0
INVAR-70, Run: 042, P, 0, 0, 35, 0, 0, 0, 0
INVAR-70, Run: 043, P, 0, 0, 35, 0, 0, 0, 0
INVAR-70, Run: 044, P, 0, 0, 35, 0, 0, 0, 0
INVAR-70, Run: 045, P, 0, 0, 35, 0, 0, 0, 0
INVAR-70, Run: 046, P, 0, 0, 35, 0, 0, 0, 0
INVAR-70, Run: 047, P, 0, 0, 35, 0, 0, 0, 0
INVAR-70, Run: 048, P, 0, 0, 35, 0, 0, 0, 0
INVAR-70, Run: 049, P, 0, 0, 35, 0, 0, 0, 0
INVAR-70, Run: 050, P, 0, 0, 35, 0, 0, 0, 0
INVAR-70, Run: 051, P, 0, 0, 35, 0, 0, 0, 0
INVAR-70, Run: 052, P, 0, 0, 35, 0, 0, 0, 0
INVAR-70, Run: 053, P, 0, 0, 35, 0, 0, 0, 0
INVAR-70, Run: 054, P, 0, 0, 35, 0, 0, 0, 0
INVAR-70, Run: 055, P, 0, 0, 35, 0, 0, 0, 0
INVAR-70, Run: 056, P, 0, 0, 35, 0, 0, 0, 0
INVAR-70, Run: 057, P, 0, 0, 35, 0, 0, 0, 0
INVAR-70, Run: 058, P, 0, 0, 35, 0, 0, 0, 0
INVAR-70, Run: 059, P, 0, 0, 35, 0, 0, 0, 0
INVAR-70, Run: 060, P, 0, 0, 35, 0, 0, 0, 0
INVAR-70, Run: 061, P, 0, 0, 35, 0, 0, 0, 0
INVAR-70, Run: 062, P, 0, 0, 35, 0, 0, 0, 0
INVAR-70, Run: 063, P, 0, 0, 35, 0, 0, 0, 0
INVAR-70, Run: 064, P, 0, 0, 35, 0, 0, 0, 0
INVAR-70, Run: 065, P, 0, 0, 35, 0, 0, 0, 0
INVAR-70, Run: 066, P, 0, 0, 35, 0, 0, 0, 0
INVAR-70, Run: 067, P, 0, 0, 35, 0, 0, 0, 0
INVAR-70, Run: 068, P, 0, 0, 35, 0, 0, 0, 0
INVAR-70, Run: 069, P, 0, 0, 35, 0, 0, 0, 0
INVAR-70, Run: 070, P, 0, 0, 35, 0, 0, 0, 0
INVAR-70, Run: 071, P, 0, 0, 35, 0, 0, 0, 0
INVAR-70, Run: 072, P, 0, 0, 35, 0, 0, 0, 0
INVAR-70, Run: 073, P, 0, 0, 35, 0, 0, 0, 0
INVAR-70, Run: 074, P, 0, 0, 35, 0, 0, 0, 0
INVAR-70, Run: 075, P, 0, 0, 35, 0, 0, 0, 0
INVAR-70, Run: 076, P, 0, 0, 35, 0, 0, 0, 0
INVAR-70, Run: 077, P, 0, 0, 35, 0, 0, 0, 0
INVAR-70, Run: 078, P, 0, 0, 35, 0, 0, 0, 0
INVAR-70, Run: 079, P, 0, 0, 35, 0, 0, 0, 0
INVAR-70, Run: 080, P, 0, 0, 35, 0, 0, 0, 0
INVAR-70, Run: 081, P, 0, 0, 35, 0, 0, 0, 0
INVAR-70, Run: 082, P, 0, 0, 35, 0, 0, 0, 0
INVAR-70, Run: 083, P, 0, 0, 35, 0, 0, 0, 0
INVAR-70, Run: 084, P, 0, 0, 35, 0, 0, 0, 0
INVAR-70, Run: 085, P, 0, 0, 35, 0, 0, 0, 0
INVAR-70, Run: 086, P, 0, 0, 35, 0, 0, 0, 0
INVAR-70, Run: 087, P, 0, 0, 35, 0, 0, 0, 0
INVAR-70, Run: 088, P, 0, 0, 35, 0, 0, 0, 0
INVAR-70, Run: 089, P, 0, 0, 35, 0, 0, 0, 0
INVAR-70, Run: 090, P, 0, 0, 35, 0, 0, 0, 0
INVAR-70, Run: 091, P, 0, 0, 35, 0, 0, 0, 0
INVAR-70, Run: 092, P, 0, 0, 35, 0, 0, 0, 0
INVAR-70, Run: 093, P, 0, 0, 35, 0, 0, 0, 0
INVAR-70, Run: 094, P, 0, 0, 35, 0, 0, 0, 0
INVAR-70, Run: 095, P, 0, 0, 35, 0, 0, 0, 0
INVAR-70, Run: 096, P, 0, 0, 35, 0, 0, 0, 0
INVAR-70, Run: 097, P, 0, 0, 35, 0, 0, 0, 0
INVAR-70, Run: 098, P, 0, 0, 35, 0, 0, 0, 0
INVAR-70, Run: 099, P, 0, 0, 35, 0, 0, 0, 0
INVAR-70, Run: 100, P, 0, 0, 35, 0, 0, 0, 0
INVAR-71, Run: 001, P, 0, 0, 89, 0, 0, 0, 0
INVAR-71, Run: 002, P, 0, 0, 89, 0, 0, 0, 0
INVAR-71, Run: 003, P, 0, 0, 89, 0, 0, 0, 0
INVAR-71, Run: 004, P, 0, 0, 89, 0, 0, 0, 0
INVAR-71, Run: 005, P, 0, 0, 89, 0, 0, 0, 0
INVAR-71, Run: 006, P, 0, 0, 89, 0, 0, 0, 0
INVAR-71, Run: 007, P, 0, 0, 89, 0, 0, 0, 0
INVAR-71, Run: 008, P, 0, 0, 89, 0, 0, 0, 0
INVAR-71, Run: 009, P, 0, 0, 89, 0, 0, 0, 0
INVAR-71, Run: 010, P, 0, 0, 89, 0, 0, 0, 0
INVAR-71, Run: 011, P, 0, 0, 89, 0, 0, 0, 0
INVAR-71, Run: 012, P, 0, 0, 89, 0, 0, 0, 0
INVAR-71, Run: 013, P, 0, 0, 89, 0, 0, 0, 0
INVAR-71, Run: 014, P, 0, 0, 89, 0, 0, 0, 0
INVAR-71, Run: 015, P, 0, 0, 89, 0, 0, 0, 0
INVAR-71, Run: 016, P, 0, 0, 89, 0, 0, 0, 0
INVAR-71, Run: 017, P, 0, 0, 89, 0, 0, 0, 0
INVAR-71, Run: 018, P, 0, 0, 89, 0, 0, 0, 0
INVAR-71, Run: 019, P, 0, 0, 89, 0, 0, 0, 0
INVAR-71, Run: 020, P, 0, 0, 89, 0, 0, 0, 0
INVAR-71, Run: 021, P, 0, 0, 89, 0, 0, 0, 0
INVAR-71, Run: 022, P, 0, 0, 89, 0, 0, 0, 0
INVAR-71, Run: 023, P, 0, 0, 89, 0, 0, 0, 0
INVAR-71, Run: 024, P, 0, 0, 89, 0, 0, 0, 0
INVAR-71, Run: 025, P, 0, 0, 89, 0, 0, 0, 0
INVAR-71, Run: 026, P, 0, 0, 89, 0, 0, 0, 0
INVAR-71, Run: 027, P, 0, 0, 89, 0, 0, 0, 0
INVAR-71, Run: 028, P, 0, 0, 89, 0, 0, 0, 0
INVAR-71, Run: 029, P, 0, 0, 89, 0, 0, 0, 0
INVAR-71, Run: 030, P, 0, 0, 89, 0, 0, 0, 0
INVAR-71, Run: 031, P, 0, 0, 89, 0, 0, 0, 0
INVAR-71, Run: 032, P, 0, 0, 89, 0, 0, 0, 0
INVAR-71, Run: 033, P, 0, 0, 89, 0, 0, 0, 0
INVAR-71, Run: 034, P, 0, 0, 89, 0, 0, 0, 0
INVAR-71, Run: 035, P, 0, 0, 89, 0, 0, 0, 0
INVAR-71, Run: 036, P, 0, 0, 89, 0, 0, 0, 0
INVAR-71, Run: 037, P, 0, 0, 89, 0, 0, 0, 0
INVAR-71, Run: 038, P, 0, 0, 89, 0, 0, 0, 0
INVAR-71, Run: 039, P, 0, 0, 89, 0, 0, 0, 0
INVAR-71, Run: 040, P, 0, 0, 89, 0, 0, 0, 0
INVAR-71, Run: 041, P, 0, 0, 89, 0, 0, 0, 0
INVAR-71, Run: 042, P, 0, 0, 89, 0, 0, 0, 0
INVAR-71, Run: 043, P, 0, 0, 89, 0, 0, 0, 0
INVAR-71, Run: 044, P, 0, 0, 89, 0, 0, 0, 0
INVAR-71, Run: 045, P, 0, 0, 89, 0, 0, 0, 0
INVAR-71, Run: 046, P, 0, 0, 89, 0, 0, 0, 0
INVAR-71, Run: 047, P, 0, 0, 89, 0, 0, 0, 0
INVAR-71, Run: 048, P, 0, 0, 89, 0, 0, 0, 0
INVAR-71, Run: 049, P, 0, 0, 89, 0, 0, 0, 0
INVAR-71, Run: 050, P, 0, 0, 89, 0, 0, 0, 0
INVAR-71, Run: 051, P, 0, 0, 89, 0, 0, 0, 0
INVAR-71, Run: 052, P, 0, 0, 89, 0, 0, 0, 0
INVAR-71, Run: 053, P, 0, 0, 89, 0, 0, 0, 0
INVAR-71, Run: 054, P, 0, 0, 89, 0, 0, 0, 0
INVAR-71, Run: 055, P, 0, 0, 89, 0, 0, 0, 0
INVAR-71, Run: 056, P, 0, 0, 89, 0, 0, 0, 0
INVAR-71, Run: 057, P, 0, 0, 89, 0, 0, 0, 0
INVAR-71, Run: 058, P, 0, 0, 89, 0, 0, 0, 0
INVAR-71, Run: 059, P, 0, 0, 89, 0, 0, 0, 0
INVAR-71, Run: 060, P, 0, 0, 89, 0, 0, 0, 0
INVAR-71, Run: 061, P, 0, 0, 89, 0, 0, 0, 0
INVAR-71, Run: 062, P, 0, 0, 89, 0, 0, 0, 0
INVAR-71, Run: 063, P, 0, 0, 89, 0, 0, 0, 0
INVAR-71, Run: 064, P, 0, 0, 89, 0, 0, 0, 0
INVAR-71, Run: 065, P, 0, 0, 89, 0, 0, 0, 0
INVAR-71, Run: 066, P, 0, 0, 89, 0, 0, 0, 0
INVAR-71, Run: 067, P, 0, 0, 89, 0, 0, 0, 0
INVAR-71, Run: 068, P, 0, 0, 89, 0, 0, 0, 0
INVAR-71, Run: 069, P, 0, 0, 89, 0, 0, 0, 0
INVAR-71, Run: 070, P, 0, 0, 89, 0, 0, 0, 0
INVAR-71, Run: 071, P, 0, 0, 89, 0, 0, 0, 0
INVAR-71, Run: 072, P, 0, 0, 89, 0, 0, 0, 0
INVAR-71, Run: 073, P, 0, 0, 89, 0, 0, 0, 0
INVAR-71, Run: 074, P, 0, 0, 89, 0, 0, 0, 0
INVAR-71, Run: 075, P, 0, 0, 89, 0, 0, 0, 0
INVAR-71, Run: 076, P, 0, 0, 89, 0, 0, 0, 0
INVAR-71, Run: 077, P, 0, 0, 89, 0, 0, 0, 0
INVAR-71, Run: 078, P, 0, 0, 89, 0, 0, 0, 0
INVAR-71, Run: 079, P, 0, 0, 89, 0, 0, 0, 0
INVAR-71, Run: 080, P, 0, 0, 89, 0, 0, 0, 0
INVAR-71, Run: 081, P, 0, 0, 89, 0, 0, 0, 0
INVAR-71, Run: 082, P, 0, 0, 89, 0, 0, 0, 0
INVAR-71, Run: 083, P, 0, 0, 89, 0, 0, 0, 0
INVAR-71, Run: 084, P, 0, 0, 89, 0, 0, 0, 0
INVAR-71, Run: 085, P, 0, 0, 89, 0, 0, 0, 0
INVAR-71, Run: 086, P, 0, 0, 89, 0, 0, 0, 0
INVAR-71, Run: 087, P, 0, 0, 89, 0, 0, 0, 0
INVAR-71, Run: 088, P, 0, 0, 89, 0, 0, 0, 0
INVAR-71, Run: 089, P, 0, 0, 89, 0, 0, 0, 0
INVAR-71, Run: 090, P, 0, 0, 89, 0, 0, 0, 0
INVAR-71, Run: 091, P, 0, 0, 89, 0, 0, 0, 0
INVAR-71, Run: 092, P, 0, 0, 89, 0, 0, 0, 0
INVAR-71, Run: 093, P, 0, 0, 89, 0, 0, 0, 0
INVAR-71, Run: 094, P, 0, 0, 89, 0, 0, 0, 0
INVAR-71, Run: 095, P, 0, 0, 89, 0, 0, 0, 0
INVAR-71, Run: 096, P, 0, 0, 89, 0, 0, 0, 0
INVAR-71, Run: 097, P, 0, 0, 89, 0, 0, 0, 0
INVAR-71, Run: 098, P, 0, 0, 89, 0, 0, 0, 0
INVAR-71, Run: 099, P, 0, 0, 89, 0, 0, 0, 0
INVAR-71, Run: 100, P, 0, 0, 89, 0, 0, 0, 0
INVAR-72, Run: 001, P, 0, 0, 193, 0, 0, 0, 0
INVAR-72, Run: 002, P, 0, 0, 193, 0, 0, 0, 0
INVAR-72, Run: 003, P, 0, 0, 193, 0, 0, 0, 0
INVAR-72, Run: 004, P, 0, 0, 193, 0, 0, 0, 0
INVAR-72, Run: 005, P, 0, 0, 193, 0, 0, 0, 0
INVAR-72, Run: 006, P, 0, 0, 193, 0, 0, 0, 0
INVAR-72, Run: 007, P, 0, 0, 193, 0, 0, 0, 0
INVAR-72, Run: 008, P, 0, 0, 193, 0, 0, 0, 0
INVAR-72, Run: 009, P, 0, 0, 193, 0, 0, 0, 0
INVAR-72, Run: 010, P, 0, 0, 193, 0, 0, 0, 0
INVAR-72, Run: 011, P, 0, 0, 193, 0, 0, 0, 0
INVAR-72, Run: 012, P, 0, 0, 193, 0, 0, 0, 0
INVAR-72, Run: 013, P, 0, 0, 193, 0, 0, 0, 0
INVAR-72, Run: 014, P, 0, 0, 193, 0, 0, 0, 0
INVAR-72, Run: 015, P, 0, 0, 193, 0, 0, 0, 0
INVAR-72, Run: 016, P, 0, 0, 193, 0, 0, 0, 0
INVAR-72, Run: 017, P, 0, 0, 193, 0, 0, 0, 0
INVAR-72, Run: 018, P, 0, 0, 193, 0, 0, 0, 0
INVAR-72, Run: 019, P, 0, 0, 193, 0, 0, 0, 0
INVAR-72, Run: 020, P, 0, 0, 193, 0, 0, 0, 0
INVAR-72, Run: 021, P, 0, 0, 193, 0, 0, 0, 0
INVAR-72, Run: 022, P, 0, 0, 193, 0, 0, 0, 0
INVAR-72, Run: 023, P, 0, 0, 193, 0, 0, 0, 0
INVAR-72, Run: 024, P, 0, 0, 193, 0, 0, 0, 0
INVAR-72, Run: 025, P, 0, 0, 193, 0, 0, 0, 0
INVAR-72, Run: 026, P, 0, 0, 193, 0, 0, 0, 0
INVAR-72, Run: 027, P, 0, 0, 193, 0, 0, 0, 0
INVAR-72, Run: 028, P, 0, 0, 193, 0, 0, 0, 0
INVAR-72, Run: 029, P, 0, 0, 193, 0, 0, 0, 0
INVAR-72, Run: 030, P, 0, 0, 193, 0, 0, 0, 0
INVAR-72, Run: 031, P, 0, 0, 193, 0, 0, 0, 0
INVAR-72, Run: 032, P, 0, 0, 193, 0, 0, 0, 0
INVAR-72, Run: 033, P, 0, 0, 193, 0, 0, 0, 0
INVAR-72, Run: 034, P, 0, 0, 193, 0, 0, 0, 0
INVAR-72, Run: 035, P, 0, 0, 193, 0, 0, 0, 0
INVAR-72, Run: 036, P, 0, 0, 193, 0, 0, 0, 0
INVAR-72, Run: 037, P, 0, 0, 193, 0, 0, 0, 0
INVAR-72, Run: 038, P, 0, 0, 193, 0, 0, 0, 0
INVAR-72, Run: 039, P, 0, 0, 193, 0, 0, 0, 0
INVAR-72, Run: 040, P, 0, 0, 193, 0, 0, 0, 0
INVAR-72, Run: 041, P, 0, 0, 193, 0, 0, 0, 0
INVAR-72, Run: 042, P, 0, 0, 193, 0, 0, 0, 0
INVAR-72, Run: 043, P, 0, 0, 193, 0, 0, 0, 0
INVAR-72, Run: 044, P, 0, 0, 193, 0, 0, 0, 0
INVAR-72, Run: 045, P, 0, 0, 193, 0, 0, 0, 0
INVAR-72, Run: 046, P, 0, 0, 193, 0, 0, 0, 0
INVAR-72, Run: 047, P, 0, 0, 193, 0, 0, 0, 0
INVAR-72, Run: 048, P, 0, 0, 193, 0, 0, 0, 0
INVAR-72, Run: 049, P, 0, 0, 193, 0, 0, 0, 0
INVAR-72, Run: 050, P, 0, 0, 193, 0, 0, 0, 0
INVAR-72, Run: 051, P, 0, 0, 193, 0, 0, 0, 0
INVAR-72, Run: 052, P, 0, 0, 193, 0, 0, 0, 0
INVAR-72, Run: 053, P, 0, 0, 193, 0, 0, 0, 0
INVAR-72, Run: 054, P, 0, 0, 193, 0, 0, 0, 0
INVAR-72, Run: 055, P, 0, 0, 193, 0, 0, 0, 0
INVAR-72, Run: 056, P, 0, 0, 193, 0, 0, 0, 0
INVAR-72, Run: 057, P, 0, 0, 193, 0, 0, 0, 0
INVAR-72, Run: 058, P, 0, 0, 193, 0, 0, 0, 0
INVAR-72, Run: 059, P, 0, 0, 193, 0, 0, 0, 0
INVAR-72, Run: 060, P, 0, 0, 193, 0, 0, 0, 0
INVAR-72, Run: 061, P, 0, 0, 193, 0, 0, 0, 0
INVAR-72, Run: 062, P, 0, 0, 193, 0, 0, 0, 0
INVAR-72, Run: 063, P, 0, 0, 193, 0, 0, 0, 0
INVAR-72, Run: 064, P, 0, 0, 193, 0, 0, 0, 0
INVAR-72, Run: 065, P, 0, 0, 193, 0, 0, 0, 0
INVAR-72, Run: 066, P, 0, 0, 193, 0, 0, 0, 0
INVAR-72, Run: 067, P, 0, 0, 193, 0, 0, 0, 0
INVAR-72, Run: 068, P, 0, 0, 193, 0, 0, 0, 0
INVAR-72, Run: 069, P, 0, 0, 193, 0, 0, 0, 0
INVAR-72, Run: 070, P, 0, 0, 193, 0, 0, 0, 0
INVAR-72, Run: 071, P, 0, 0, 193, 0, 0, 0, 0
INVAR-72, Run: 072, P, 0, 0, 193, 0, 0, 0, 0
INVAR-72, Run: 073, P, 0, 0, 193, 0, 0, 0, 0
INVAR-72, Run: 074, P, 0, 0, 193, 0, 0, 0, 0
INVAR-72, Run: 075, P, 0, 0, 193, 0, 0, 0, 0
INVAR-72, Run: 076, P, 0, 0, 193, 0, 0, 0, 0
INVAR-72, Run: 077, P, 0, 0, 193, 0, 0, 0, 0
INVAR-72, Run: 078, P, 0, 0, 193, 0, 0, 0, 0
INVAR-72, Run: 079, P, 0, 0, 193, 0, 0, 0, 0
INVAR-72, Run: 080, P, 0, 0, 193, 0, 0, 0, 0
INVAR-72, Run: 081, P, 0, 0, 193, 0, 0, 0, 0
INVAR-72, Run: 082, P, 0, 0, 193, 0, 0, 0, 0
INVAR-72, Run: 083, P, 0, 0, 193, 0, 0, 0, 0
INVAR-72, Run: 084, P, 0, 0, 193, 0, 0, 0, 0
INVAR-72, Run: 085, P, 0, 0, 193, 0, 0, 0, 0
INVAR-72, Run: 086, P, 0, 0, 193, 0, 0, 0, 0
INVAR-72, Run: 087, P, 0, 0, 193, 0, 0, 0, 0
INVAR-72, Run: 088, P, 0, 0, 193, 0, 0, 0, 0
INVAR-72, Run: 089, P, 0, 0, 193, 0, 0, 0, 0
INVAR-72, Run: 090, P, 0, 0, 193, 0, 0, 0, 0
INVAR-72, Run: 091, P, 0, 0, 193, 0, 0, 0, 0
INVAR-72, Run: 092, P, 0, 0, 193, 0, 0, 0, 0
INVAR-72, Run: 093, P, 0, 0, 193, 0, 0, 0, 0
INVAR-72, Run: 094, P, 0, 0, 193, 0, 0, 0, 0
INVAR-72, Run: 095, P, 0, 0, 193, 0, 0, 0, 0
INVAR-72, Run: 096, P, 0, 0, 193, 0, 0, 0, 0
INVAR-72, Run: 097, P, 0, 0, 193, 0, 0, 0, 0
INVAR-72, Run: 098, P, 0, 0, 193, 0, 0, 0, 0
INVAR-72, Run: 099, P, 0, 0, 193, 0, 0, 0, 0
INVAR-72, Run: 100, P, 0, 0, 193, 0, 0, 0, 0
INVAR-73, Run: 001, F, 0, 0, 58, 269, 808, 261, 1069
INVAR-73, Run: 002, F, 0, 58, 0, 635, 1023, 685, 1708
INVAR-73, Run: 003, F, 0, 0, 58, 60, 328, 52, 380
INVAR-73, Run: 004, F, 0, 0, 58, 51, 631, 43, 674
INVAR-73, Run: 005, F, 0, 0, 58, 29, 295, 21, 316
INVAR-73, Run: 006, F, 0, 0, 58, 12, 110, 4, 114
INVAR-73, Run: 007, F, 0, 58, 0, 950, 1271, 1000, 2271
INVAR-73, Run: 008, F, 0, 58, 0, 156, 165, 206, 371
INVAR-73, Run: 009, F, 0, 0, 58, 30, 305, 22, 327
INVAR-73, Run: 010, F, 0, 0, 58, 50, 689, 42, 731
INVAR-73, Run: 011, F, 0, 58, 0, 340, 221, 390, 611
INVAR-73, Run: 012, F, 0, 0, 58, 26, 280, 18, 298
INVAR-73, Run: 013, F, 0, 0, 58, 56, 356, 48, 404
INVAR-73, Run: 014, F, 0, 0, 58, 89, 447, 81, 528
INVAR-73, Run: 015, F, 0, 0, 58, 101, 1087, 93, 1180
INVAR-73, Run: 016, F, 0, 0, 58, 116, 654, 108, 762
INVAR-73, Run: 017, F, 0, 0, 58, 38, 319, 30, 349
INVAR-73, Run: 018, F, 0, 58, 0, 151, 269, 201, 470
INVAR-73, Run: 019, F, 0, 58, 0, 468, 406, 518, 924
INVAR-73, Run: 020, F, 0, 0, 58, 177, 974, 169, 1143
INVAR-73, Run: 021, F, 0, 0, 58, 18, 200, 10, 210
INVAR-73, Run: 022, F, 0, 0, 58, 34, 441, 26, 467
INVAR-73, Run: 023, F, 0, 0, 58, 339, 1538, 331, 1869
INVAR-73, Run: 024, F, 0, 0, 58, 9, 112, 1, 113
INVAR-73, Run: 025, F, 0, 0, 58, 17, 130, 9, 139
INVAR-73, Run: 026, F, 0, 0, 58, 46, 131, 38, 169
INVAR-73, Run: 027, F, 0, 58, 0, 232, 218, 282, 500
INVAR-73, Run: 028, F, 0, 0, 58, 120, 976, 112, 1088
INVAR-73, Run: 029, F, 0, 0, 58, 32, 315, 24, 339
INVAR-73, Run: 030, F, 0, 0, 58, 27, 143, 19, 162
INVAR-73, Run: 031, F, 0, 0, 58, 31, 288, 23, 311
INVAR-73, Run: 032, F, 0, 0, 58, 26, 184, 18, 202
INVAR-73, Run: 033, F, 0, 0, 58, 57, 581, 49, 630
INVAR-73, Run: 034, F, 0, 0, 58, 35, 370, 27, 397
INVAR-73, Run: 035, F, 0, 58, 0, 958, 1842, 1008, 2850
INVAR-73, Run: 036, F, 0, 0, 58, 10, 114, 2, 116
INVAR-73, Run: 037, F, 0, 0, 58, 207, 579, 199, 778
INVAR-73, Run: 038, F, 0, 0, 58, 101, 578, 93, 671
INVAR-73, Run: 039, F, 0, 0, 58, 19, 201, 11, 212
INVAR-73, Run: 040, F, 0, 0, 58, 33, 394, 25, 419
INVAR-73, Run: 041, F, 0, 58, 0, 672, 449, 722, 1171
INVAR-73, Run: 042, F, 0, 0, 58, 157, 723, 149, 872
INVAR-73, Run: 043, F, 0, 0, 58, 28, 246, 20, 266
INVAR-73, Run: 044, F, 0, 0, 58, 82, 785, 74, 859
INVAR-73, Run: 045, F, 0, 0, 58, 79, 474, 71, 545
INVAR-73, Run: 046, F, 0, 0, 58, 74, 528, 66, 594
INVAR-73, Run: 047, F, 0, 0, 58, 74, 399, 66, 465
INVAR-73, Run: 048, F, 0, 0, 58, 1129, 1281, 1121, 2402
INVAR-73, Run: 049, F, 0, 0, 58, 30, 348, 22, 370
INVAR-73, Run: 050, F, 0, 0, 58, 143, 418, 135, 553
INVAR-73, Run: 051, F, 0, 0, 58, 27, 238, 19, 257
INVAR-73, Run: 052, F, 0, 0, 58, 49, 300, 41, 341
INVAR-73, Run: 053, F, 0, 0, 58, 61, 477, 53, 530
INVAR-73, Run: 054, F, 0, 0, 58, 33, 174, 25, 199
INVAR-73, Run: 055, F, 0, 0, 58, 82, 560, 74, 634
INVAR-73, Run: 056, F, 0, 0, 58, 1450, 2467, 1442, 3909
INVAR-73, Run: 057, F, 0, 0, 58, 31, 383, 23, 406
INVAR-73, Run: 058, F, 0, 0, 58, 64, 498, 56, 554
INVAR-73, Run: 059, F, 0, 0, 58, 255, 509, 247, 756
INVAR-73, Run: 060, F, 0, 0, 58, 490, 1047, 482, 1529
INVAR-73, Run: 061, F, 0, 0, 58, 125, 881, 117, 998
INVAR-73, Run: 062, F, 0, 0, 58, 104, 824, 96, 920
INVAR-73, Run: 063, F, 0, 0, 58, 290, 818, 282, 1100
INVAR-73, Run: 064, F, 0, 0, 58, 13, 110, 5, 115
INVAR-73, Run: 065, F, 0, 0, 58, 165, 527, 157, 684
INVAR-73, Run: 066, F, 0, 0, 58, 15, 197, 7, 204
INVAR-73, Run: 067, F, 0, 0, 58, 259, 899, 251, 1150
INVAR-73, Run: 068, F, 0, 0, 58, 2644, 3238, 2636, 5874
INVAR-73, Run: 069, F, 0, 0, 58, 8, 85, 0, 85
INVAR-73, Run: 070, F, 0, 0, 58, 10, 95, 2, 97
INVAR-73, Run: 071, F, 0, 0, 58, 10, 150, 2, 152
INVAR-73, Run: 072, F, 0, 0, 58, 45, 374, 37, 411
INVAR-73, Run: 073, F, 0, 0, 58, 184, 908, 176, 1084
INVAR-73, Run: 074, F, 0, 58, 0, 353, 857, 403, 1260
INVAR-73, Run: 075, F, 0, 0, 58, 64, 416, 56, 472
INVAR-73, Run: 076, F, 0, 0, 58, 471, 812, 463, 1275
INVAR-73, Run: 077, F, 0, 0, 58, 84, 627, 76, 703
INVAR-73, Run: 078, F, 0, 0, 58, 56, 541, 48, 589
INVAR-73, Run: 079, F, 0, 0, 58, 285, 842, 277, 1119
INVAR-73, Run: 080, F, 0, 0, 58, 60, 221, 52, 273
INVAR-73, Run: 081, F, 0, 0, 58, 625, 852, 617, 1469
INVAR-73, Run: 082, F, 0, 0, 58, 14, 101, 6, 107
INVAR-73, Run: 083, F, 0, 0, 58, 19, 217, 11, 228
INVAR-73, Run: 084, F, 0, 58, 0, 147, 333, 197, 530
INVAR-73, Run: 085, F, 0, 0, 58, 18, 288, 10, 298
INVAR-73, Run: 086, F, 0, 0, 58, 11, 158, 3, 161
INVAR-73, Run: 087, F, 0, 0, 58, 60, 488, 52, 540
INVAR-73, Run: 088, F, 0, 58, 0, 555, 900, 605, 1505
INVAR-73, Run: 089, F, 0, 0, 58, 20, 171, 12, 183
INVAR-73, Run: 090, F, 0, 0, 58, 83, 960, 75, 1035
INVAR-73, Run: 091, F, 0, 0, 58, 57, 285, 49, 334
INVAR-73, Run: 092, F, 0, 0, 58, 49, 361, 41, 402
INVAR-73, Run: 093, F, 0, 0, 58, 22, 260, 14, 274
INVAR-73, Run: 094, F, 0, 0, 58, 25, 265, 17, 282
INVAR-73, Run: 095, F, 0, 58, 0, 437, 683, 487, 1170
INVAR-73, Run: 096, F, 0, 0, 58, 13, 126, 5, 131
INVAR-73, Run: 097, F, 0, 0, 58, 42, 248, 34, 282
INVAR-73, Run: 098, F, 0, 0, 58, 15, 264, 7, 271
INVAR-73, Run: 099, F, 0, 0, 58, 53, 323, 45, 368
INVAR-73, Run: 100, F, 0, 0, 58, 48, 405, 40, 445
INVAR-74, Run: 001, F, 0, 0, 126, 2913, 8896, 2887, 11783
INVAR-74, Run: 002, F, 0, 0, 126, 74, 361, 48, 409
INVAR-74, Run: 003, F, 0, 0, 126, 1799, 3763, 1773, 5536
INVAR-74, Run: 004, F, 0, 126, 0, 1484, 3424, 1584, 5008
INVAR-74, Run: 005, F, 0, 0, 126, 2837, 6100, 2811, 8911
INVAR-74, Run: 006, F, 0, 0, 126, 5879, 12165, 5853, 18018
INVAR-74, Run: 007, F, 0, 0, 126, 115, 789, 89, 878
INVAR-74, Run: 008, F, 0, 0, 126, 439, 1835, 413, 2248
INVAR-74, Run: 009, F, 0, 0, 126, 101, 1408, 75, 1483
INVAR-74, Run: 010, F, 0, 0, 126, 3214, 6979, 3188, 10167
INVAR-74, Run: 011, F, 0, 126, 0, 1823, 1689, 1923, 3612
INVAR-74, Run: 012, F, 0, 0, 126, 100, 1601, 74, 1675
INVAR-74, Run: 013, F, 0, 0, 126, 409, 3135, 383, 3518
INVAR-74, Run: 014, F, 0, 0, 126, 1265, 2642, 1239, 3881
INVAR-74, Run: 015, F, 0, 0, 126, 259, 2609, 233, 2842
INVAR-74, Run: 016, F, 0, 126, 0, 1805, 1253, 1905, 3158
INVAR-74, Run: 017, F, 0, 0, 126, 124, 980, 98, 1078
INVAR-74, Run: 018, F, 0, 0, 126, 238, 1272, 212, 1484
INVAR-74, Run: 019, F, 0, 0, 126, 1297, 3922, 1271, 5193
INVAR-74, Run: 020, F, 0, 0, 126, 530, 3416, 504, 3920
INVAR-74, Run: 021, F, 0, 0, 126, 142, 783, 116, 899
INVAR-74, Run: 022, F, 0, 0, 126, 55, 555, 29, 584
INVAR-74, Run: 023, F, 0, 0, 126, 3057, 7043, 3031, 10074
INVAR-74, Run: 024, F, 0, 0, 126, 149, 1203, 123, 1326
INVAR-74, Run: 025, F, 0, 126, 0, 1815, 722, 1915, 2637
INVAR-74, Run: 026, F, 0, 0, 126, 603, 2177, 577, 2754
INVAR-74, Run: 027, F, 0, 0, 126, 113, 1285, 87, 1372
INVAR-74, Run: 028, F, 0, 0, 126, 138, 1225, 112, 1337
INVAR-74, Run: 029, F, 0, 0, 126, 51, 709, 25, 734
INVAR-74, Run: 030, F, 0, 0, 126, 420, 5376, 394, 5770
INVAR-74, Run: 031, F, 0, 126, 0, 1490, 1676, 1590, 3266
INVAR-74, Run: 032, F, 0, 0, 126, 387, 1958, 361, 2319
INVAR-74, Run: 033, F, 0, 126, 0, 3568, 3635, 3668, 7303
INVAR-74, Run: 034, F, 0, 126, 0, 440, 339, 540, 879
INVAR-74, Run: 035, F, 0, 0, 126, 1184, 3238, 1158, 4396
INVAR-74, Run: 036, F, 0, 0, 126, 516, 1741, 490, 2231
INVAR-74, Run: 037, F, 0, 0, 126, 1073, 2709, 1047, 3756
INVAR-74, Run: 038, F, 0, 0, 126, 146, 1217, 120, 1337
INVAR-74, Run: 039, F, 0, 0, 126, 573, 2364, 547, 2911
INVAR-74, Run: 040, F, 0, 126, 0, 16310, 16786, 16410, 33196
INVAR-74, Run: 041, F, 0, 0, 126, 1331, 7352, 1305, 8657
INVAR-74, Run: 042, F, 0, 0, 126, 3167, 6949, 3141, 10090
INVAR-74, Run: 043, F, 0, 126, 0, 4183, 6573, 4283, 10856
INVAR-74, Run: 044, F, 0, 0, 126, 409, 1415, 383, 1798
INVAR-74, Run: 045, F, 0, 0, 126, 1592, 8167, 1566, 9733
INVAR-74, Run: 046, F, 0, 0, 126, 746, 4727, 720, 5447
INVAR-74, Run: 047, F, 0, 0, 126, 698, 3616, 672, 4288
INVAR-74, Run: 048, F, 0, 0, 126, 116, 868, 90, 958
INVAR-74, Run: 049, F, 0, 126, 0, 1489, 2670, 1589, 4259
INVAR-74, Run: 050, F, 0, 0, 126, 151, 1197, 125, 1322
INVAR-74, Run: 051, F, 0, 0, 126, 299, 3237, 273, 3510
INVAR-74, Run: 052, F, 0, 0, 126, 1636, 6564, 1610, 8174
INVAR-74, Run: 053, F, 0, 0, 126, 920, 2433, 894, 3327
INVAR-74, Run: 054, F, 0, 0, 126, 123, 1444, 97, 1541
INVAR-74, Run: 055, F, 0, 0, 126, 150, 972, 124, 1096
INVAR-74, Run: 056, F, 0, 0, 126, 125, 1256, 99, 1355
INVAR-74, Run: 057, F, 0, 0, 126, 114, 782, 88, 870
INVAR-74, Run: 058, F, 0, 0, 126, 682, 2279, 656, 2935
INVAR-74, Run: 059, F, 0, 126, 0, 1618, 1053, 1718, 2771
INVAR-74, Run: 060, F, 0, 0, 126, 3690, 5485, 3664, 9149
INVAR-74, Run: 061, F, 0, 0, 126, 1667, 4115, 1641, 5756
INVAR-74, Run: 062, F, 0, 126, 0, 1123, 773, 1223, 1996
INVAR-74, Run: 063, F, 0, 0, 126, 6139, 10240, 6113, 16353
INVAR-74, Run: 064, F, 0, 0, 126, 47, 345, 21, 366
INVAR-74, Run: 065, F, 0, 0, 126, 875, 1609, 849, 2458
INVAR-74, Run: 066, F, 0, 0, 126, 821, 2621, 795, 3416
INVAR-74, Run: 067, F, 0, 0, 126, 157, 1776, 131, 1907
INVAR-74, Run: 068, F, 0, 0, 126, 526, 3962, 500, 4462
INVAR-74, Run: 069, F, 0, 0, 126, 2668, 1976, 2642, 4618
INVAR-74, Run: 070, F, 0, 0, 126, 68, 479, 42, 521
INVAR-74, Run: 071, F, 0, 0, 126, 383, 2035, 357, 2392
INVAR-74, Run: 072, F, 0, 0, 126, 127, 830, 101, 931
INVAR-74, Run: 073, F, 0, 0, 126, 525, 3310, 499, 3809
INVAR-74, Run: 074, F, 0, 0, 126, 371, 1696, 345, 2041
INVAR-74, Run: 075, F, 0, 0, 126, 1136, 1909, 1110, 3019
INVAR-74, Run: 076, F, 0, 0, 126, 100, 989, 74, 1063
INVAR-74, Run: 077, F, 0, 0, 126, 236, 1557, 210, 1767
INVAR-74, Run: 078, F, 0, 0, 126, 123, 970, 97, 1067
INVAR-74, Run: 079, F, 0, 0, 126, 503, 4488, 477, 4965
INVAR-74, Run: 080, F, 0, 126, 0, 2213, 1276, 2313, 3589
INVAR-74, Run: 081, F, 0, 0, 126, 617, 2411, 591, 3002
INVAR-74, Run: 082, F, 0, 0, 126, 402, 2850, 376, 3226
INVAR-74, Run: 083, F, 0, 126, 0, 2564, 2753, 2664, 5417
INVAR-74, Run: 084, F, 0, 0, 126, 2044, 10331, 2018, 12349
INVAR-74, Run: 085, F, 0, 0, 126, 6286, 10047, 6260, 16307
INVAR-74, Run: 086, F, 0, 0, 126, 528, 1979, 502, 2481
INVAR-74, Run: 087, F, 0, 0, 126, 371, 1511, 345, 1856
INVAR-74, Run: 088, F, 0, 126, 0, 1228, 901, 1328, 2229
INVAR-74, Run: 089, F, 0, 0, 126, 141, 1440, 115, 1555
INVAR-74, Run: 090, F, 0, 0, 126, 1980, 4374, 1954, 6328
INVAR-74, Run: 091, F, 0, 0, 126, 1083, 3861, 1057, 4918
INVAR-74, Run: 092, F, 0, 0, 126, 1027, 4742, 1001, 5743
INVAR-74, Run: 093, F, 0, 0, 126, 397, 3241, 371, 3612
INVAR-74, Run: 094, F, 0, 0, 126, 619, 3418, 593, 4011
INVAR-74, Run: 095, F, 0, 0, 126, 175, 1783, 149, 1932
INVAR-74, Run: 096, F, 0, 0, 126, 272, 1244, 246, 1490
INVAR-74, Run: 097, F, 0, 0, 126, 975, 5183, 949, 6132
INVAR-74, Run: 098, F, 0, 0, 126, 810, 5684, 784, 6468
INVAR-74, Run: 099, F, 0, 0, 126, 2153, 7866, 2127, 9993
INVAR-74, Run: 100, F, 0, 126, 0, 3126, 2369, 3226, 5595
INVAR-75, Run: 001, F, 0, 0, 218, 542, 5239, 524, 5763
INVAR-75, Run: 002, F, 0, 0, 218, 127, 2683, 109, 2792
INVAR-75, Run: 003, F, 0, 0, 218, 4432, 16157, 4414, 20571
INVAR-75, Run: 004, F, 0, 0, 218, 152, 3607, 134, 3741
INVAR-75, Run: 005, F, 0, 0, 218, 649, 5887, 631, 6518
INVAR-75, Run: 006, F, 0, 0, 218, 202, 2461, 184, 2645
INVAR-75, Run: 007, F, 0, 0, 218, 473, 6365, 455, 6820
INVAR-75, Run: 008, F, 0, 0, 218, 37, 1116, 19, 1135
INVAR-75, Run: 009, F, 0, 0, 218, 2833, 14245, 2815, 17060
INVAR-75, Run: 010, F, 0, 0, 218, 69, 1310, 51, 1361
INVAR-75, Run: 011, F, 0, 0, 218, 7465, 19871, 7447, 27318
INVAR-75, Run: 012, F, 0, 0, 218, 598, 4862, 580, 5442
INVAR-75, Run: 013, F, 0, 0, 218, 160, 5896, 142, 6038
INVAR-75, Run: 014, F, 0, 0, 218, 787, 4805, 769, 5574
INVAR-75, Run: 015, F, 0, 218, 0, 5560, 7328, 5760, 13088
INVAR-75, Run: 016, F, 0, 0, 218, 4760, 16748, 4742, 21490
INVAR-75, Run: 017, F, 0, 0, 218, 10804, 23906, 10786, 34692
INVAR-75, Run: 018, F, 0, 0, 218, 141, 5318, 123, 5441
INVAR-75, Run: 019, F, 0, 0, 218, 232, 6135, 214, 6349
INVAR-75, Run: 020, F, 0, 0, 218, 990, 5168, 972, 6140
INVAR-75, Run: 021, F, 0, 0, 218, 400, 3472, 382, 3854
INVAR-75, Run: 022, F, 0, 0, 218, 448, 7096, 430, 7526
INVAR-75, Run: 023, F, 0, 218, 0, 4977, 11966, 5177, 17143
INVAR-75, Run: 024, F, 0, 0, 218, 2771, 12512, 2753, 15265
INVAR-75, Run: 025, F, 0, 0, 218, 451, 4297, 433, 4730
INVAR-75, Run: 026, F, 0, 218, 0, 3145, 2420, 3345, 5765
INVAR-75, Run: 027, F, 0, 0, 218, 117, 2037, 99, 2136
INVAR-75, Run: 028, F, 0, 0, 218, 70, 2886, 52, 2938
INVAR-75, Run: 029, F, 0, 0, 218, 1832, 10312, 1814, 12126
INVAR-75, Run: 030, F, 0, 0, 218, 1638, 12372, 1620, 13992
INVAR-75, Run: 031, F, 0, 0, 218, 819, 7184, 801, 7985
INVAR-75, Run: 032, F, 0, 0, 218, 233, 3051, 215, 3266
INVAR-75, Run: 033, F, 0, 0, 218, 80, 2063, 62, 2125
INVAR-75, Run: 034, F, 0, 0, 218, 176, 3111, 158, 3269
INVAR-75, Run: 035, F, 0, 0, 218, 70, 1939, 52, 1991
INVAR-75, Run: 036, F, 0, 0, 218, 202, 3078, 184, 3262
INVAR-75, Run: 037, F, 0, 218, 0, 7824, 12912, 8024, 20936
INVAR-75, Run: 038, F, 0, 0, 218, 1308, 7541, 1290, 8831
INVAR-75, Run: 039, F, 0, 0, 218, 92, 2616, 74, 2690
INVAR-75, Run: 040, F, 0, 0, 218, 50, 1621, 32, 1653
INVAR-75, Run: 041, F, 0, 0, 218, 42, 567, 24, 591
INVAR-75, Run: 042, F, 0, 0, 218, 8646, 19632, 8628, 28260
INVAR-75, Run: 043, F, 0, 0, 218, 1006, 7363, 988, 8351
INVAR-75, Run: 044, F, 0, 0, 218, 154, 3349, 136, 3485
INVAR-75, Run: 045, F, 0, 0, 218, 1514, 6014, 1496, 7510
INVAR-75, Run: 046, F, 0, 0, 218, 228, 4401, 210, 4611
INVAR-75, Run: 047, F, 0, 0, 218, 20398, 24447, 20380, 44827
INVAR-75, Run: 048, F, 0, 0, 218, 388, 3622, 370, 3992
INVAR-75, Run: 049, F, 0, 0, 218, 2138, 16619, 2120, 18739
INVAR-75, Run: 050, F, 0, 0, 218, 244, 4140, 226, 4366
INVAR-75, Run: 051, F, 0, 0, 218, 281, 4979, 263, 5242
INVAR-75, Run: 052, F, 0, 0, 218, 40, 596, 22, 618
INVAR-75, Run: 053, F, 0, 0, 218, 318, 4314, 300, 4614
INVAR-75, Run: 054, F, 0, 0, 218, 13249, 29012, 13231, 42243
INVAR-75, Run: 055, F, 0, 0, 218, 880, 7961, 862, 8823
INVAR-75, Run: 056, F, 0, 0, 218, 216, 5000, 198, 5198
INVAR-75, Run: 057, F, 0, 0, 218, 1460, 7693, 1442, 9135
INVAR-75, Run: 058, F, 0, 0, 218, 160, 3548, 142, 3690
INVAR-75, Run: 059, F, 0, 0, 218, 10492, 24714, 10474, 35188
INVAR-75, Run: 060, F, 0, 0, 218, 1318, 12375, 1300, 13675
INVAR-75, Run: 061, F, 0, 0, 218, 284, 3870, 266, 4136
INVAR-75, Run: 062, F, 0, 218, 0, 4956, 9517, 5156, 14673
INVAR-75, Run: 063, F, 0, 0, 218, 11934, 23791, 11916, 35707
INVAR-75, Run: 064, F, 0, 0, 218, 2451, 13715, 2433, 16148
INVAR-75, Run: 065, F, 0, 218, 0, 4650, 2862, 4850, 7712
INVAR-75, Run: 066, F, 0, 0, 218, 235, 5384, 217, 5601
INVAR-75, Run: 067, F, 0, 0, 218, 80, 3666, 62, 3728
INVAR-75, Run: 068, F, 0, 0, 218, 911, 7102, 893, 7995
INVAR-75, Run: 069, F, 0, 218, 0, 8092, 4146, 8292, 12438
INVAR-75, Run: 070, F, 0, 0, 218, 37, 1391, 19, 1410
INVAR-75, Run: 071, F, 0, 0, 218, 1045, 11909, 1027, 12936
INVAR-75, Run: 072, F, 0, 0, 218, 162, 1688, 144, 1832
INVAR-75, Run: 073, F, 0, 0, 218, 59, 1333, 41, 1374
INVAR-75, Run: 074, F, 0, 0, 218, 1136, 7822, 1118, 8940
INVAR-75, Run: 075, F, 0, 218, 0, 7246, 8738, 7446, 16184
INVAR-75, Run: 076, F, 0, 0, 218, 386, 4543, 368, 4911
INVAR-75, Run: 077, F, 0, 0, 218, 41, 705, 23, 728
INVAR-75, Run: 078, F, 0, 0, 218, 239, 5162, 221, 5383
INVAR-75, Run: 079, F, 0, 0, 218, 7751, 28467, 7733, 36200
INVAR-75, Run: 080, F, 0, 0, 218, 654, 8456, 636, 9092
INVAR-75, Run: 081, F, 0, 0, 218, 684, 5902, 666, 6568
INVAR-75, Run: 082, F, 0, 0, 218, 209, 2994, 191, 3185
INVAR-75, Run: 083, F, 0, 0, 218, 66, 1977, 48, 2025
INVAR-75, Run: 084, F, 0, 0, 218, 177, 4577, 159, 4736
INVAR-75, Run: 085, F, 0, 0, 218, 60, 1087, 42, 1129
INVAR-75, Run: 086, F, 0, 0, 218, 246, 4073, 228, 4301
INVAR-75, Run: 087, F, 0, 0, 218, 71, 1142, 53, 1195
INVAR-75, Run: 088, F, 0, 0, 218, 542, 4913, 524, 5437
INVAR-75, Run: 089, F, 0, 218, 0, 6063, 5943, 6263, 12206
INVAR-75, Run: 090, F, 0, 0, 218, 4762, 21457, 4744, 26201
INVAR-75, Run: 091, F, 0, 0, 218, 1363, 8470, 1345, 9815
INVAR-75, Run: 092, F, 0, 0, 218, 1358, 11848, 1340, 13188
INVAR-75, Run: 093, F, 0, 0, 218, 162, 4182, 144, 4326
INVAR-75, Run: 094, F, 0, 218, 0, 4343, 7606, 4543, 12149
INVAR-75, Run: 095, F, 0, 0, 218, 33, 551, 15, 566
INVAR-75, Run: 096, F, 0, 0, 218, 113, 1701, 95, 1796
INVAR-75, Run: 097, F, 0, 0, 218, 65, 1233, 47, 1280
INVAR-75, Run: 098, F, 0, 0, 218, 76, 2511, 58, 2569
INVAR-75, Run: 099, F, 0, 0, 218, 37, 768, 19, 787
INVAR-75, Run: 100, F, 0, 0, 218, 315, 5917, 297, 6214
INVAR-76, Run: 001, F, 0, 0, 61, 23, 113, 12, 125
INVAR-76, Run: 002, F, 0, 0, 61, 15, 68, 4, 72
INVAR-76, Run: 003, F, 0, 0, 61, 259, 1255, 248, 1503
INVAR-76, Run: 004, F, 0, 0, 61, 211, 755, 200, 955
INVAR-76, Run: 005, F, 0, 0, 61, 215, 812, 204, 1016
INVAR-76, Run: 006, F, 0, 0, 61, 1134, 1838, 1123, 2961
INVAR-76, Run: 007, F, 0, 0, 61, 41, 412, 30, 442
INVAR-76, Run: 008, F, 0, 0, 61, 96, 392, 85, 477
INVAR-76, Run: 009, F, 0, 61, 0, 1762, 1336, 1812, 3148
INVAR-76, Run: 010, F, 0, 0, 61, 85, 624, 74, 698
INVAR-76, Run: 011, F, 0, 0, 61, 26, 205, 15, 220
INVAR-76, Run: 012, F, 0, 0, 61, 65, 671, 54, 725
INVAR-76, Run: 013, F, 0, 61, 0, 1080, 1311, 1130, 2441
INVAR-76, Run: 014, F, 0, 0, 61, 656, 2252, 645, 2897
INVAR-76, Run: 015, F, 0, 0, 61, 86, 1034, 75, 1109
INVAR-76, Run: 016, F, 0, 61, 0, 310, 434, 360, 794
INVAR-76, Run: 017, F, 0, 0, 61, 347, 1172, 336, 1508
INVAR-76, Run: 018, F, 0, 0, 61, 154, 982, 143, 1125
INVAR-76, Run: 019, F, 0, 0, 61, 989, 2235, 978, 3213
INVAR-76, Run: 020, F, 0, 0, 61, 171, 836, 160, 996
INVAR-76, Run: 021, F, 0, 0, 61, 140, 1030, 129, 1159
INVAR-76, Run: 022, F, 0, 0, 61, 30, 337, 19, 356
INVAR-76, Run: 023, F, 0, 0, 61, 32, 208, 21, 229
INVAR-76, Run: 024, F, 0, 0, 61, 401, 1128, 390, 1518
INVAR-76, Run: 025, F, 0, 61, 0, 1167, 1977, 1217, 3194
INVAR-76, Run: 026, F, 0, 61, 0, 634, 602, 684, 1286
INVAR-76, Run: 027, F, 0, 61, 0, 371, 706, 421, 1127
INVAR-76, Run: 028, F, 0, 61, 0, 861, 385, 911, 1296
INVAR-76, Run: 029, F, 0, 0, 61, 904, 1876, 893, 2769
INVAR-76, Run: 030, F, 0, 0, 61, 101, 661, 90, 751
INVAR-76, Run: 031, F, 0, 0, 61, 99, 569, 88, 657
INVAR-76, Run: 032, F, 0, 0, 61, 460, 1015, 449, 1464
INVAR-76, Run: 033, F, 0, 0, 61, 89, 659, 78, 737
INVAR-76, Run: 034, F, 0, 0, 61, 28, 141, 17, 158
INVAR-76, Run: 035, F, 0, 61, 0, 537, 1819, 587, 2406
INVAR-76, Run: 036, F, 0, 0, 61, 67, 567, 56, 623
INVAR-76, Run: 037, F, 0, 0, 61, 71, 859, 60, 919
INVAR-76, Run: 038, F, 0, 0, 61, 83, 247, 72, 319
INVAR-76, Run: 039, F, 0, 0, 61, 508, 635, 497, 1132
INVAR-76, Run: 040, F, 0, 0, 61, 17, 122, 6, 128
INVAR-76, Run: 041, F, 0, 0, 61, 77, 500, 66, 566
INVAR-76, Run: 042, F, 0, 0, 61, 146, 761, 135, 896
INVAR-76, Run: 043, F, 0, 0, 61, 37, 419, 26, 445
INVAR-76, Run: 044, F, 0, 0, 61, 540, 2353, 529, 2882
INVAR-76, Run: 045, F, 0, 0, 61, 197, 1700, 186, 1886
INVAR-76, Run: 046, F, 0, 0, 61, 53, 411, 42, 453
INVAR-76, Run: 047, F, 0, 0, 61, 76, 332, 65, 397
INVAR-76, Run: 048, F, 0, 0, 61, 180, 706, 169, 875
INVAR-76, Run: 049, F, 0, 0, 61, 77, 434, 66, 500
INVAR-76, Run: 050, F, 0, 0, 61, 1001, 2079, 990, 3069
INVAR-76, Run: 051, F, 0, 0, 61, 175, 718, 164, 882
INVAR-76, Run: 052, F, 0, 0, 61, 84, 450, 73, 523
INVAR-76, Run: 053, F, 0, 0, 61, 31, 157, 20, 177
INVAR-76, Run: 054, F, 0, 0, 61, 61, 187, 50, 237
INVAR-76, Run: 055, F, 0, 0, 61, 369, 757, 358, 1115
INVAR-76, Run: 056, F, 0, 0, 61, 27, 130, 16, 146
INVAR-76, Run: 057, F, 0, 0, 61, 40, 202, 29, 231
INVAR-76, Run: 058, F, 0, 0, 61, 41, 279, 30, 309
INVAR-76, Run: 059, F, 0, 0, 61, 74, 665, 63, 728
INVAR-76, Run: 060, F, 0, 0, 61, 73, 265, 62, 327
INVAR-76, Run: 061, F, 0, 0, 61, 633, 1073, 622, 1695
INVAR-76, Run: 062, F, 0, 0, 61, 133, 482, 122, 604
INVAR-76, Run: 063, F, 0, 0, 61, 36, 524, 25, 549
INVAR-76, Run: 064, F, 0, 0, 61, 168, 1185, 157, 1342
INVAR-76, Run: 065, F, 0, 0, 61, 23, 91, 12, 103
INVAR-76, Run: 066, F, 0, 0, 61, 123, 834, 112, 946
INVAR-76, Run: 067, F, 0, 0, 61, 873, 1064, 862, 1926
INVAR-76, Run: 068, F, 0, 61, 0, 238, 111, 288, 399
INVAR-76, Run: 069, F, 0, 0, 61, 157, 1047, 146, 1193
INVAR-76, Run: 070, F, 0, 0, 61, 73, 363, 62, 425
INVAR-76, Run: 071, F, 0, 61, 0, 113, 242, 163, 405
INVAR-76, Run: 072, F, 0, 0, 61, 277, 1519, 266, 1785
INVAR-76, Run: 073, F, 0, 0, 61, 81, 285, 70, 355
INVAR-76, Run: 074, F, 0, 0, 61, 1285, 2444, 1274, 3718
INVAR-76, Run: 075, F, 0, 61, 0, 769, 671, 819, 1490
INVAR-76, Run: 076, F, 0, 0, 61, 479, 1027, 468, 1495
INVAR-76, Run: 077, F, 0, 0, 61, 533, 1753, 522, 2275
INVAR-76, Run: 078, F, 0, 0, 61, 330, 898, 319, 1217
INVAR-76, Run: 079, F, 0, 0, 61, 217, 917, 206, 1123
INVAR-76, Run: 080, F, 0, 0, 61, 117, 335, 106, 441
INVAR-76, Run: 081, F, 0, 0, 61, 32, 266, 21, 287
INVAR-76, Run: 082, F, 0, 61, 0, 285, 357, 335, 692
INVAR-76, Run: 083, F, 0, 0, 61, 55, 337, 44, 381
INVAR-76, Run: 084, F, 0, 0, 61, 16, 162, 5, 167
INVAR-76, Run: 085, F, 0, 61, 0, 694, 936, 744, 1680
INVAR-76, Run: 086, F, 0, 0, 61, 107, 292, 96, 388
INVAR-76, Run: 087, F, 0, 0, 61, 34, 218, 23, 241
INVAR-76, Run: 088, F, 0, 0, 61, 131, 854, 120, 974
INVAR-76, Run: 089, F, 0, 61, 0, 595, 1128, 645, 1773
INVAR-76, Run: 090, F, 0, 0, 61, 24, 165, 13, 178
INVAR-76, Run: 091, F, 0, 61, 0, 1291, 1107, 1341, 2448
INVAR-76, Run: 092, F, 0, 0, 61, 818, 2089, 807, 2896
INVAR-76, Run: 093, F, 0, 61, 0, 998, 1680, 1048, 2728
INVAR-76, Run: 094, F, 0, 0, 61, 25, 325, 14, 339
INVAR-76, Run: 095, F, 0, 0, 61, 92, 527, 81, 608
INVAR-76, Run: 096, F, 0, 0, 61, 22, 137, 11, 148
INVAR-76, Run: 097, F, 0, 0, 61, 58, 461, 47, 508
INVAR-76, Run: 098, F, 0, 0, 61, 125, 581, 114, 695
INVAR-76, Run: 099, F, 0, 61, 0, 335, 295, 385, 680
INVAR-76, Run: 100, F, 0, 61, 0, 762, 419, 812, 1231
INVAR-77, Run: 001, F, 0, 0, 115, 362, 2555, 347, 2902
INVAR-77, Run: 002, F, 0, 0, 115, 33, 370, 18, 388
INVAR-77, Run: 003, F, 0, 0, 115, 204, 795, 189, 984
INVAR-77, Run: 004, F, 0, 0, 115, 75, 944, 60, 1004
INVAR-77, Run: 005, F, 0, 0, 115, 102, 1938, 87, 2025
INVAR-77, Run: 006, F, 0, 0, 115, 978, 4882, 963, 5845
INVAR-77, Run: 007, F, 0, 115, 0, 5114, 5071, 5214, 10285
INVAR-77, Run: 008, F, 0, 0, 115, 62, 646, 47, 693
INVAR-77, Run: 009, F, 0, 0, 115, 77, 1304, 62, 1366
INVAR-77, Run: 010, F, 0, 0, 115, 227, 1152, 212, 1364
INVAR-77, Run: 011, F, 0, 115, 0, 2001, 3589, 2101, 5690
INVAR-77, Run: 012, F, 0, 115, 0, 2928, 2616, 3028, 5644
INVAR-77, Run: 013, F, 0, 0, 115, 2232, 5813, 2217, 8030
INVAR-77, Run: 014, F, 0, 115, 0, 3798, 2625, 3898, 6523
INVAR-77, Run: 015, F, 0, 0, 115, 1093, 6325, 1078, 7403
INVAR-77, Run: 016, F, 0, 0, 115, 1794, 7149, 1779, 8928
INVAR-77, Run: 017, F, 0, 0, 115, 382, 2436, 367, 2803
INVAR-77, Run: 018, F, 0, 0, 115, 63, 586, 48, 634
INVAR-77, Run: 019, F, 0, 115, 0, 2637, 2189, 2737, 4926
INVAR-77, Run: 020, F, 0, 0, 115, 2654, 8404, 2639, 11043
INVAR-77, Run: 021, F, 0, 0, 115, 252, 2188, 237, 2425
INVAR-77, Run: 022, F, 0, 0, 115, 1834, 3379, 1819, 5198
INVAR-77, Run: 023, F, 0, 115, 0, 2022, 1242, 2122, 3364
INVAR-77, Run: 024, F, 0, 0, 115, 34, 381, 19, 400
INVAR-77, Run: 025, F, 0, 0, 115, 247, 1805, 232, 2037
INVAR-77, Run: 026, F, 0, 0, 115, 118, 746, 103, 849
INVAR-77, Run: 027, F, 0, 0, 115, 984, 1956, 969, 2925
INVAR-77, Run: 028, F, 0, 115, 0, 1959, 1573, 2059, 3632
INVAR-77, Run: 029, F, 0, 0, 115, 1101, 3028, 1086, 4114
INVAR-77, Run: 030, F, 0, 0, 115, 582, 4578, 567, 5145
INVAR-77, Run: 031, F, 0, 0, 115, 189, 1888, 174, 2062
INVAR-77, Run: 032, F, 0, 0, 115, 663, 2552, 648, 3200
INVAR-77, Run: 033, F, 0, 0, 115, 488, 2367, 473, 2840
INVAR-77, Run: 034, F, 0, 115, 0, 2822, 1239, 2922, 4161
INVAR-77, Run: 035, F, 0, 0, 115, 113, 1281, 98, 1379
INVAR-77, Run: 036, F, 0, 0, 115, 128, 1470, 113, 1583
INVAR-77, Run: 037, F, 0, 0, 115, 256, 1747, 241, 1988
INVAR-77, Run: 038, F, 0, 0, 115, 44, 521, 29, 550
INVAR-77, Run: 039, F, 0, 0, 115, 362, 2527, 347, 2874
INVAR-77, Run: 040, F, 0, 0, 115, 62, 606, 47, 653
INVAR-77, Run: 041, F, 0, 0, 115, 51, 1106, 36, 1142
INVAR-77, Run: 042, F, 0, 0, 115, 740, 5146, 725, 5871
INVAR-77, Run: 043, F, 0, 0, 115, 388, 1885, 373, 2258
INVAR-77, Run: 044, F, 0, 0, 115, 51, 658, 36, 694
INVAR-77, Run: 045, F, 0, 0, 115, 63, 650, 48, 698
INVAR-77, Run: 046, F, 0, 0, 115, 463, 5058, 448, 5506
INVAR-77, Run: 047, F, 0, 0, 115, 797, 5816, 782, 6598
INVAR-77, Run: 048, F, 0, 115, 0, 700, 554, 800, 1354
INVAR-77, Run: 049, F, 0, 115, 0, 3738, 4558, 3838, 8396
INVAR-77, Run: 050, F, 0, 0, 115, 69, 1039, 54, 1093
INVAR-77, Run: 051, F, 0, 115, 0, 914, 805, 1014, 1819
INVAR-77, Run: 052, F, 0, 0, 115, 45, 797, 30, 827
INVAR-77, Run: 053, F, 0, 0, 115, 81, 985, 66, 1051
INVAR-77, Run: 054, F, 0, 0, 115, 176, 1211, 161, 1372
INVAR-77, Run: 055, F, 0, 0, 115, 145, 1964, 130, 2094
INVAR-77, Run: 056, F, 0, 0, 115, 448, 3043, 433, 3476
INVAR-77, Run: 057, F, 0, 0, 115, 112, 2328, 97, 2425
INVAR-77, Run: 058, F, 0, 115, 0, 1014, 1960, 1114, 3074
INVAR-77, Run: 059, F, 0, 0, 115, 247, 1336, 232, 1568
INVAR-77, Run: 060, F, 0, 0, 115, 64, 678, 49, 727
INVAR-77, Run: 061, F, 0, 0, 115, 76, 770, 61, 831
INVAR-77, Run: 062, F, 0, 0, 115, 67, 1097, 52, 1149
INVAR-77, Run: 063, F, 0, 0, 115, 163, 1180, 148, 1328
INVAR-77, Run: 064, F, 0, 0, 115, 434, 2852, 419, 3271
INVAR-77, Run: 065, F, 0, 0, 115, 120, 1089, 105, 1194
INVAR-77, Run: 066, F, 0, 0, 115, 93, 1943, 78, 2021
INVAR-77, Run: 067, F, 0, 0, 115, 214, 1268, 199, 1467
INVAR-77, Run: 068, F, 0, 0, 115, 1835, 4864, 1820, 6684
INVAR-77, Run: 069, F, 0, 0, 115, 269, 3086, 254, 3340
INVAR-77, Run: 070, F, 0, 0, 115, 105, 1002, 90, 1092
INVAR-77, Run: 071, F, 0, 0, 115, 190, 2175, 175, 2350
INVAR-77, Run: 072, F, 0, 0, 115, 94, 1058, 79, 1137
INVAR-77, Run: 073, F, 0, 0, 115, 97, 719, 82, 801
INVAR-77, Run: 074, F, 0, 0, 115, 190, 2159, 175, 2334
INVAR-77, Run: 075, F, 0, 0, 115, 289, 1984, 274, 2258
INVAR-77, Run: 076, F, 0, 0, 115, 548, 2398, 533, 2931
INVAR-77, Run: 077, F, 0, 0, 115, 38, 549, 23, 572
INVAR-77, Run: 078, F, 0, 115, 0, 4820, 5022, 4920, 9942
INVAR-77, Run: 079, F, 0, 0, 115, 94, 627, 79, 706
INVAR-77, Run: 080, F, 0, 0, 115, 75, 825, 60, 885
INVAR-77, Run: 081, F, 0, 0, 115, 259, 2828, 244, 3072
INVAR-77, Run: 082, F, 0, 0, 115, 636, 2241, 621, 2862
INVAR-77, Run: 083, F, 0, 0, 115, 29, 427, 14, 441
INVAR-77, Run: 084, F, 0, 0, 115, 35, 398, 20, 418
INVAR-77, Run: 085, F, 0, 0, 115, 50, 684, 35, 719
INVAR-77, Run: 086, F, 0, 0, 115, 367, 2129, 352, 2481
INVAR-77, Run: 087, F, 0, 115, 0, 1397, 1035, 1497, 2532
INVAR-77, Run: 088, F, 0, 0, 115, 252, 3090, 237, 3327
INVAR-77, Run: 089, F, 0, 0, 115, 54, 728, 39, 767
INVAR-77, Run: 090, F, 0, 0, 115, 1349, 5054, 1334, 6388
INVAR-77, Run: 091, F, 0, 0, 115, 45, 813, 30, 843
INVAR-77, Run: 092, F, 0, 0, 115, 577, 2094, 562, 2656
INVAR-77, Run: 093, F, 0, 0, 115, 48, 859, 33, 892
INVAR-77, Run: 094, F, 0, 115, 0, 2914, 3485, 3014, 6499
INVAR-77, Run: 095, F, 0, 0, 115, 93, 688, 78, 766
INVAR-77, Run: 096, F, 0, 0, 115, 103, 1156, 88, 1244
INVAR-77, Run: 097, F, 0, 0, 115, 556, 2576, 541, 3117
INVAR-77, Run: 098, F, 0, 0, 115, 27, 611, 12, 623
INVAR-77, Run: 099, F, 0, 0, 115, 34, 468, 19, 487
INVAR-77, Run: 100, F, 0, 0, 115, 484, 2341, 469, 2810
INVAR-78, Run: 001, F, 0, 0, 225, 182, 3052, 157, 3209
INVAR-78, Run: 002, F, 0, 225, 0, 6453, 17233, 6653, 23886
INVAR-78, Run: 003, F, 0, 0, 225, 240, 2947, 215, 3162
INVAR-78, Run: 004, F, 0, 0, 225, 5051, 12604, 5026, 17630
INVAR-78, Run: 005, F, 0, 0, 225, 956, 7089, 931, 8020
INVAR-78, Run: 006, F, 0, 0, 225, 3532, 7866, 3507, 11373
INVAR-78, Run: 007, F, 0, 0, 225, 98, 1517, 73, 1590
INVAR-78, Run: 008, F, 0, 225, 0, 6935, 5249, 7135, 12384
INVAR-78, Run: 009, F, 0, 0, 225, 422, 4736, 397, 5133
INVAR-78, Run: 010, F, 0, 225, 0, 6850, 8600, 7050, 15650
INVAR-78, Run: 011, F, 0, 0, 225, 748, 4026, 723, 4749
INVAR-78, Run: 012, F, 0, 0, 225, 868, 10028, 843, 10871
INVAR-78, Run: 013, F, 0, 0, 225, 682, 9208, 657, 9865
INVAR-78, Run: 014, F, 0, 0, 225, 5454, 13530, 5429, 18959
INVAR-78, Run: 015, F, 0, 0, 225, 629, 4418, 604, 5022
INVAR-78, Run: 016, F, 0, 0, 225, 747, 7128, 722, 7850
INVAR-78, Run: 017, F, 0, 0, 225, 1453, 6022, 1428, 7450
INVAR-78, Run: 018, F, 0, 0, 225, 687, 4139, 662, 4801
INVAR-78, Run: 019, F, 0, 225, 0, 7816, 16154, 8016, 24170
INVAR-78, Run: 020, F, 0, 0, 225, 148, 2322, 123, 2445
INVAR-78, Run: 021, F, 0, 0, 225, 335, 4720, 310, 5030
INVAR-78, Run: 022, F, 0, 0, 225, 195, 2679, 170, 2849
INVAR-78, Run: 023, F, 0, 0, 225, 8730, 22738, 8705, 31443
INVAR-78, Run: 024, F, 0, 0, 225, 375, 5470, 350, 5820
INVAR-78, Run: 025, F, 0, 0, 225, 411, 6550, 386, 6936
INVAR-78, Run: 026, F, 0, 0, 225, 244, 3734, 219, 3953
INVAR-78, Run: 027, F, 0, 0, 225, 2654, 16451, 2629, 19080
INVAR-78, Run: 028, F, 0, 0, 225, 1500, 10136, 1475, 11611
INVAR-78, Run: 029, F, 0, 0, 225, 122, 2252, 97, 2349
INVAR-78, Run: 030, F, 0, 0, 225, 307, 5567, 282, 5849
INVAR-78, Run: 031, F, 0, 225, 0, 10467, 15070, 10667, 25737
INVAR-78, Run: 032, F, 0, 0, 225, 10653, 36109, 10628, 46737
INVAR-78, Run: 033, F, 0, 0, 225, 133, 2908, 108, 3016
INVAR-78, Run: 034, F, 0, 0, 225, 3033, 11042, 3008, 14050
INVAR-78, Run: 035, F, 0, 0, 225, 437, 6641, 412, 7053
INVAR-78, Run: 036, F, 0, 0, 225, 77, 1186, 52, 1238
INVAR-78, Run: 037, F, 0, 0, 225, 1507, 12922, 1482, 14404
INVAR-78, Run: 038, F, 0, 0, 225, 184, 1622, 159, 1781
INVAR-78, Run: 039, F, 0, 225, 0, 5772, 5090, 5972, 11062
INVAR-78, Run: 040, F, 0, 225, 0, 10509, 16989, 10709, 27698
INVAR-78, Run: 041, F, 0, 0, 225, 2102, 11799, 2077, 13876
INVAR-78, Run: 042, F, 0, 0, 225, 6479, 18980, 6454, 25434
INVAR-78, Run: 043, F, 0, 0, 225, 1972, 8249, 1947, 10196
INVAR-78, Run: 044, F, 0, 0, 225, 6480, 20550, 6455, 27005
INVAR-78, Run: 045, F, 0, 0, 225, 2098, 7683, 2073, 9756
INVAR-78, Run: 046, F, 0, 0, 225, 8405, 12835, 8380, 21215
INVAR-78, Run: 047, F, 0, 0, 225, 840, 4384, 815, 5199
INVAR-78, Run: 048, F, 0, 225, 0, 3989, 7845, 4189, 12034
INVAR-78, Run: 049, F, 0, 0, 225, 335, 4923, 310, 5233
INVAR-78, Run: 050, F, 0, 0, 225, 1780, 19695, 1755, 21450
INVAR-78, Run: 051, F, 0, 225, 0, 12864, 13103, 13064, 26167
INVAR-78, Run: 052, F, 0, 0, 225, 4913, 17304, 4888, 22192
INVAR-78, Run: 053, F, 0, 0, 225, 858, 4995, 833, 5828
INVAR-78, Run: 054, F, 0, 0, 225, 132, 2270, 107, 2377
INVAR-78, Run: 055, F, 0, 0, 225, 2340, 16671, 2315, 18986
INVAR-78, Run: 056, F, 0, 0, 225, 10745, 28668, 10720, 39388
INVAR-78, Run: 057, F, 0, 0, 225, 12347, 21183, 12322, 33505
INVAR-78, Run: 058, F, 0, 225, 0, 5601, 10141, 5801, 15942
INVAR-78, Run: 059, F, 0, 225, 0, 15204, 14719, 15404, 30123
INVAR-78, Run: 060, F, 0, 0, 225, 3209, 6671, 3184, 9855
INVAR-78, Run: 061, F, 0, 0, 225, 484, 6824, 459, 7283
INVAR-78, Run: 062, F, 0, 0, 225, 228, 2280, 203, 2483
INVAR-78, Run: 063, F, 0, 0, 225, 128, 3316, 103, 3419
INVAR-78, Run: 064, F, 0, 0, 225, 1228, 10445, 1203, 11648
INVAR-78, Run: 065, F, 0, 0, 225, 2118, 12686, 2093, 14779
INVAR-78, Run: 066, F, 0, 0, 225, 324, 5108, 299, 5407
INVAR-78, Run: 067, F, 0, 0, 225, 115, 2347, 90, 2437
INVAR-78, Run: 068, F, 0, 0, 225, 1314, 10312, 1289, 11601
INVAR-78, Run: 069, F, 0, 0, 225, 607, 6150, 582, 6732
INVAR-78, Run: 070, F, 0, 0, 225, 74, 775, 49, 824
INVAR-78, Run: 071, F, 0, 0, 225, 51, 1244, 26, 1270
INVAR-78, Run: 072, F, 0, 0, 225, 7390, 22096, 7365, 29461
INVAR-78, Run: 073, F, 0, 0, 225, 591, 4967, 566, 5533
INVAR-78, Run: 074, F, 0, 225, 0, 32840, 45119, 33040, 78159
INVAR-78, Run: 075, F, 0, 0, 225, 2312, 8302, 2287, 10589
INVAR-78, Run: 076, F, 0, 0, 225, 290, 2868, 265, 3133
INVAR-78, Run: 077, F, 0, 0, 225, 2141, 12772, 2116, 14888
INVAR-78, Run: 078, F, 0, 0, 225, 2370, 10611, 2345, 12956
INVAR-78, Run: 079, F, 0, 0, 225, 1334, 9119, 1309, 10428
INVAR-78, Run: 080, F, 0, 0, 225, 498, 3491, 473, 3964
INVAR-78, Run: 081, F, 0, 0, 225, 318, 3459, 293, 3752
INVAR-78, Run: 082, F, 0, 0, 225, 451, 4349, 426, 4775
INVAR-78, Run: 083, F, 0, 0, 225, 128, 2556, 103, 2659
INVAR-78, Run: 084, F, 0, 0, 225, 322, 3350, 297, 3647
INVAR-78, Run: 085, F, 0, 0, 225, 279, 3987, 254, 4241
INVAR-78, Run: 086, F, 0, 0, 225, 763, 6555, 738, 7293
INVAR-78, Run: 087, F, 0, 0, 225, 177, 1717, 152, 1869
INVAR-78, Run: 088, F, 0, 0, 225, 1255, 9871, 1230, 11101
INVAR-78, Run: 089, F, 0, 0, 225, 364, 5109, 339, 5448
INVAR-78, Run: 090, F, 0, 0, 225, 1894, 10392, 1869, 12261
INVAR-78, Run: 091, F, 0, 0, 225, 688, 6551, 663, 7214
INVAR-78, Run: 092, F, 0, 0, 225, 2137, 9719, 2112, 11831
INVAR-78, Run: 093, F, 0, 0, 225, 211, 4577, 186, 4763
INVAR-78, Run: 094, F, 0, 0, 225, 102, 2656, 77, 2733
INVAR-78, Run: 095, F, 0, 0, 225, 134, 1690, 109, 1799
INVAR-78, Run: 096, F, 0, 0, 225, 1187, 11946, 1162, 13108
INVAR-78, Run: 097, F, 0, 0, 225, 115, 1893, 90, 1983
INVAR-78, Run: 098, F, 0, 0, 225, 218, 2549, 193, 2742
INVAR-78, Run: 099, F, 0, 0, 225, 6566, 26587, 6541, 33128
INVAR-78, Run: 100, F, 0, 0, 225, 1937, 15145, 1912, 17057
INVAR-79, Run: 001, F, 0, 0, 82, 325, 753, 293, 1046
INVAR-79, Run: 002, F, 0, 0, 82, 545, 1378, 513, 1891
INVAR-79, Run: 003, F, 0, 82, 0, 2008, 675, 2058, 2733
INVAR-79, Run: 004, F, 0, 0, 82, 1341, 2401, 1309, 3710
INVAR-79, Run: 005, F, 0, 0, 82, 289, 643, 257, 900
INVAR-79, Run: 006, F, 0, 82, 0, 389, 240, 439, 679
INVAR-79, Run: 007, F, 0, 82, 0, 1210, 889, 1260, 2149
INVAR-79, Run: 008, F, 0, 0, 82, 1119, 2534, 1087, 3621
INVAR-79, Run: 009, F, 0, 0, 82, 353, 1171, 321, 1492
INVAR-79, Run: 010, F, 0, 82, 0, 607, 187, 657, 844
INVAR-79, Run: 011, F, 0, 0, 82, 92, 342, 60, 402
INVAR-79, Run: 012, F, 0, 82, 0, 585, 877, 635, 1512
INVAR-79, Run: 013, F, 0, 82, 0, 658, 214, 708, 922
INVAR-79, Run: 014, F, 0, 82, 0, 330, 200, 380, 580
INVAR-79, Run: 015, F, 0, 82, 0, 559, 503, 609, 1112
INVAR-79, Run: 016, F, 0, 82, 0, 996, 572, 1046, 1618
INVAR-79, Run: 017, F, 0, 0, 82, 1421, 1796, 1389, 3185
INVAR-79, Run: 018, F, 0, 0, 82, 3010, 4794, 2978, 7772
INVAR-79, Run: 019, F, 0, 0, 82, 414, 2921, 382, 3303
INVAR-79, Run: 020, F, 0, 0, 82, 159, 377, 127, 504
INVAR-79, Run: 021, F, 0, 82, 0, 870, 455, 920, 1375
INVAR-79, Run: 022, F, 0, 82, 0, 2356, 1156, 2406, 3562
INVAR-79, Run: 023, F, 0, 82, 0, 724, 261, 774, 1035
INVAR-79, Run: 024, F, 0, 82, 0, 306, 177, 356, 533
INVAR-79, Run: 025, F, 0, 82, 0, 113, 54, 163, 217
INVAR-79, Run: 026, F, 0, 82, 0, 628, 477, 678, 1155
INVAR-79, Run: 027, F, 0, 82, 0, 1285, 1572, 1335, 2907
INVAR-79, Run: 028, F, 0, 82, 0, 724, 283, 774, 1057
INVAR-79, Run: 029, F, 0, 0, 82, 2406, 3442, 2374, 5816
INVAR-79, Run: 030, F, 0, 0, 82, 490, 1164, 458, 1622
INVAR-79, Run: 031, F, 0, 82, 0, 675, 502, 725, 1227
INVAR-79, Run: 032, F, 0, 0, 82, 924, 2257, 892, 3149
INVAR-79, Run: 033, F, 0, 0, 82, 271, 921, 239, 1160
INVAR-79, Run: 034, F, 0, 0, 82, 552, 2695, 520, 3215
INVAR-79, Run: 035, F, 0, 0, 82, 220, 1228, 188, 1416
INVAR-79, Run: 036, F, 0, 0, 82, 238, 2418, 206, 2624
INVAR-79, Run: 037, F, 0, 0, 82, 1680, 1508, 1648, 3156
INVAR-79, Run: 038, F, 0, 0, 82, 1057, 2113, 1025, 3138
INVAR-79, Run: 039, F, 0, 82, 0, 280, 130, 330, 460
INVAR-79, Run: 040, F, 0, 82, 0, 1010, 631, 1060, 1691
INVAR-79, Run: 041, F, 0, 0, 82, 704, 1268, 672, 1940
INVAR-79, Run: 042, F, 0, 0, 82, 195, 645, 163, 808
INVAR-79, Run: 043, F, 0, 0, 82, 207, 1858, 175, 2033
INVAR-79, Run: 044, F, 0, 82, 0, 167, 97, 217, 314
INVAR-79, Run: 045, F, 0, 0, 82, 414, 513, 382, 895
INVAR-79, Run: 046, F, 0, 82, 0, 1977, 1364, 2027, 3391
INVAR-79, Run: 047, F, 0, 82, 0, 203, 106, 253, 359
INVAR-79, Run: 048, F, 0, 82, 0, 1443, 1398, 1493, 2891
INVAR-79, Run: 049, F, 0, 0, 82, 160, 700, 128, 828
INVAR-79, Run: 050, F, 0, 82, 0, 826, 684, 876, 1560
INVAR-79, Run: 051, F, 0, 82, 0, 1569, 676, 1619, 2295
INVAR-79, Run: 052, F, 0, 0, 82, 926, 1588, 894, 2482
INVAR-79, Run: 053, F, 0, 82, 0, 182, 94, 232, 326
INVAR-79, Run: 054, F, 0, 0, 82, 187, 701, 155, 856
INVAR-79, Run: 055, F, 0, 0, 82, 250, 1408, 218, 1626
INVAR-79, Run: 056, F, 0, 0, 82, 495, 1510, 463, 1973
INVAR-79, Run: 057, F, 0, 0, 82, 836, 2225, 804, 3029
INVAR-79, Run: 058, F, 0, 0, 82, 1558, 2184, 1526, 3710
INVAR-79, Run: 059, F, 0, 82, 0, 428, 190, 478, 668
INVAR-79, Run: 060, F, 0, 82, 0, 627, 467, 677, 1144
INVAR-79, Run: 061, F, 0, 0, 82, 167, 936, 135, 1071
INVAR-79, Run: 062, F, 0, 82, 0, 492, 865, 542, 1407
INVAR-79, Run: 063, F, 0, 0, 82, 1683, 2336, 1651, 3987
INVAR-79, Run: 064, F, 0, 0, 82, 447, 1102, 415, 1517
INVAR-79, Run: 065, F, 0, 82, 0, 832, 1273, 882, 2155
INVAR-79, Run: 066, F, 0, 82, 0, 2668, 5096, 2718, 7814
INVAR-79, Run: 067, F, 0, 0, 82, 495, 2547, 463, 3010
INVAR-79, Run: 068, F, 0, 0, 82, 3332, 7895, 3300, 11195
INVAR-79, Run: 069, F, 0, 0, 82, 2154, 3554, 2122, 5676
INVAR-79, Run: 070, F, 0, 0, 82, 1162, 3394, 1130, 4524
INVAR-79, Run: 071, F, 0, 82, 0, 777, 195, 827, 1022
INVAR-79, Run: 072, F, 0, 0, 82, 1198, 4081, 1166, 5247
INVAR-79, Run: 073, F, 0, 0, 82, 152, 617, 120, 737
INVAR-79, Run: 074, F, 0, 82, 0, 292, 127, 342, 469
INVAR-79, Run: 075, F, 0, 0, 82, 240, 1115, 208, 1323
INVAR-79, Run: 076, F, 0, 0, 82, 1096, 2139, 1064, 3203
INVAR-79, Run: 077, F, 0, 0, 82, 135, 797, 103, 900
INVAR-79, Run: 078, F, 0, 82, 0, 832, 727, 882, 1609
INVAR-79, Run: 079, F, 0, 0, 82, 346, 991, 314, 1305
INVAR-79, Run: 080, F, 0, 82, 0, 552, 318, 602, 920
INVAR-79, Run: 081, F, 0, 0, 82, 1165, 3106, 1133, 4239
INVAR-79, Run: 082, F, 0, 0, 82, 2533, 2865, 2501, 5366
INVAR-79, Run: 083, F, 0, 82, 0, 614, 357, 664, 1021
INVAR-79, Run: 084, F, 0, 82, 0, 447, 167, 497, 664
INVAR-79, Run: 085, F, 0, 82, 0, 478, 230, 528, 758
INVAR-79, Run: 086, F, 0, 0, 82, 192, 782, 160, 942
INVAR-79, Run: 087, F, 0, 0, 82, 491, 711, 459, 1170
INVAR-79, Run: 088, F, 0, 0, 82, 456, 1314, 424, 1738
INVAR-79, Run: 089, F, 0, 0, 82, 274, 1255, 242, 1497
INVAR-79, Run: 090, F, 0, 82, 0, 626, 189, 676, 865
INVAR-79, Run: 091, F, 0, 0, 82, 1083, 1654, 1051, 2705
INVAR-79, Run: 092, F, 0, 0, 82, 154, 1021, 122, 1143
INVAR-79, Run: 093, F, 0, 82, 0, 997, 402, 1047, 1449
INVAR-79, Run: 094, F, 0, 0, 82, 218, 645, 186, 831
INVAR-79, Run: 095, F, 0, 82, 0, 852, 373, 902, 1275
INVAR-79, Run: 096, F, 0, 0, 82, 436, 1028, 404, 1432
INVAR-79, Run: 097, F, 0, 82, 0, 905, 1287, 955, 2242
INVAR-79, Run: 098, F, 0, 0, 82, 567, 530, 535, 1065
INVAR-79, Run: 099, F, 0, 0, 82, 283, 982, 251, 1233
INVAR-79, Run: 100, F, 0, 0, 82, 1213, 1259, 1181, 2440
INVAR-8, Run: 001, F, 0, 0, 9, 18, 23, 16, 39
INVAR-8, Run: 002, F, 0, 0, 9, 2, 6, 0, 6
INVAR-8, Run: 003, F, 0, 0, 9, 8, 28, 6, 34
INVAR-8, Run: 004, F, 0, 0, 9, 2, 18, 0, 18
INVAR-8, Run: 005, F, 0, 0, 9, 2, 9, 0, 9
INVAR-8, Run: 006, F, 0, 9, 0, 14, 5, 21, 26
INVAR-8, Run: 007, F, 0, 0, 9, 5, 13, 3, 16
INVAR-8, Run: 008, F, 0, 0, 9, 21, 22, 19, 41
INVAR-8, Run: 009, F, 0, 0, 9, 3, 17, 1, 18
INVAR-8, Run: 010, F, 0, 0, 9, 3, 3, 1, 4
INVAR-8, Run: 011, F, 0, 0, 9, 7, 15, 5, 20
INVAR-8, Run: 012, F, 0, 9, 0, 6, 23, 13, 36
INVAR-8, Run: 013, F, 0, 0, 9, 2, 7, 0, 7
INVAR-8, Run: 014, F, 0, 9, 0, 3, 8, 10, 18
INVAR-8, Run: 015, F, 0, 0, 9, 6, 19, 4, 23
INVAR-8, Run: 016, F, 0, 0, 9, 2, 6, 0, 6
INVAR-8, Run: 017, F, 0, 0, 9, 6, 7, 4, 11
INVAR-8, Run: 018, F, 0, 0, 9, 16, 19, 14, 33
INVAR-8, Run: 019, F, 0, 0, 9, 2, 4, 0, 4
INVAR-8, Run: 020, F, 0, 0, 9, 3, 11, 1, 12
INVAR-8, Run: 021, F, 0, 0, 9, 2, 3, 0, 3
INVAR-8, Run: 022, F, 0, 0, 9, 5, 10, 3, 13
INVAR-8, Run: 023, F, 0, 0, 9, 2, 7, 0, 7
INVAR-8, Run: 024, F, 0, 0, 9, 22, 27, 20, 47
INVAR-8, Run: 025, F, 0, 0, 9, 6, 28, 4, 32
INVAR-8, Run: 026, F, 0, 0, 9, 2, 6, 0, 6
INVAR-8, Run: 027, F, 0, 0, 9, 2, 5, 0, 5
INVAR-8, Run: 028, F, 0, 0, 9, 2, 5, 0, 5
INVAR-8, Run: 029, F, 0, 9, 0, 17, 28, 24, 52
INVAR-8, Run: 030, F, 0, 0, 9, 6, 12, 4, 16
INVAR-8, Run: 031, F, 0, 0, 9, 4, 18, 2, 20
INVAR-8, Run: 032, F, 0, 0, 9, 2, 13, 0, 13
INVAR-8, Run: 033, F, 0, 0, 9, 27, 23, 25, 48
INVAR-8, Run: 034, F, 0, 0, 9, 2, 7, 0, 7
INVAR-8, Run: 035, F, 0, 0, 9, 4, 8, 2, 10
INVAR-8, Run: 036, F, 0, 0, 9, 8, 9, 6, 15
INVAR-8, Run: 037, F, 0, 0, 9, 2, 7, 0, 7
INVAR-8, Run: 038, F, 0, 0, 9, 2, 12, 0, 12
INVAR-8, Run: 039, F, 0, 9, 0, 5, 12, 12, 24
INVAR-8, Run: 040, F, 0, 0, 9, 2, 6, 0, 6
INVAR-8, Run: 041, F, 0, 0, 9, 6, 8, 4, 12
INVAR-8, Run: 042, F, 0, 0, 9, 8, 8, 6, 14
INVAR-8, Run: 043, F, 0, 9, 0, 5, 6, 12, 18
INVAR-8, Run: 044, F, 0, 9, 0, 4, 3, 11, 14
INVAR-8, Run: 045, F, 0, 9, 0, 7, 8, 14, 22
INVAR-8, Run: 046, F, 0, 0, 9, 11, 18, 9, 27
INVAR-8, Run: 047, F, 0, 0, 9, 4, 5, 2, 7
INVAR-8, Run: 048, F, 0, 0, 9, 2, 2, 0, 2
INVAR-8, Run: 049, F, 0, 0, 9, 4, 8, 2, 10
INVAR-8, Run: 050, F, 0, 0, 9, 7, 12, 5, 17
INVAR-8, Run: 051, F, 0, 0, 9, 3, 14, 1, 15
INVAR-8, Run: 052, F, 0, 0, 9, 4, 14, 2, 16
INVAR-8, Run: 053, F, 0, 9, 0, 17, 17, 24, 41
INVAR-8, Run: 054, F, 0, 0, 9, 28, 28, 26, 54
INVAR-8, Run: 055, F, 0, 0, 9, 2, 7, 0, 7
INVAR-8, Run: 056, F, 0, 9, 0, 7, 13, 14, 27
INVAR-8, Run: 057, F, 0, 0, 9, 20, 21, 18, 39
INVAR-8, Run: 058, F, 0, 0, 9, 3, 23, 1, 24
INVAR-8, Run: 059, F, 0, 0, 9, 3, 5, 1, 6
INVAR-8, Run: 060, F, 0, 0, 9, 3, 3, 1, 4
INVAR-8, Run: 061, F, 0, 0, 9, 4, 15, 2, 17
INVAR-8, Run: 062, F, 0, 0, 9, 4, 14, 2, 16
INVAR-8, Run: 063, F, 0, 0, 9, 3, 10, 1, 11
INVAR-8, Run: 064, F, 0, 0, 9, 2, 6, 0, 6
INVAR-8, Run: 065, F, 0, 0, 9, 6, 21, 4, 25
INVAR-8, Run: 066, F, 0, 0, 9, 2, 7, 0, 7
INVAR-8, Run: 067, F, 0, 0, 9, 9, 24, 7, 31
INVAR-8, Run: 068, F, 0, 0, 9, 4, 6, 2, 8
INVAR-8, Run: 069, F, 0, 0, 9, 14, 22, 12, 34
INVAR-8, Run: 070, F, 0, 0, 9, 12, 13, 10, 23
INVAR-8, Run: 071, F, 0, 0, 9, 2, 10, 0, 10
INVAR-8, Run: 072, F, 0, 9, 0, 12, 8, 19, 27
INVAR-8, Run: 073, F, 0, 0, 9, 2, 5, 0, 5
INVAR-8, Run: 074, F, 0, 0, 9, 11, 33, 9, 42
INVAR-8, Run: 075, F, 0, 0, 9, 8, 29, 6, 35
INVAR-8, Run: 076, F, 0, 0, 9, 4, 6, 2, 8
INVAR-8, Run: 077, F, 0, 0, 9, 3, 10, 1, 11
INVAR-8, Run: 078, F, 0, 0, 9, 5, 8, 3, 11
INVAR-8, Run: 079, F, 0, 0, 9, 3, 10, 1, 11
INVAR-8, Run: 080, F, 0, 0, 9, 2, 3, 0, 3
INVAR-8, Run: 081, F, 0, 0, 9, 5, 8, 3, 11
INVAR-8, Run: 082, F, 0, 0, 9, 6, 15, 4, 19
INVAR-8, Run: 083, F, 0, 0, 9, 2, 10, 0, 10
INVAR-8, Run: 084, F, 0, 9, 0, 18, 20, 25, 45
INVAR-8, Run: 085, F, 0, 9, 0, 4, 5, 11, 16
INVAR-8, Run: 086, F, 0, 9, 0, 10, 36, 17, 53
INVAR-8, Run: 087, F, 0, 0, 9, 6, 12, 4, 16
INVAR-8, Run: 088, F, 0, 0, 9, 22, 20, 20, 40
INVAR-8, Run: 089, F, 0, 0, 9, 3, 6, 1, 7
INVAR-8, Run: 090, F, 0, 0, 9, 2, 4, 0, 4
INVAR-8, Run: 091, F, 0, 0, 9, 2, 7, 0, 7
INVAR-8, Run: 092, F, 0, 0, 9, 16, 22, 14, 36
INVAR-8, Run: 093, F, 0, 0, 9, 4, 23, 2, 25
INVAR-8, Run: 094, F, 0, 0, 9, 3, 10, 1, 11
INVAR-8, Run: 095, F, 0, 0, 9, 3, 17, 1, 18
INVAR-8, Run: 096, F, 0, 0, 9, 3, 7, 1, 8
INVAR-8, Run: 097, F, 0, 0, 9, 3, 10, 1, 11
INVAR-8, Run: 098, F, 0, 9, 0, 5, 5, 12, 17
INVAR-8, Run: 099, F, 0, 9, 0, 2, 0, 9, 9
INVAR-8, Run: 100, F, 0, 0, 9, 3, 4, 1, 5
INVAR-80, Run: 001, F, 0, 0, 140, 443, 1217, 403, 1620
INVAR-80, Run: 002, F, 0, 0, 140, 335, 2049, 295, 2344
INVAR-80, Run: 003, F, 0, 0, 140, 943, 3572, 903, 4475
INVAR-80, Run: 004, F, 0, 0, 140, 160, 960, 120, 1080
INVAR-80, Run: 005, F, 0, 0, 140, 488, 2211, 448, 2659
INVAR-80, Run: 006, F, 0, 0, 140, 478, 2588, 438, 3026
INVAR-80, Run: 007, F, 0, 0, 140, 1260, 5364, 1220, 6584
INVAR-80, Run: 008, F, 0, 0, 140, 903, 3918, 863, 4781
INVAR-80, Run: 009, F, 0, 0, 140, 1508, 5373, 1468, 6841
INVAR-80, Run: 010, F, 0, 0, 140, 900, 3475, 860, 4335
INVAR-80, Run: 011, F, 0, 140, 0, 7090, 5398, 7190, 12588
INVAR-80, Run: 012, F, 0, 0, 140, 1059, 3834, 1019, 4853
INVAR-80, Run: 013, F, 0, 140, 0, 1059, 552, 1159, 1711
INVAR-80, Run: 014, F, 0, 140, 0, 1547, 885, 1647, 2532
INVAR-80, Run: 015, F, 0, 140, 0, 464, 528, 564, 1092
INVAR-80, Run: 016, F, 0, 0, 140, 11245, 8995, 11205, 20200
INVAR-80, Run: 017, F, 0, 140, 0, 968, 356, 1068, 1424
INVAR-80, Run: 018, F, 0, 0, 140, 443, 3120, 403, 3523
INVAR-80, Run: 019, F, 0, 0, 140, 2014, 5534, 1974, 7508
INVAR-80, Run: 020, F, 0, 0, 140, 142, 1507, 102, 1609
INVAR-80, Run: 021, F, 0, 0, 140, 9289, 20915, 9249, 30164
INVAR-80, Run: 022, F, 0, 0, 140, 906, 2653, 866, 3519
INVAR-80, Run: 023, F, 0, 140, 0, 2012, 2502, 2112, 4614
INVAR-80, Run: 024, F, 0, 140, 0, 2034, 789, 2134, 2923
INVAR-80, Run: 025, F, 0, 0, 140, 251, 1247, 211, 1458
INVAR-80, Run: 026, F, 0, 0, 140, 1218, 3151, 1178, 4329
INVAR-80, Run: 027, F, 0, 0, 140, 2013, 5903, 1973, 7876
INVAR-80, Run: 028, F, 0, 140, 0, 3054, 2173, 3154, 5327
INVAR-80, Run: 029, F, 0, 0, 140, 617, 2386, 577, 2963
INVAR-80, Run: 030, F, 0, 0, 140, 197, 1926, 157, 2083
INVAR-80, Run: 031, F, 0, 0, 140, 743, 2170, 703, 2873
INVAR-80, Run: 032, F, 0, 0, 140, 1081, 3534, 1041, 4575
INVAR-80, Run: 033, F, 0, 0, 140, 430, 2220, 390, 2610
INVAR-80, Run: 034, F, 0, 0, 140, 1422, 8610, 1382, 9992
INVAR-80, Run: 035, F, 0, 0, 140, 286, 1618, 246, 1864
INVAR-80, Run: 036, F, 0, 140, 0, 2444, 1365, 2544, 3909
INVAR-80, Run: 037, F, 0, 140, 0, 750, 267, 850, 1117
INVAR-80, Run: 038, F, 0, 140, 0, 1949, 4305, 2049, 6354
INVAR-80, Run: 039, F, 0, 0, 140, 1001, 2296, 961, 3257
INVAR-80, Run: 040, F, 0, 0, 140, 347, 1485, 307, 1792
INVAR-80, Run: 041, F, 0, 140, 0, 5840, 3152, 5940, 9092
INVAR-80, Run: 042, F, 0, 0, 140, 219, 1180, 179, 1359
INVAR-80, Run: 043, F, 0, 0, 140, 537, 1686, 497, 2183
INVAR-80, Run: 044, F, 0, 140, 0, 2919, 1705, 3019, 4724
INVAR-80, Run: 045, F, 0, 0, 140, 481, 1226, 441, 1667
INVAR-80, Run: 046, F, 0, 0, 140, 398, 2137, 358, 2495
INVAR-80, Run: 047, F, 0, 0, 140, 295, 1364, 255, 1619
INVAR-80, Run: 048, F, 0, 140, 0, 1757, 1219, 1857, 3076
INVAR-80, Run: 049, F, 0, 0, 140, 859, 3136, 819, 3955
INVAR-80, Run: 050, F, 0, 0, 140, 4913, 17167, 4873, 22040
INVAR-80, Run: 051, F, 0, 0, 140, 2208, 3149, 2168, 5317
INVAR-80, Run: 052, F, 0, 0, 140, 1114, 7208, 1074, 8282
INVAR-80, Run: 053, F, 0, 0, 140, 324, 1780, 284, 2064
INVAR-80, Run: 054, F, 0, 0, 140, 1590, 2199, 1550, 3749
INVAR-80, Run: 055, F, 0, 140, 0, 917, 571, 1017, 1588
INVAR-80, Run: 056, F, 0, 0, 140, 4081, 6411, 4041, 10452
INVAR-80, Run: 057, F, 0, 0, 140, 791, 2935, 751, 3686
INVAR-80, Run: 058, F, 0, 0, 140, 588, 5131, 548, 5679
INVAR-80, Run: 059, F, 0, 0, 140, 4620, 6429, 4580, 11009
INVAR-80, Run: 060, F, 0, 140, 0, 1088, 396, 1188, 1584
INVAR-80, Run: 061, F, 0, 140, 0, 2021, 1615, 2121, 3736
INVAR-80, Run: 062, F, 0, 140, 0, 1358, 1041, 1458, 2499
INVAR-80, Run: 063, F, 0, 0, 140, 3021, 6620, 2981, 9601
INVAR-80, Run: 064, F, 0, 0, 140, 600, 2945, 560, 3505
INVAR-80, Run: 065, F, 0, 0, 140, 458, 3918, 418, 4336
INVAR-80, Run: 066, F, 0, 140, 0, 2530, 2439, 2630, 5069
INVAR-80, Run: 067, F, 0, 140, 0, 1663, 850, 1763, 2613
INVAR-80, Run: 068, F, 0, 0, 140, 3387, 10812, 3347, 14159
INVAR-80, Run: 069, F, 0, 140, 0, 2770, 1918, 2870, 4788
INVAR-80, Run: 070, F, 0, 0, 140, 2858, 4216, 2818, 7034
INVAR-80, Run: 071, F, 0, 140, 0, 2887, 1622, 2987, 4609
INVAR-80, Run: 072, F, 0, 0, 140, 594, 4642, 554, 5196
INVAR-80, Run: 073, F, 0, 0, 140, 845, 2649, 805, 3454
INVAR-80, Run: 074, F, 0, 0, 140, 1251, 5075, 1211, 6286
INVAR-80, Run: 075, F, 0, 0, 140, 329, 2372, 289, 2661
INVAR-80, Run: 076, F, 0, 140, 0, 1233, 1122, 1333, 2455
INVAR-80, Run: 077, F, 0, 0, 140, 3651, 6706, 3611, 10317
INVAR-80, Run: 078, F, 0, 140, 0, 3705, 1313, 3805, 5118
INVAR-80, Run: 079, F, 0, 0, 140, 357, 1839, 317, 2156
INVAR-80, Run: 080, F, 0, 0, 140, 4896, 8694, 4856, 13550
INVAR-80, Run: 081, F, 0, 0, 140, 4623, 6642, 4583, 11225
INVAR-80, Run: 082, F, 0, 0, 140, 3072, 4707, 3032, 7739
INVAR-80, Run: 083, F, 0, 0, 140, 1272, 5476, 1232, 6708
INVAR-80, Run: 084, F, 0, 140, 0, 2956, 4121, 3056, 7177
INVAR-80, Run: 085, F, 0, 140, 0, 699, 614, 799, 1413
INVAR-80, Run: 086, F, 0, 0, 140, 495, 3193, 455, 3648
INVAR-80, Run: 087, F, 0, 0, 140, 878, 3147, 838, 3985
INVAR-80, Run: 088, F, 0, 0, 140, 152, 1089, 112, 1201
INVAR-80, Run: 089, F, 0, 0, 140, 655, 5033, 615, 5648
INVAR-80, Run: 090, F, 0, 0, 140, 9231, 13396, 9191, 22587
INVAR-80, Run: 091, F, 0, 140, 0, 4637, 2536, 4737, 7273
INVAR-80, Run: 092, F, 0, 140, 0, 5925, 7437, 6025, 13462
INVAR-80, Run: 093, F, 0, 140, 0, 1167, 445, 1267, 1712
INVAR-80, Run: 094, F, 0, 0, 140, 1221, 4673, 1181, 5854
INVAR-80, Run: 095, F, 0, 0, 140, 940, 4349, 900, 5249
INVAR-80, Run: 096, F, 0, 0, 140, 2174, 5102, 2134, 7236
INVAR-80, Run: 097, F, 0, 0, 140, 181, 1369, 141, 1510
INVAR-80, Run: 098, F, 0, 0, 140, 490, 2934, 450, 3384
INVAR-80, Run: 099, F, 0, 0, 140, 1562, 5291, 1522, 6813
INVAR-80, Run: 100, F, 0, 0, 140, 2284, 6308, 2244, 8552
INVAR-81, Run: 001, F, 0, 316, 0, 8174, 4021, 8374, 12395
INVAR-81, Run: 002, F, 0, 0, 316, 12746, 17457, 12630, 30087
INVAR-81, Run: 003, F, 0, 0, 316, 6466, 22103, 6350, 28453
INVAR-81, Run: 004, F, 0, 0, 316, 7284, 35383, 7168, 42551
INVAR-81, Run: 005, F, 0, 316, 0, 10083, 3213, 10283, 13496
INVAR-81, Run: 006, F, 0, 0, 316, 1759, 5962, 1643, 7605
INVAR-81, Run: 007, F, 0, 0, 316, 5171, 22937, 5055, 27992
INVAR-81, Run: 008, F, 0, 316, 0, 7284, 2225, 7484, 9709
INVAR-81, Run: 009, F, 0, 316, 0, 31885, 22633, 32085, 54718
INVAR-81, Run: 010, F, 0, 0, 316, 8339, 18039, 8223, 26262
INVAR-81, Run: 011, F, 0, 0, 316, 5081, 17002, 4965, 21967
INVAR-81, Run: 012, F, 0, 316, 0, 7476, 3328, 7676, 11004
INVAR-81, Run: 013, F, 0, 0, 316, 4221, 9180, 4105, 13285
INVAR-81, Run: 014, F, 0, 316, 0, 4582, 2036, 4782, 6818
INVAR-81, Run: 015, F, 0, 0, 316, 1430, 21665, 1314, 22979
INVAR-81, Run: 016, F, 0, 316, 0, 12663, 8875, 12863, 21738
INVAR-81, Run: 017, F, 0, 316, 0, 7218, 3020, 7418, 10438
INVAR-81, Run: 018, F, 0, 0, 316, 1515, 10019, 1399, 11418
INVAR-81, Run: 019, F, 0, 316, 0, 6492, 2978, 6692, 9670
INVAR-81, Run: 020, F, 0, 316, 0, 20520, 15228, 20720, 35948
INVAR-81, Run: 021, F, 0, 0, 316, 18926, 27440, 18810, 46250
INVAR-81, Run: 022, F, 0, 316, 0, 12878, 12870, 13078, 25948
INVAR-81, Run: 023, F, 0, 316, 0, 9993, 9421, 10193, 19614
INVAR-81, Run: 024, F, 0, 0, 316, 10190, 27751, 10074, 37825
INVAR-81, Run: 025, F, 0, 316, 0, 8584, 2805, 8784, 11589
INVAR-81, Run: 026, F, 0, 0, 316, 22330, 53630, 22214, 75844
INVAR-81, Run: 027, F, 0, 316, 0, 6750, 3758, 6950, 10708
INVAR-81, Run: 028, F, 0, 0, 316, 3593, 15986, 3477, 19463
INVAR-81, Run: 029, F, 0, 0, 316, 5063, 24255, 4947, 29202
INVAR-81, Run: 030, F, 0, 0, 316, 8245, 24617, 8129, 32746
INVAR-81, Run: 031, F, 0, 316, 0, 4566, 2418, 4766, 7184
INVAR-81, Run: 032, F, 0, 316, 0, 2586, 1508, 2786, 4294
INVAR-81, Run: 033, F, 0, 0, 316, 23387, 30314, 23271, 53585
INVAR-81, Run: 034, F, 0, 0, 316, 2871, 7413, 2755, 10168
INVAR-81, Run: 035, F, 0, 0, 316, 7234, 15216, 7118, 22334
INVAR-81, Run: 036, F, 0, 0, 316, 9595, 29365, 9479, 38844
INVAR-81, Run: 037, F, 0, 0, 316, 1607, 7465, 1491, 8956
INVAR-81, Run: 038, F, 0, 316, 0, 14957, 20314, 15157, 35471
INVAR-81, Run: 039, F, 0, 0, 316, 20113, 34277, 19997, 54274
INVAR-81, Run: 040, F, 0, 0, 316, 5902, 18798, 5786, 24584
INVAR-81, Run: 041, F, 0, 316, 0, 2752, 2257, 2952, 5209
INVAR-81, Run: 042, F, 0, 316, 0, 8248, 2642, 8448, 11090
INVAR-81, Run: 043, F, 0, 0, 316, 9972, 25448, 9856, 35304
INVAR-81, Run: 044, F, 0, 0, 316, 38769, 42440, 38653, 81093
INVAR-81, Run: 045, F, 0, 0, 316, 4356, 24088, 4240, 28328
INVAR-81, Run: 046, F, 0, 316, 0, 30323, 15532, 30523, 46055
INVAR-81, Run: 047, F, 0, 316, 0, 11104, 10086, 11304, 21390
INVAR-81, Run: 048, F, 0, 0, 316, 9995, 14595, 9879, 24474
INVAR-81, Run: 049, F, 0, 316, 0, 5630, 2309, 5830, 8139
INVAR-81, Run: 050, F, 0, 0, 316, 5757, 10162, 5641, 15803
INVAR-81, Run: 051, F, 0, 0, 316, 6839, 13445, 6723, 20168
INVAR-81, Run: 052, F, 0, 316, 0, 19550, 27313, 19750, 47063
INVAR-81, Run: 053, F, 0, 0, 316, 22171, 46374, 22055, 68429
INVAR-81, Run: 054, F, 0, 0, 316, 9508, 25553, 9392, 34945
INVAR-81, Run: 055, F, 0, 0, 316, 4873, 27054, 4757, 31811
INVAR-81, Run: 056, F, 0, 0, 316, 7383, 16330, 7267, 23597
INVAR-81, Run: 057, F, 0, 316, 0, 4675, 1983, 4875, 6858
INVAR-81, Run: 058, F, 0, 0, 316, 8493, 21731, 8377, 30108
INVAR-81, Run: 059, F, 0, 316, 0, 8436, 5313, 8636, 13949
INVAR-81, Run: 060, F, 0, 0, 316, 5813, 16324, 5697, 22021
INVAR-81, Run: 061, F, 0, 316, 0, 5820, 2064, 6020, 8084
INVAR-81, Run: 062, F, 0, 0, 316, 5301, 10225, 5185, 15410
INVAR-81, Run: 063, F, 0, 0, 316, 1853, 12166, 1737, 13903
INVAR-81, Run: 064, F, 0, 316, 0, 7068, 4094, 7268, 11362
INVAR-81, Run: 065, F, 0, 0, 316, 5615, 29916, 5499, 35415
INVAR-81, Run: 066, F, 0, 0, 316, 39119, 84495, 39003, 123498
INVAR-81, Run: 067, F, 0, 0, 316, 15203, 34736, 15087, 49823
INVAR-81, Run: 068, F, 0, 0, 316, 13558, 25080, 13442, 38522
INVAR-81, Run: 069, F, 0, 0, 316, 54536, 87441, 54420, 141861
INVAR-81, Run: 070, F, 0, 316, 0, 46865, 54082, 47065, 101147
INVAR-81, Run: 071, F, 0, 0, 316, 26274, 48483, 26158, 74641
INVAR-81, Run: 072, F, 0, 0, 316, 3317, 9057, 3201, 12258
INVAR-81, Run: 073, F, 0, 0, 316, 7916, 11275, 7800, 19075
INVAR-81, Run: 074, F, 0, 0, 316, 19080, 35586, 18964, 54550
INVAR-81, Run: 075, F, 0, 0, 316, 2553, 12967, 2437, 15404
INVAR-81, Run: 076, F, 0, 0, 316, 11077, 32909, 10961, 43870
INVAR-81, Run: 077, F, 0, 316, 0, 8890, 4598, 9090, 13688
INVAR-81, Run: 078, F, 0, 0, 316, 25749, 24919, 25633, 50552
INVAR-81, Run: 079, F, 0, 0, 316, 10304, 11833, 10188, 22021
INVAR-81, Run: 080, F, 0, 316, 0, 15253, 7224, 15453, 22677
INVAR-81, Run: 081, F, 0, 316, 0, 10653, 5880, 10853, 16733
INVAR-81, Run: 082, F, 0, 0, 316, 2793, 9417, 2677, 12094
INVAR-81, Run: 083, F, 0, 316, 0, 12120, 3824, 12320, 16144
INVAR-81, Run: 084, F, 0, 0, 316, 1185, 6229, 1069, 7298
INVAR-81, Run: 085, F, 0, 0, 316, 22408, 33839, 22292, 56131
INVAR-81, Run: 086, F, 0, 316, 0, 8961, 3698, 9161, 12859
INVAR-81, Run: 087, F, 0, 0, 316, 4744, 17878, 4628, 22506
INVAR-81, Run: 088, F, 0, 316, 0, 7956, 2664, 8156, 10820
INVAR-81, Run: 089, F, 0, 0, 316, 22016, 49650, 21900, 71550
INVAR-81, Run: 090, F, 0, 0, 316, 13201, 26863, 13085, 39948
INVAR-81, Run: 091, F, 0, 0, 316, 2606, 11524, 2490, 14014
INVAR-81, Run: 092, F, 0, 316, 0, 10428, 2908, 10628, 13536
INVAR-81, Run: 093, F, 0, 0, 316, 3496, 21345, 3380, 24725
INVAR-81, Run: 094, F, 0, 0, 316, 7507, 12643, 7391, 20034
INVAR-81, Run: 095, F, 0, 0, 316, 8376, 26467, 8260, 34727
INVAR-81, Run: 096, F, 0, 0, 316, 22522, 32780, 22406, 55186
INVAR-81, Run: 097, F, 0, 316, 0, 11877, 11085, 12077, 23162
INVAR-81, Run: 098, F, 0, 316, 0, 5448, 2005, 5648, 7653
INVAR-81, Run: 099, F, 0, 316, 0, 5427, 1733, 5627, 7360
INVAR-81, Run: 100, F, 0, 0, 316, 2616, 11861, 2500, 14361
INVAR-82, Run: 001, F, 0, 0, 81, 4541, 6447, 4510, 10957
INVAR-82, Run: 002, F, 0, 0, 81, 4305, 6260, 4274, 10534
INVAR-82, Run: 003, F, 0, 0, 81, 2669, 1891, 2638, 4529
INVAR-82, Run: 004, F, 0, 81, 0, 1328, 1672, 1378, 3050
INVAR-82, Run: 005, F, 0, 0, 81, 452, 1872, 421, 2293
INVAR-82, Run: 006, F, 0, 0, 81, 505, 1161, 474, 1635
INVAR-82, Run: 007, F, 0, 81, 0, 339, 245, 389, 634
INVAR-82, Run: 008, F, 0, 81, 0, 1585, 2452, 1635, 4087
INVAR-82, Run: 009, F, 0, 0, 81, 507, 984, 476, 1460
INVAR-82, Run: 010, F, 0, 81, 0, 1035, 576, 1085, 1661
INVAR-82, Run: 011, F, 0, 0, 81, 488, 1705, 457, 2162
INVAR-82, Run: 012, F, 0, 81, 0, 719, 394, 769, 1163
INVAR-82, Run: 013, F, 0, 0, 81, 536, 851, 505, 1356
INVAR-82, Run: 014, F, 0, 0, 81, 745, 1228, 714, 1942
INVAR-82, Run: 015, F, 0, 81, 0, 3612, 4893, 3662, 8555
INVAR-82, Run: 016, F, 0, 81, 0, 314, 216, 364, 580
INVAR-82, Run: 017, F, 0, 0, 81, 558, 1578, 527, 2105
INVAR-82, Run: 018, F, 0, 0, 81, 644, 1194, 613, 1807
INVAR-82, Run: 019, F, 0, 0, 81, 514, 1369, 483, 1852
INVAR-82, Run: 020, F, 0, 81, 0, 1102, 770, 1152, 1922
INVAR-82, Run: 021, F, 0, 0, 81, 1203, 1355, 1172, 2527
INVAR-82, Run: 022, F, 0, 81, 0, 344, 103, 394, 497
INVAR-82, Run: 023, F, 0, 0, 81, 568, 902, 537, 1439
INVAR-82, Run: 024, F, 0, 0, 81, 617, 1867, 586, 2453
INVAR-82, Run: 025, F, 0, 0, 81, 277, 903, 246, 1149
INVAR-82, Run: 026, F, 0, 0, 81, 480, 1708, 449, 2157
INVAR-82, Run: 027, F, 0, 0, 81, 492, 1643, 461, 2104
INVAR-82, Run: 028, F, 0, 0, 81, 68, 255, 37, 292
INVAR-82, Run: 029, F, 0, 81, 0, 2383, 1957, 2433, 4390
INVAR-82, Run: 030, F, 0, 81, 0, 1296, 564, 1346, 1910
INVAR-82, Run: 031, F, 0, 0, 81, 1152, 1676, 1121, 2797
INVAR-82, Run: 032, F, 0, 0, 81, 257, 1351, 226, 1577
INVAR-82, Run: 033, F, 0, 0, 81, 127, 275, 96, 371
INVAR-82, Run: 034, F, 0, 0, 81, 162, 1377, 131, 1508
INVAR-82, Run: 035, F, 0, 0, 81, 821, 1617, 790, 2407
INVAR-82, Run: 036, F, 0, 0, 81, 2280, 3643, 2249, 5892
INVAR-82, Run: 037, F, 0, 0, 81, 68, 438, 37, 475
INVAR-82, Run: 038, F, 0, 0, 81, 803, 1311, 772, 2083
INVAR-82, Run: 039, F, 0, 0, 81, 3500, 4625, 3469, 8094
INVAR-82, Run: 040, F, 0, 0, 81, 1343, 2415, 1312, 3727
INVAR-82, Run: 041, F, 0, 0, 81, 2072, 1335, 2041, 3376
INVAR-82, Run: 042, F, 0, 0, 81, 262, 558, 231, 789
INVAR-82, Run: 043, F, 0, 81, 0, 743, 352, 793, 1145
INVAR-82, Run: 044, F, 0, 0, 81, 361, 858, 330, 1188
INVAR-82, Run: 045, F, 0, 81, 0, 191, 203, 241, 444
INVAR-82, Run: 046, F, 0, 81, 0, 248, 134, 298, 432
INVAR-82, Run: 047, F, 0, 0, 81, 361, 1495, 330, 1825
INVAR-82, Run: 048, F, 0, 81, 0, 137, 84, 187, 271
INVAR-82, Run: 049, F, 0, 0, 81, 210, 588, 179, 767
INVAR-82, Run: 050, F, 0, 0, 81, 732, 1562, 701, 2263
INVAR-82, Run: 051, F, 0, 81, 0, 1521, 2048, 1571, 3619
INVAR-82, Run: 052, F, 0, 0, 81, 149, 1109, 118, 1227
INVAR-82, Run: 053, F, 0, 81, 0, 2698, 3230, 2748, 5978
INVAR-82, Run: 054, F, 0, 0, 81, 1994, 2892, 1963, 4855
INVAR-82, Run: 055, F, 0, 0, 81, 314, 647, 283, 930
INVAR-82, Run: 056, F, 0, 81, 0, 3007, 3352, 3057, 6409
INVAR-82, Run: 057, F, 0, 81, 0, 1586, 1676, 1636, 3312
INVAR-82, Run: 058, F, 0, 81, 0, 953, 1224, 1003, 2227
INVAR-82, Run: 059, F, 0, 0, 81, 220, 439, 189, 628
INVAR-82, Run: 060, F, 0, 81, 0, 484, 387, 534, 921
INVAR-82, Run: 061, F, 0, 0, 81, 1250, 2251, 1219, 3470
INVAR-82, Run: 062, F, 0, 0, 81, 1072, 2529, 1041, 3570
INVAR-82, Run: 063, F, 0, 0, 81, 176, 879, 145, 1024
INVAR-82, Run: 064, F, 0, 0, 81, 503, 777, 472, 1249
INVAR-82, Run: 065, F, 0, 0, 81, 650, 2026, 619, 2645
INVAR-82, Run: 066, F, 0, 0, 81, 847, 1510, 816, 2326
INVAR-82, Run: 067, F, 0, 0, 81, 846, 1289, 815, 2104
INVAR-82, Run: 068, F, 0, 0, 81, 160, 550, 129, 679
INVAR-82, Run: 069, F, 0, 0, 81, 971, 1259, 940, 2199
INVAR-82, Run: 070, F, 0, 81, 0, 268, 89, 318, 407
INVAR-82, Run: 071, F, 0, 81, 0, 821, 1621, 871, 2492
INVAR-82, Run: 072, F, 0, 81, 0, 2109, 2045, 2159, 4204
INVAR-82, Run: 073, F, 0, 81, 0, 2454, 3049, 2504, 5553
INVAR-82, Run: 074, F, 0, 0, 81, 151, 532, 120, 652
INVAR-82, Run: 075, F, 0, 0, 81, 1072, 2596, 1041, 3637
INVAR-82, Run: 076, F, 0, 81, 0, 631, 311, 681, 992
INVAR-82, Run: 077, F, 0, 0, 81, 2278, 3238, 2247, 5485
INVAR-82, Run: 078, F, 0, 0, 81, 1062, 2381, 1031, 3412
INVAR-82, Run: 079, F, 0, 0, 81, 2436, 2932, 2405, 5337
INVAR-82, Run: 080, F, 0, 0, 81, 511, 544, 480, 1024
INVAR-82, Run: 081, F, 0, 0, 81, 229, 449, 198, 647
INVAR-82, Run: 082, F, 0, 81, 0, 1753, 2134, 1803, 3937
INVAR-82, Run: 083, F, 0, 0, 81, 522, 1760, 491, 2251
INVAR-82, Run: 084, F, 0, 0, 81, 682, 1004, 651, 1655
INVAR-82, Run: 085, F, 0, 0, 81, 2307, 2843, 2276, 5119
INVAR-82, Run: 086, F, 0, 0, 81, 732, 1705, 701, 2406
INVAR-82, Run: 087, F, 0, 0, 81, 156, 396, 125, 521
INVAR-82, Run: 088, F, 0, 0, 81, 467, 1287, 436, 1723
INVAR-82, Run: 089, F, 0, 81, 0, 134, 77, 184, 261
INVAR-82, Run: 090, F, 0, 0, 81, 1198, 1991, 1167, 3158
INVAR-82, Run: 091, F, 0, 81, 0, 273, 132, 323, 455
INVAR-82, Run: 092, F, 0, 81, 0, 188, 122, 238, 360
INVAR-82, Run: 093, F, 0, 81, 0, 438, 524, 488, 1012
INVAR-82, Run: 094, F, 0, 81, 0, 342, 118, 392, 510
INVAR-82, Run: 095, F, 0, 81, 0, 736, 595, 786, 1381
INVAR-82, Run: 096, F, 0, 0, 81, 444, 1428, 413, 1841
INVAR-82, Run: 097, F, 0, 0, 81, 338, 922, 307, 1229
INVAR-82, Run: 098, F, 0, 81, 0, 378, 222, 428, 650
INVAR-82, Run: 099, F, 0, 81, 0, 340, 314, 390, 704
INVAR-82, Run: 100, F, 0, 0, 81, 465, 881, 434, 1315
INVAR-83, Run: 001, F, 0, 0, 133, 193, 1003, 160, 1163
INVAR-83, Run: 002, F, 0, 0, 133, 271, 1847, 238, 2085
INVAR-83, Run: 003, F, 0, 0, 133, 182, 2473, 149, 2622
INVAR-83, Run: 004, F, 0, 0, 133, 3268, 12384, 3235, 15619
INVAR-83, Run: 005, F, 0, 133, 0, 1659, 807, 1759, 2566
INVAR-83, Run: 006, F, 0, 0, 133, 591, 3737, 558, 4295
INVAR-83, Run: 007, F, 0, 0, 133, 1205, 4524, 1172, 5696
INVAR-83, Run: 008, F, 0, 0, 133, 1278, 1729, 1245, 2974
INVAR-83, Run: 009, F, 0, 0, 133, 972, 3791, 939, 4730
INVAR-83, Run: 010, F, 0, 133, 0, 3017, 2982, 3117, 6099
INVAR-83, Run: 011, F, 0, 0, 133, 199, 1325, 166, 1491
INVAR-83, Run: 012, F, 0, 133, 0, 3924, 2262, 4024, 6286
INVAR-83, Run: 013, F, 0, 133, 0, 2672, 2350, 2772, 5122
INVAR-83, Run: 014, F, 0, 0, 133, 5684, 12082, 5651, 17733
INVAR-83, Run: 015, F, 0, 0, 133, 90, 679, 57, 736
INVAR-83, Run: 016, F, 0, 0, 133, 2881, 8920, 2848, 11768
INVAR-83, Run: 017, F, 0, 0, 133, 538, 2253, 505, 2758
INVAR-83, Run: 018, F, 0, 0, 133, 246, 1108, 213, 1321
INVAR-83, Run: 019, F, 0, 0, 133, 2302, 6830, 2269, 9099
INVAR-83, Run: 020, F, 0, 0, 133, 1960, 7413, 1927, 9340
INVAR-83, Run: 021, F, 0, 0, 133, 5404, 7889, 5371, 13260
INVAR-83, Run: 022, F, 0, 0, 133, 5047, 11154, 5014, 16168
INVAR-83, Run: 023, F, 0, 0, 133, 606, 3707, 573, 4280
INVAR-83, Run: 024, F, 0, 0, 133, 793, 3844, 760, 4604
INVAR-83, Run: 025, F, 0, 0, 133, 383, 1253, 350, 1603
INVAR-83, Run: 026, F, 0, 133, 0, 2831, 1710, 2931, 4641
INVAR-83, Run: 027, F, 0, 0, 133, 1804, 6736, 1771, 8507
INVAR-83, Run: 028, F, 0, 133, 0, 2098, 1635, 2198, 3833
INVAR-83, Run: 029, F, 0, 0, 133, 6114, 13003, 6081, 19084
INVAR-83, Run: 030, F, 0, 133, 0, 5019, 4595, 5119, 9714
INVAR-83, Run: 031, F, 0, 0, 133, 1102, 4626, 1069, 5695
INVAR-83, Run: 032, F, 0, 0, 133, 821, 2769, 788, 3557
INVAR-83, Run: 033, F, 0, 0, 133, 3980, 7362, 3947, 11309
INVAR-83, Run: 034, F, 0, 0, 133, 2124, 4128, 2091, 6219
INVAR-83, Run: 035, F, 0, 133, 0, 2745, 1309, 2845, 4154
INVAR-83, Run: 036, F, 0, 133, 0, 3891, 6179, 3991, 10170
INVAR-83, Run: 037, F, 0, 0, 133, 372, 2111, 339, 2450
INVAR-83, Run: 038, F, 0, 133, 0, 1897, 1154, 1997, 3151
INVAR-83, Run: 039, F, 0, 0, 133, 5298, 10428, 5265, 15693
INVAR-83, Run: 040, F, 0, 0, 133, 700, 3273, 667, 3940
INVAR-83, Run: 041, F, 0, 0, 133, 1006, 4900, 973, 5873
INVAR-83, Run: 042, F, 0, 0, 133, 2451, 4575, 2418, 6993
INVAR-83, Run: 043, F, 0, 0, 133, 4241, 7281, 4208, 11489
INVAR-83, Run: 044, F, 0, 0, 133, 663, 4180, 630, 4810
INVAR-83, Run: 045, F, 0, 133, 0, 4277, 6339, 4377, 10716
INVAR-83, Run: 046, F, 0, 0, 133, 603, 1833, 570, 2403
INVAR-83, Run: 047, F, 0, 0, 133, 1532, 2802, 1499, 4301
INVAR-83, Run: 048, F, 0, 0, 133, 174, 2762, 141, 2903
INVAR-83, Run: 049, F, 0, 133, 0, 1964, 1842, 2064, 3906
INVAR-83, Run: 050, F, 0, 0, 133, 334, 1837, 301, 2138
INVAR-83, Run: 051, F, 0, 0, 133, 536, 3032, 503, 3535
INVAR-83, Run: 052, F, 0, 0, 133, 789, 3549, 756, 4305
INVAR-83, Run: 053, F, 0, 0, 133, 6451, 5359, 6418, 11777
INVAR-83, Run: 054, F, 0, 0, 133, 5265, 6093, 5232, 11325
INVAR-83, Run: 055, F, 0, 0, 133, 5608, 11884, 5575, 17459
INVAR-83, Run: 056, F, 0, 0, 133, 434, 1916, 401, 2317
INVAR-83, Run: 057, F, 0, 133, 0, 2726, 1180, 2826, 4006
INVAR-83, Run: 058, F, 0, 0, 133, 2401, 7145, 2368, 9513
INVAR-83, Run: 059, F, 0, 0, 133, 477, 1621, 444, 2065
INVAR-83, Run: 060, F, 0, 0, 133, 322, 2732, 289, 3021
INVAR-83, Run: 061, F, 0, 0, 133, 2497, 7630, 2464, 10094
INVAR-83, Run: 062, F, 0, 133, 0, 3964, 2498, 4064, 6562
INVAR-83, Run: 063, F, 0, 133, 0, 832, 804, 932, 1736
INVAR-83, Run: 064, F, 0, 133, 0, 1571, 1672, 1671, 3343
INVAR-83, Run: 065, F, 0, 133, 0, 2488, 2402, 2588, 4990
INVAR-83, Run: 066, F, 0, 0, 133, 3238, 8287, 3205, 11492
INVAR-83, Run: 067, F, 0, 0, 133, 193, 1885, 160, 2045
INVAR-83, Run: 068, F, 0, 133, 0, 3700, 3131, 3800, 6931
INVAR-83, Run: 069, F, 0, 0, 133, 646, 3348, 613, 3961
INVAR-83, Run: 070, F, 0, 133, 0, 4924, 4630, 5024, 9654
INVAR-83, Run: 071, F, 0, 0, 133, 2545, 6166, 2512, 8678
INVAR-83, Run: 072, F, 0, 0, 133, 842, 2722, 809, 3531
INVAR-83, Run: 073, F, 0, 0, 133, 2300, 4888, 2267, 7155
INVAR-83, Run: 074, F, 0, 133, 0, 1472, 781, 1572, 2353
INVAR-83, Run: 075, F, 0, 133, 0, 3365, 1045, 3465, 4510
INVAR-83, Run: 076, F, 0, 0, 133, 330, 1764, 297, 2061
INVAR-83, Run: 077, F, 0, 0, 133, 3470, 10047, 3437, 13484
INVAR-83, Run: 078, F, 0, 0, 133, 248, 1666, 215, 1881
INVAR-83, Run: 079, F, 0, 0, 133, 283, 2715, 250, 2965
INVAR-83, Run: 080, F, 0, 0, 133, 218, 1863, 185, 2048
INVAR-83, Run: 081, F, 0, 0, 133, 341, 1836, 308, 2144
INVAR-83, Run: 082, F, 0, 0, 133, 260, 1990, 227, 2217
INVAR-83, Run: 083, F, 0, 0, 133, 2693, 7480, 2660, 10140
INVAR-83, Run: 084, F, 0, 133, 0, 1098, 1505, 1198, 2703
INVAR-83, Run: 085, F, 0, 0, 133, 5601, 8224, 5568, 13792
INVAR-83, Run: 086, F, 0, 0, 133, 466, 2701, 433, 3134
INVAR-83, Run: 087, F, 0, 0, 133, 722, 2111, 689, 2800
INVAR-83, Run: 088, F, 0, 133, 0, 1455, 807, 1555, 2362
INVAR-83, Run: 089, F, 0, 0, 133, 3280, 5877, 3247, 9124
INVAR-83, Run: 090, F, 0, 0, 133, 1307, 2315, 1274, 3589
INVAR-83, Run: 091, F, 0, 0, 133, 249, 1292, 216, 1508
INVAR-83, Run: 092, F, 0, 0, 133, 206, 1315, 173, 1488
INVAR-83, Run: 093, F, 0, 0, 133, 488, 2773, 455, 3228
INVAR-83, Run: 094, F, 0, 0, 133, 136, 2069, 103, 2172
INVAR-83, Run: 095, F, 0, 0, 133, 417, 2009, 384, 2393
INVAR-83, Run: 096, F, 0, 0, 133, 145, 1706, 112, 1818
INVAR-83, Run: 097, F, 0, 133, 0, 1640, 2280, 1740, 4020
INVAR-83, Run: 098, F, 0, 133, 0, 1385, 859, 1485, 2344
INVAR-83, Run: 099, F, 0, 133, 0, 5311, 11904, 5411, 17315
INVAR-83, Run: 100, F, 0, 0, 133, 675, 4236, 642, 4878
INVAR-84, Run: 001, F, 0, 279, 0, 11727, 8470, 11927, 20397
INVAR-84, Run: 002, F, 0, 279, 0, 6010, 5859, 6210, 12069
INVAR-84, Run: 003, F, 0, 0, 279, 2151, 13538, 2072, 15610
INVAR-84, Run: 004, F, 0, 0, 279, 52780, 67955, 52701, 120656
INVAR-84, Run: 005, F, 0, 279, 0, 13704, 19693, 13904, 33597
INVAR-84, Run: 006, F, 0, 279, 0, 12745, 28406, 12945, 41351
INVAR-84, Run: 007, F, 0, 279, 0, 12988, 13630, 13188, 26818
INVAR-84, Run: 008, F, 0, 0, 279, 3074, 17151, 2995, 20146
INVAR-84, Run: 009, F, 0, 0, 279, 3649, 14660, 3570, 18230
INVAR-84, Run: 010, F, 0, 279, 0, 5188, 2504, 5388, 7892
INVAR-84, Run: 011, F, 0, 0, 279, 7965, 18625, 7886, 26511
INVAR-84, Run: 012, F, 0, 0, 279, 16346, 30541, 16267, 46808
INVAR-84, Run: 013, F, 0, 279, 0, 9253, 3049, 9453, 12502
INVAR-84, Run: 014, F, 0, 0, 279, 8122, 13168, 8043, 21211
INVAR-84, Run: 015, F, 0, 0, 279, 34391, 34004, 34312, 68316
INVAR-84, Run: 016, F, 0, 0, 279, 282, 4711, 203, 4914
INVAR-84, Run: 017, F, 0, 0, 279, 7206, 13174, 7127, 20301
INVAR-84, Run: 018, F, 0, 0, 279, 21512, 33497, 21433, 54930
INVAR-84, Run: 019, F, 0, 0, 279, 1477, 14108, 1398, 15506
INVAR-84, Run: 020, F, 0, 0, 279, 1239, 9024, 1160, 10184
INVAR-84, Run: 021, F, 0, 0, 279, 10985, 26709, 10906, 37615
INVAR-84, Run: 022, F, 0, 279, 0, 5463, 2891, 5663, 8554
INVAR-84, Run: 023, F, 0, 0, 279, 1637, 6879, 1558, 8437
INVAR-84, Run: 024, F, 0, 0, 279, 17415, 46021, 17336, 63357
INVAR-84, Run: 025, F, 0, 0, 279, 1421, 11334, 1342, 12676
INVAR-84, Run: 026, F, 0, 0, 279, 1321, 11038, 1242, 12280
INVAR-84, Run: 027, F, 0, 279, 0, 27991, 16376, 28191, 44567
INVAR-84, Run: 028, F, 0, 0, 279, 6737, 36820, 6658, 43478
INVAR-84, Run: 029, F, 0, 0, 279, 3698, 25500, 3619, 29119
INVAR-84, Run: 030, F, 0, 0, 279, 1693, 12219, 1614, 13833
INVAR-84, Run: 031, F, 0, 0, 279, 2593, 9302, 2514, 11816
INVAR-84, Run: 032, F, 0, 279, 0, 10241, 7819, 10441, 18260
INVAR-84, Run: 033, F, 0, 0, 279, 7172, 22404, 7093, 29497
INVAR-84, Run: 034, F, 0, 0, 279, 1695, 8918, 1616, 10534
INVAR-84, Run: 035, F, 0, 0, 279, 857, 5898, 778, 6676
INVAR-84, Run: 036, F, 0, 0, 279, 1076, 6372, 997, 7369
INVAR-84, Run: 037, F, 0, 279, 0, 10285, 24075, 10485, 34560
INVAR-84, Run: 038, F, 0, 279, 0, 9674, 14371, 9874, 24245
INVAR-84, Run: 039, F, 0, 0, 279, 933, 8518, 854, 9372
INVAR-84, Run: 040, F, 0, 0, 279, 427, 6522, 348, 6870
INVAR-84, Run: 041, F, 0, 0, 279, 845, 9205, 766, 9971
INVAR-84, Run: 042, F, 0, 0, 279, 2513, 11196, 2434, 13630
INVAR-84, Run: 043, F, 0, 0, 279, 1106, 6062, 1027, 7089
INVAR-84, Run: 044, F, 0, 279, 0, 7771, 8288, 7971, 16259
INVAR-84, Run: 045, F, 0, 0, 279, 6999, 27360, 6920, 34280
INVAR-84, Run: 046, F, 0, 0, 279, 41471, 35067, 41392, 76459
INVAR-84, Run: 047, F, 0, 0, 279, 4424, 18649, 4345, 22994
INVAR-84, Run: 048, F, 0, 279, 0, 21791, 11689, 21991, 33680
INVAR-84, Run: 049, F, 0, 0, 279, 2174, 11133, 2095, 13228
INVAR-84, Run: 050, F, 0, 0, 279, 1437, 11373, 1358, 12731
INVAR-84, Run: 051, F, 0, 0, 279, 12855, 12518, 12776, 25294
INVAR-84, Run: 052, F, 0, 0, 279, 1651, 12070, 1572, 13642
INVAR-84, Run: 053, F, 0, 0, 279, 9867, 10404, 9788, 20192
INVAR-84, Run: 054, F, 0, 0, 279, 8986, 25660, 8907, 34567
INVAR-84, Run: 055, F, 0, 279, 0, 4520, 4947, 4720, 9667
INVAR-84, Run: 056, F, 0, 0, 279, 1827, 6477, 1748, 8225
INVAR-84, Run: 057, F, 0, 0, 279, 4573, 16068, 4494, 20562
INVAR-84, Run: 058, F, 0, 0, 279, 2343, 18886, 2264, 21150
INVAR-84, Run: 059, F, 0, 0, 279, 3923, 24166, 3844, 28010
INVAR-84, Run: 060, F, 0, 0, 279, 3511, 14225, 3432, 17657
INVAR-84, Run: 061, F, 0, 0, 279, 2631, 11659, 2552, 14211
INVAR-84, Run: 062, F, 0, 0, 279, 3324, 9551, 3245, 12796
INVAR-84, Run: 063, F, 0, 279, 0, 2560, 2266, 2760, 5026
INVAR-84, Run: 064, F, 0, 0, 279, 8305, 25384, 8226, 33610
INVAR-84, Run: 065, F, 0, 0, 279, 5526, 21513, 5447, 26960
INVAR-84, Run: 066, F, 0, 279, 0, 9894, 3478, 10094, 13572
INVAR-84, Run: 067, F, 0, 0, 279, 1628, 12054, 1549, 13603
INVAR-84, Run: 068, F, 0, 279, 0, 5770, 7130, 5970, 13100
INVAR-84, Run: 069, F, 0, 0, 279, 4794, 20580, 4715, 25295
INVAR-84, Run: 070, F, 0, 279, 0, 5144, 2306, 5344, 7650
INVAR-84, Run: 071, F, 0, 0, 279, 7365, 31761, 7286, 39047
INVAR-84, Run: 072, F, 0, 0, 279, 623, 4462, 544, 5006
INVAR-84, Run: 073, F, 0, 0, 279, 1063, 5592, 984, 6576
INVAR-84, Run: 074, F, 0, 279, 0, 9061, 2154, 9261, 11415
INVAR-84, Run: 075, F, 0, 0, 279, 7145, 16531, 7066, 23597
INVAR-84, Run: 076, F, 0, 0, 279, 2026, 13588, 1947, 15535
INVAR-84, Run: 077, F, 0, 0, 279, 10721, 31437, 10642, 42079
INVAR-84, Run: 078, F, 0, 0, 279, 1839, 8314, 1760, 10074
INVAR-84, Run: 079, F, 0, 279, 0, 4677, 4491, 4877, 9368
INVAR-84, Run: 080, F, 0, 0, 279, 3444, 11277, 3365, 14642
INVAR-84, Run: 081, F, 0, 0, 279, 7719, 17750, 7640, 25390
INVAR-84, Run: 082, F, 0, 279, 0, 12668, 11562, 12868, 24430
INVAR-84, Run: 083, F, 0, 279, 0, 9670, 7833, 9870, 17703
INVAR-84, Run: 084, F, 0, 0, 279, 4028, 13718, 3949, 17667
INVAR-84, Run: 085, F, 0, 279, 0, 2949, 2689, 3149, 5838
INVAR-84, Run: 086, F, 0, 0, 279, 1843, 9937, 1764, 11701
INVAR-84, Run: 087, F, 0, 279, 0, 17530, 15777, 17730, 33507
INVAR-84, Run: 088, F, 0, 0, 279, 14964, 16151, 14885, 31036
INVAR-84, Run: 089, F, 0, 0, 279, 509, 4446, 430, 4876
INVAR-84, Run: 090, F, 0, 0, 279, 3348, 17499, 3269, 20768
INVAR-84, Run: 091, F, 0, 0, 279, 14490, 23735, 14411, 38146
INVAR-84, Run: 092, F, 0, 0, 279, 8246, 27194, 8167, 35361
INVAR-84, Run: 093, F, 0, 0, 279, 2929, 8020, 2850, 10870
INVAR-84, Run: 094, F, 0, 0, 279, 10757, 23756, 10678, 34434
INVAR-84, Run: 095, F, 0, 0, 279, 3523, 16970, 3444, 20414
INVAR-84, Run: 096, F, 0, 279, 0, 11147, 7441, 11347, 18788
INVAR-84, Run: 097, F, 0, 0, 279, 1941, 7032, 1862, 8894
INVAR-84, Run: 098, F, 0, 0, 279, 855, 7725, 776, 8501
INVAR-84, Run: 099, F, 0, 279, 0, 7673, 5200, 7873, 13073
INVAR-84, Run: 100, F, 0, 0, 279, 871, 3786, 792, 4578
INVAR-85, Run: 001, F, 0, 0, 86, 182, 727, 146, 873
INVAR-85, Run: 002, F, 0, 86, 0, 300, 69, 350, 419
INVAR-85, Run: 003, F, 0, 86, 0, 1002, 538, 1052, 1590
INVAR-85, Run: 004, F, 0, 86, 0, 704, 322, 754, 1076
INVAR-85, Run: 005, F, 0, 0, 86, 846, 1051, 810, 1861
INVAR-85, Run: 006, F, 0, 86, 0, 493, 367, 543, 910
INVAR-85, Run: 007, F, 0, 86, 0, 308, 227, 358, 585
INVAR-85, Run: 008, F, 0, 0, 86, 1088, 1968, 1052, 3020
INVAR-85, Run: 009, F, 0, 0, 86, 414, 1268, 378, 1646
INVAR-85, Run: 010, F, 0, 0, 86, 451, 1594, 415, 2009
INVAR-85, Run: 011, F, 0, 86, 0, 128, 46, 178, 224
INVAR-85, Run: 012, F, 0, 86, 0, 967, 443, 1017, 1460
INVAR-85, Run: 013, F, 0, 0, 86, 408, 2187, 372, 2559
INVAR-85, Run: 014, F, 0, 86, 0, 1258, 1164, 1308, 2472
INVAR-85, Run: 015, F, 0, 0, 86, 476, 1167, 440, 1607
INVAR-85, Run: 016, F, 0, 86, 0, 659, 245, 709, 954
INVAR-85, Run: 017, F, 0, 86, 0, 1272, 879, 1322, 2201
INVAR-85, Run: 018, F, 0, 0, 86, 505, 2221, 469, 2690
INVAR-85, Run: 019, F, 0, 0, 86, 900, 1845, 864, 2709
INVAR-85, Run: 020, F, 0, 0, 86, 230, 660, 194, 854
INVAR-85, Run: 021, F, 0, 86, 0, 278, 50, 328, 378
INVAR-85, Run: 022, F, 0, 0, 86, 774, 2087, 738, 2825
INVAR-85, Run: 023, F, 0, 0, 86, 1659, 3864, 1623, 5487
INVAR-85, Run: 024, F, 0, 0, 86, 90, 328, 54, 382
INVAR-85, Run: 025, F, 0, 86, 0, 1191, 384, 1241, 1625
INVAR-85, Run: 026, F, 0, 86, 0, 2227, 2698, 2277, 4975
INVAR-85, Run: 027, F, 0, 86, 0, 1029, 558, 1079, 1637
INVAR-85, Run: 028, F, 0, 0, 86, 1609, 3035, 1573, 4608
INVAR-85, Run: 029, F, 0, 0, 86, 311, 755, 275, 1030
INVAR-85, Run: 030, F, 0, 0, 86, 1512, 1463, 1476, 2939
INVAR-85, Run: 031, F, 0, 86, 0, 795, 1027, 845, 1872
INVAR-85, Run: 032, F, 0, 0, 86, 1679, 1932, 1643, 3575
INVAR-85, Run: 033, F, 0, 0, 86, 1413, 1118, 1377, 2495
INVAR-85, Run: 034, F, 0, 0, 86, 424, 647, 388, 1035
INVAR-85, Run: 035, F, 0, 0, 86, 300, 1073, 264, 1337
INVAR-85, Run: 036, F, 0, 0, 86, 230, 1118, 194, 1312
INVAR-85, Run: 037, F, 0, 0, 86, 712, 2063, 676, 2739
INVAR-85, Run: 038, F, 0, 0, 86, 812, 4894, 776, 5670
INVAR-85, Run: 039, F, 0, 0, 86, 4030, 5094, 3994, 9088
INVAR-85, Run: 040, F, 0, 86, 0, 267, 111, 317, 428
INVAR-85, Run: 041, F, 0, 86, 0, 1437, 1047, 1487, 2534
INVAR-85, Run: 042, F, 0, 0, 86, 157, 431, 121, 552
INVAR-85, Run: 043, F, 0, 86, 0, 294, 82, 344, 426
INVAR-85, Run: 044, F, 0, 86, 0, 451, 330, 501, 831
INVAR-85, Run: 045, F, 0, 86, 0, 2852, 2361, 2902, 5263
INVAR-85, Run: 046, F, 0, 0, 86, 1600, 1900, 1564, 3464
INVAR-85, Run: 047, F, 0, 0, 86, 994, 2645, 958, 3603
INVAR-85, Run: 048, F, 0, 0, 86, 383, 2164, 347, 2511
INVAR-85, Run: 049, F, 0, 0, 86, 680, 2746, 644, 3390
INVAR-85, Run: 050, F, 0, 86, 0, 719, 736, 769, 1505
INVAR-85, Run: 051, F, 0, 86, 0, 689, 227, 739, 966
INVAR-85, Run: 052, F, 0, 86, 0, 314, 177, 364, 541
INVAR-85, Run: 053, F, 0, 0, 86, 676, 1270, 640, 1910
INVAR-85, Run: 054, F, 0, 86, 0, 271, 100, 321, 421
INVAR-85, Run: 055, F, 0, 86, 0, 1054, 445, 1104, 1549
INVAR-85, Run: 056, F, 0, 86, 0, 598, 271, 648, 919
INVAR-85, Run: 057, F, 0, 0, 86, 2582, 3653, 2546, 6199
INVAR-85, Run: 058, F, 0, 0, 86, 974, 2196, 938, 3134
INVAR-85, Run: 059, F, 0, 0, 86, 373, 1310, 337, 1647
INVAR-85, Run: 060, F, 0, 0, 86, 649, 1382, 613, 1995
INVAR-85, Run: 061, F, 0, 0, 86, 1564, 4012, 1528, 5540
INVAR-85, Run: 062, F, 0, 0, 86, 331, 1168, 295, 1463
INVAR-85, Run: 063, F, 0, 86, 0, 1296, 495, 1346, 1841
INVAR-85, Run: 064, F, 0, 86, 0, 305, 156, 355, 511
INVAR-85, Run: 065, F, 0, 86, 0, 349, 275, 399, 674
INVAR-85, Run: 066, F, 0, 86, 0, 1274, 622, 1324, 1946
INVAR-85, Run: 067, F, 0, 86, 0, 982, 235, 1032, 1267
INVAR-85, Run: 068, F, 0, 0, 86, 354, 1019, 318, 1337
INVAR-85, Run: 069, F, 0, 86, 0, 3640, 2514, 3690, 6204
INVAR-85, Run: 070, F, 0, 0, 86, 1315, 1581, 1279, 2860
INVAR-85, Run: 071, F, 0, 0, 86, 470, 849, 434, 1283
INVAR-85, Run: 072, F, 0, 0, 86, 485, 749, 449, 1198
INVAR-85, Run: 073, F, 0, 0, 86, 628, 1745, 592, 2337
INVAR-85, Run: 074, F, 0, 0, 86, 2476, 2838, 2440, 5278
INVAR-85, Run: 075, F, 0, 0, 86, 342, 1297, 306, 1603
INVAR-85, Run: 076, F, 0, 0, 86, 1446, 1993, 1410, 3403
INVAR-85, Run: 077, F, 0, 0, 86, 560, 1241, 524, 1765
INVAR-85, Run: 078, F, 0, 0, 86, 854, 1654, 818, 2472
INVAR-85, Run: 079, F, 0, 0, 86, 1364, 1457, 1328, 2785
INVAR-85, Run: 080, F, 0, 0, 86, 284, 1709, 248, 1957
INVAR-85, Run: 081, F, 0, 0, 86, 1629, 2345, 1593, 3938
INVAR-85, Run: 082, F, 0, 0, 86, 176, 468, 140, 608
INVAR-85, Run: 083, F, 0, 0, 86, 798, 1497, 762, 2259
INVAR-85, Run: 084, F, 0, 86, 0, 336, 193, 386, 579
INVAR-85, Run: 085, F, 0, 0, 86, 1100, 2800, 1064, 3864
INVAR-85, Run: 086, F, 0, 0, 86, 1066, 2160, 1030, 3190
INVAR-85, Run: 087, F, 0, 0, 86, 286, 600, 250, 850
INVAR-85, Run: 088, F, 0, 0, 86, 1804, 2233, 1768, 4001
INVAR-85, Run: 089, F, 0, 86, 0, 1844, 2344, 1894, 4238
INVAR-85, Run: 090, F, 0, 86, 0, 746, 398, 796, 1194
INVAR-85, Run: 091, F, 0, 0, 86, 1373, 3580, 1337, 4917
INVAR-85, Run: 092, F, 0, 86, 0, 166, 69, 216, 285
INVAR-85, Run: 093, F, 0, 0, 86, 758, 3206, 722, 3928
INVAR-85, Run: 094, F, 0, 0, 86, 453, 1660, 417, 2077
INVAR-85, Run: 095, F, 0, 0, 86, 1127, 2271, 1091, 3362
INVAR-85, Run: 096, F, 0, 0, 86, 772, 2589, 736, 3325
INVAR-85, Run: 097, F, 0, 0, 86, 570, 1130, 534, 1664
INVAR-85, Run: 098, F, 0, 0, 86, 580, 1160, 544, 1704
INVAR-85, Run: 099, F, 0, 86, 0, 1195, 951, 1245, 2196
INVAR-85, Run: 100, F, 0, 0, 86, 414, 1172, 378, 1550
INVAR-86, Run: 001, F, 0, 184, 0, 14856, 11720, 14956, 26676
INVAR-86, Run: 002, F, 0, 0, 184, 822, 3621, 738, 4359
INVAR-86, Run: 003, F, 0, 0, 184, 4918, 13440, 4834, 18274
INVAR-86, Run: 004, F, 0, 184, 0, 10218, 7871, 10318, 18189
INVAR-86, Run: 005, F, 0, 184, 0, 1165, 242, 1265, 1507
INVAR-86, Run: 006, F, 0, 0, 184, 509, 2996, 425, 3421
INVAR-86, Run: 007, F, 0, 0, 184, 883, 4935, 799, 5734
INVAR-86, Run: 008, F, 0, 0, 184, 1957, 3637, 1873, 5510
INVAR-86, Run: 009, F, 0, 0, 184, 557, 2298, 473, 2771
INVAR-86, Run: 010, F, 0, 0, 184, 8057, 10820, 7973, 18793
INVAR-86, Run: 011, F, 0, 0, 184, 1165, 5425, 1081, 6506
INVAR-86, Run: 012, F, 0, 0, 184, 3882, 6314, 3798, 10112
INVAR-86, Run: 013, F, 0, 184, 0, 2631, 746, 2731, 3477
INVAR-86, Run: 014, F, 0, 0, 184, 1425, 3370, 1341, 4711
INVAR-86, Run: 015, F, 0, 184, 0, 3819, 1281, 3919, 5200
INVAR-86, Run: 016, F, 0, 0, 184, 1991, 6050, 1907, 7957
INVAR-86, Run: 017, F, 0, 0, 184, 4317, 9719, 4233, 13952
INVAR-86, Run: 018, F, 0, 184, 0, 3154, 3046, 3254, 6300
INVAR-86, Run: 019, F, 0, 0, 184, 2112, 6853, 2028, 8881
INVAR-86, Run: 020, F, 0, 184, 0, 1178, 495, 1278, 1773
INVAR-86, Run: 021, F, 0, 184, 0, 632, 208, 732, 940
INVAR-86, Run: 022, F, 0, 184, 0, 8917, 4213, 9017, 13230
INVAR-86, Run: 023, F, 0, 0, 184, 7189, 18411, 7105, 25516
INVAR-86, Run: 024, F, 0, 184, 0, 3933, 2999, 4033, 7032
INVAR-86, Run: 025, F, 0, 0, 184, 3458, 12754, 3374, 16128
INVAR-86, Run: 026, F, 0, 184, 0, 3606, 1132, 3706, 4838
INVAR-86, Run: 027, F, 0, 184, 0, 2677, 1152, 2777, 3929
INVAR-86, Run: 028, F, 0, 0, 184, 4358, 16107, 4274, 20381
INVAR-86, Run: 029, F, 0, 0, 184, 5076, 13855, 4992, 18847
INVAR-86, Run: 030, F, 0, 0, 184, 726, 5018, 642, 5660
INVAR-86, Run: 031, F, 0, 184, 0, 4514, 5526, 4614, 10140
INVAR-86, Run: 032, F, 0, 0, 184, 3818, 7617, 3734, 11351
INVAR-86, Run: 033, F, 0, 184, 0, 7462, 10971, 7562, 18533
INVAR-86, Run: 034, F, 0, 184, 0, 4608, 2644, 4708, 7352
INVAR-86, Run: 035, F, 0, 184, 0, 5608, 3855, 5708, 9563
INVAR-86, Run: 036, F, 0, 0, 184, 4267, 12167, 4183, 16350
INVAR-86, Run: 037, F, 0, 184, 0, 5133, 2675, 5233, 7908
INVAR-86, Run: 038, F, 0, 0, 184, 2315, 17804, 2231, 20035
INVAR-86, Run: 039, F, 0, 184, 0, 3301, 779, 3401, 4180
INVAR-86, Run: 040, F, 0, 184, 0, 32828, 26416, 32928, 59344
INVAR-86, Run: 041, F, 0, 0, 184, 944, 4882, 860, 5742
INVAR-86, Run: 042, F, 0, 0, 184, 22791, 20088, 22707, 42795
INVAR-86, Run: 043, F, 0, 184, 0, 5059, 2911, 5159, 8070
INVAR-86, Run: 044, F, 0, 0, 184, 3573, 5240, 3489, 8729
INVAR-86, Run: 045, F, 0, 184, 0, 3043, 1350, 3143, 4493
INVAR-86, Run: 046, F, 0, 0, 184, 6821, 9477, 6737, 16214
INVAR-86, Run: 047, F, 0, 0, 184, 3555, 6553, 3471, 10024
INVAR-86, Run: 048, F, 0, 0, 184, 3963, 9583, 3879, 13462
INVAR-86, Run: 049, F, 0, 184, 0, 4287, 1520, 4387, 5907
INVAR-86, Run: 050, F, 0, 184, 0, 1240, 332, 1340, 1672
INVAR-86, Run: 051, F, 0, 184, 0, 2813, 726, 2913, 3639
INVAR-86, Run: 052, F, 0, 184, 0, 11186, 10550, 11286, 21836
INVAR-86, Run: 053, F, 0, 184, 0, 6362, 2293, 6462, 8755
INVAR-86, Run: 054, F, 0, 0, 184, 3488, 8197, 3404, 11601
INVAR-86, Run: 055, F, 0, 184, 0, 1797, 760, 1897, 2657
INVAR-86, Run: 056, F, 0, 184, 0, 2087, 554, 2187, 2741
INVAR-86, Run: 057, F, 0, 184, 0, 4255, 3685, 4355, 8040
INVAR-86, Run: 058, F, 0, 184, 0, 2628, 674, 2728, 3402
INVAR-86, Run: 059, F, 0, 0, 184, 5684, 11362, 5600, 16962
INVAR-86, Run: 060, F, 0, 0, 184, 9682, 13845, 9598, 23443
INVAR-86, Run: 061, F, 0, 0, 184, 4187, 12068, 4103, 16171
INVAR-86, Run: 062, F, 0, 0, 184, 947, 2623, 863, 3486
INVAR-86, Run: 063, F, 0, 184, 0, 3211, 884, 3311, 4195
INVAR-86, Run: 064, F, 0, 0, 184, 4967, 15046, 4883, 19929
INVAR-86, Run: 065, F, 0, 0, 184, 2702, 5647, 2618, 8265
INVAR-86, Run: 066, F, 0, 184, 0, 4447, 2968, 4547, 7515
INVAR-86, Run: 067, F, 0, 0, 184, 8447, 13395, 8363, 21758
INVAR-86, Run: 068, F, 0, 184, 0, 10837, 20025, 10937, 30962
INVAR-86, Run: 069, F, 0, 184, 0, 4416, 4127, 4516, 8643
INVAR-86, Run: 070, F, 0, 184, 0, 11155, 7259, 11255, 18514
INVAR-86, Run: 071, F, 0, 184, 0, 2024, 695, 2124, 2819
INVAR-86, Run: 072, F, 0, 184, 0, 629, 178, 729, 907
INVAR-86, Run: 073, F, 0, 0, 184, 1916, 2935, 1832, 4767
INVAR-86, Run: 074, F, 0, 0, 184, 1738, 7559, 1654, 9213
INVAR-86, Run: 075, F, 0, 0, 184, 3429, 6736, 3345, 10081
INVAR-86, Run: 076, F, 0, 0, 184, 3940, 3397, 3856, 7253
INVAR-86, Run: 077, F, 0, 184, 0, 4859, 2562, 4959, 7521
INVAR-86, Run: 078, F, 0, 184, 0, 11668, 6866, 11768, 18634
INVAR-86, Run: 079, F, 0, 184, 0, 7123, 7081, 7223, 14304
INVAR-86, Run: 080, F, 0, 0, 184, 3443, 7305, 3359, 10664
INVAR-86, Run: 081, F, 0, 0, 184, 3720, 4720, 3636, 8356
INVAR-86, Run: 082, F, 0, 184, 0, 4105, 1667, 4205, 5872
INVAR-86, Run: 083, F, 0, 0, 184, 1517, 11675, 1433, 13108
INVAR-86, Run: 084, F, 0, 184, 0, 740, 330, 840, 1170
INVAR-86, Run: 085, F, 0, 0, 184, 1901, 9897, 1817, 11714
INVAR-86, Run: 086, F, 0, 184, 0, 3268, 1524, 3368, 4892
INVAR-86, Run: 087, F, 0, 0, 184, 2543, 6440, 2459, 8899
INVAR-86, Run: 088, F, 0, 0, 184, 1601, 5004, 1517, 6521
INVAR-86, Run: 089, F, 0, 184, 0, 1514, 645, 1614, 2259
INVAR-86, Run: 090, F, 0, 184, 0, 4941, 1487, 5041, 6528
INVAR-86, Run: 091, F, 0, 0, 184, 1141, 5932, 1057, 6989
INVAR-86, Run: 092, F, 0, 184, 0, 1960, 561, 2060, 2621
INVAR-86, Run: 093, F, 0, 0, 184, 1306, 3042, 1222, 4264
INVAR-86, Run: 094, F, 0, 0, 184, 2149, 4245, 2065, 6310
INVAR-86, Run: 095, F, 0, 0, 184, 6572, 11092, 6488, 17580
INVAR-86, Run: 096, F, 0, 0, 184, 3012, 7055, 2928, 9983
INVAR-86, Run: 097, F, 0, 0, 184, 4747, 6500, 4663, 11163
INVAR-86, Run: 098, F, 0, 0, 184, 692, 2168, 608, 2776
INVAR-86, Run: 099, F, 0, 0, 184, 5967, 7592, 5883, 13475
INVAR-86, Run: 100, F, 0, 184, 0, 3886, 1476, 3986, 5462
INVAR-87, Run: 001, F, 0, 388, 0, 57085, 74858, 57285, 132143
INVAR-87, Run: 002, F, 0, 0, 388, 35194, 47224, 35006, 82230
INVAR-87, Run: 003, F, 0, 0, 388, 4419, 12408, 4231, 16639
INVAR-87, Run: 004, F, 0, 0, 388, 14880, 48438, 14692, 63130
INVAR-87, Run: 005, F, 0, 0, 388, 7108, 15328, 6920, 22248
INVAR-87, Run: 006, F, 0, 0, 388, 19962, 59171, 19774, 78945
INVAR-87, Run: 007, F, 0, 388, 0, 8104, 1921, 8304, 10225
INVAR-87, Run: 008, F, 0, 388, 0, 3408, 695, 3608, 4303
INVAR-87, Run: 009, F, 0, 388, 0, 23524, 6594, 23724, 30318
INVAR-87, Run: 010, F, 0, 0, 388, 26396, 43796, 26208, 70004
INVAR-87, Run: 011, F, 0, 0, 388, 4698, 22655, 4510, 27165
INVAR-87, Run: 012, F, 0, 388, 0, 13796, 4305, 13996, 18301
INVAR-87, Run: 013, F, 0, 388, 0, 9699, 2013, 9899, 11912
INVAR-87, Run: 014, F, 0, 0, 388, 5602, 19655, 5414, 25069
INVAR-87, Run: 015, F, 0, 0, 388, 29625, 34037, 29437, 63474
INVAR-87, Run: 016, F, 0, 0, 388, 10894, 21632, 10706, 32338
INVAR-87, Run: 017, F, 0, 388, 0, 32616, 16548, 32816, 49364
INVAR-87, Run: 018, F, 0, 0, 388, 15271, 28084, 15083, 43167
INVAR-87, Run: 019, F, 0, 0, 388, 21607, 37948, 21419, 59367
INVAR-87, Run: 020, F, 0, 388, 0, 5962, 2012, 6162, 8174
INVAR-87, Run: 021, F, 0, 388, 0, 9442, 2457, 9642, 12099
INVAR-87, Run: 022, F, 0, 388, 0, 5716, 1758, 5916, 7674
INVAR-87, Run: 023, F, 0, 388, 0, 5653, 1982, 5853, 7835
INVAR-87, Run: 024, F, 0, 388, 0, 23005, 13757, 23205, 36962
INVAR-87, Run: 025, F, 0, 388, 0, 13644, 5923, 13844, 19767
INVAR-87, Run: 026, F, 0, 388, 0, 27117, 9886, 27317, 37203
INVAR-87, Run: 027, F, 0, 388, 0, 38559, 34977, 38759, 73736
INVAR-87, Run: 028, F, 0, 0, 388, 6813, 25764, 6625, 32389
INVAR-87, Run: 029, F, 0, 0, 388, 25915, 68164, 25727, 93891
INVAR-87, Run: 030, F, 0, 388, 0, 13830, 5603, 14030, 19633
INVAR-87, Run: 031, F, 0, 388, 0, 18166, 8120, 18366, 26486
INVAR-87, Run: 032, F, 0, 388, 0, 33104, 22871, 33304, 56175
INVAR-87, Run: 033, F, 0, 388, 0, 15014, 5044, 15214, 20258
INVAR-87, Run: 034, F, 0, 0, 388, 40389, 35907, 40201, 76108
INVAR-87, Run: 035, F, 0, 0, 388, 3105, 16943, 2917, 19860
INVAR-87, Run: 036, F, 0, 0, 388, 25013, 46190, 24825, 71015
INVAR-87, Run: 037, F, 0, 0, 388, 23529, 84130, 23341, 107471
INVAR-87, Run: 038, F, 0, 0, 388, 15566, 27385, 15378, 42763
INVAR-87, Run: 039, F, 0, 0, 388, 7132, 24780, 6944, 31724
INVAR-87, Run: 040, F, 0, 388, 0, 20363, 7957, 20563, 28520
INVAR-87, Run: 041, F, 0, 388, 0, 13139, 3006, 13339, 16345
INVAR-87, Run: 042, F, 0, 388, 0, 7820, 3544, 8020, 11564
INVAR-87, Run: 043, F, 0, 0, 388, 6498, 22943, 6310, 29253
INVAR-87, Run: 044, F, 0, 388, 0, 10175, 3553, 10375, 13928
INVAR-87, Run: 045, F, 0, 0, 388, 47300, 61703, 47112, 108815
INVAR-87, Run: 046, F, 0, 0, 388, 14451, 37227, 14263, 51490
INVAR-87, Run: 047, F, 0, 388, 0, 22104, 13693, 22304, 35997
INVAR-87, Run: 048, F, 0, 0, 388, 33483, 70521, 33295, 103816
INVAR-87, Run: 049, F, 0, 0, 388, 10981, 32530, 10793, 43323
INVAR-87, Run: 050, F, 0, 388, 0, 8059, 1914, 8259, 10173
INVAR-87, Run: 051, F, 0, 0, 388, 15266, 38157, 15078, 53235
INVAR-87, Run: 052, F, 0, 0, 388, 7641, 17376, 7453, 24829
INVAR-87, Run: 053, F, 0, 0, 388, 16241, 30896, 16053, 46949
INVAR-87, Run: 054, F, 0, 0, 388, 32152, 72287, 31964, 104251
INVAR-87, Run: 055, F, 0, 0, 388, 4753, 14635, 4565, 19200
INVAR-87, Run: 056, F, 0, 388, 0, 14211, 6357, 14411, 20768
INVAR-87, Run: 057, F, 0, 0, 388, 14467, 43329, 14279, 57608
INVAR-87, Run: 058, F, 0, 388, 0, 15813, 3125, 16013, 19138
INVAR-87, Run: 059, F, 0, 388, 0, 11924, 5854, 12124, 17978
INVAR-87, Run: 060, F, 0, 388, 0, 7849, 5695, 8049, 13744
INVAR-87, Run: 061, F, 0, 388, 0, 12837, 5726, 13037, 18763
INVAR-87, Run: 062, F, 0, 0, 388, 8596, 15137, 8408, 23545
INVAR-87, Run: 063, F, 0, 0, 388, 7177, 22349, 6989, 29338
INVAR-87, Run: 064, F, 0, 388, 0, 5409, 2652, 5609, 8261
INVAR-87, Run: 065, F, 0, 388, 0, 16572, 6029, 16772, 22801
INVAR-87, Run: 066, F, 0, 388, 0, 2199, 739, 2399, 3138
INVAR-87, Run: 067, F, 0, 388, 0, 9377, 3254, 9577, 12831
INVAR-87, Run: 068, F, 0, 388, 0, 53957, 53470, 54157, 107627
INVAR-87, Run: 069, F, 0, 388, 0, 16464, 19256, 16664, 35920
INVAR-87, Run: 070, F, 0, 0, 388, 2400, 11180, 2212, 13392
INVAR-87, Run: 071, F, 0, 388, 0, 5224, 968, 5424, 6392
INVAR-87, Run: 072, F, 0, 0, 388, 47824, 64112, 47636, 111748
INVAR-87, Run: 073, F, 0, 0, 388, 3504, 10450, 3316, 13766
INVAR-87, Run: 074, F, 0, 0, 388, 13158, 28156, 12970, 41126
INVAR-87, Run: 075, F, 0, 388, 0, 9706, 5096, 9906, 15002
INVAR-87, Run: 076, F, 0, 0, 388, 70410, 92769, 70222, 162991
INVAR-87, Run: 077, F, 0, 0, 388, 18516, 35990, 18328, 54318
INVAR-87, Run: 078, F, 0, 0, 388, 21982, 57868, 21794, 79662
INVAR-87, Run: 079, F, 0, 388, 0, 3293, 761, 3493, 4254
INVAR-87, Run: 080, F, 0, 0, 388, 8301, 16746, 8113, 24859
INVAR-87, Run: 081, F, 0, 0, 388, 39609, 63870, 39421, 103291
INVAR-87, Run: 082, F, 0, 0, 388, 11722, 15650, 11534, 27184
INVAR-87, Run: 083, F, 0, 388, 0, 22026, 9175, 22226, 31401
INVAR-87, Run: 084, F, 0, 388, 0, 19061, 11226, 19261, 30487
INVAR-87, Run: 085, F, 0, 0, 388, 3854, 10273, 3666, 13939
INVAR-87, Run: 086, F, 0, 388, 0, 11861, 4236, 12061, 16297
INVAR-87, Run: 087, F, 0, 0, 388, 5265, 31337, 5077, 36414
INVAR-87, Run: 088, F, 0, 388, 0, 5477, 3786, 5677, 9463
INVAR-87, Run: 089, F, 0, 388, 0, 23985, 12996, 24185, 37181
INVAR-87, Run: 090, F, 0, 388, 0, 4035, 1075, 4235, 5310
INVAR-87, Run: 091, F, 0, 388, 0, 9777, 6116, 9977, 16093
INVAR-87, Run: 092, F, 0, 0, 388, 23401, 19134, 23213, 42347
INVAR-87, Run: 093, F, 0, 0, 388, 28058, 57919, 27870, 85789
INVAR-87, Run: 094, F, 0, 0, 388, 70954, 142158, 70766, 212924
INVAR-87, Run: 095, F, 0, 388, 0, 41318, 53220, 41518, 94738
INVAR-87, Run: 096, F, 0, 0, 388, 3915, 25847, 3727, 29574
INVAR-87, Run: 097, F, 0, 388, 0, 9037, 4541, 9237, 13778
INVAR-87, Run: 098, F, 0, 0, 388, 37071, 47487, 36883, 84370
INVAR-87, Run: 099, F, 0, 0, 388, 24889, 42392, 24701, 67093
INVAR-87, Run: 100, F, 0, 0, 388, 39885, 60129, 39697, 99826
INVAR-88, Run: 001, F, 0, 99, 0, 296, 85, 346, 431
INVAR-88, Run: 002, F, 0, 0, 99, 397, 1471, 348, 1819
INVAR-88, Run: 003, F, 0, 99, 0, 695, 228, 745, 973
INVAR-88, Run: 004, F, 0, 99, 0, 1105, 316, 1155, 1471
INVAR-88, Run: 005, F, 0, 99, 0, 1223, 576, 1273, 1849
INVAR-88, Run: 006, F, 0, 0, 99, 1084, 4176, 1035, 5211
INVAR-88, Run: 007, F, 0, 99, 0, 955, 332, 1005, 1337
INVAR-88, Run: 008, F, 0, 0, 99, 1117, 3174, 1068, 4242
INVAR-88, Run: 009, F, 0, 0, 99, 385, 1402, 336, 1738
INVAR-88, Run: 010, F, 0, 99, 0, 2513, 1467, 2563, 4030
INVAR-88, Run: 011, F, 0, 99, 0, 6171, 7277, 6221, 13498
INVAR-88, Run: 012, F, 0, 0, 99, 380, 1389, 331, 1720
INVAR-88, Run: 013, F, 0, 99, 0, 2913, 2398, 2963, 5361
INVAR-88, Run: 014, F, 0, 0, 99, 1631, 2536, 1582, 4118
INVAR-88, Run: 015, F, 0, 99, 0, 1693, 1566, 1743, 3309
INVAR-88, Run: 016, F, 0, 99, 0, 1743, 819, 1793, 2612
INVAR-88, Run: 017, F, 0, 99, 0, 1586, 674, 1636, 2310
INVAR-88, Run: 018, F, 0, 99, 0, 1490, 477, 1540, 2017
INVAR-88, Run: 019, F, 0, 0, 99, 3023, 4734, 2974, 7708
INVAR-88, Run: 020, F, 0, 0, 99, 953, 1598, 904, 2502
INVAR-88, Run: 021, F, 0, 99, 0, 299, 75, 349, 424
INVAR-88, Run: 022, F, 0, 99, 0, 761, 681, 811, 1492
INVAR-88, Run: 023, F, 0, 99, 0, 1139, 430, 1189, 1619
INVAR-88, Run: 024, F, 0, 99, 0, 301, 85, 351, 436
INVAR-88, Run: 025, F, 0, 99, 0, 1954, 817, 2004, 2821
INVAR-88, Run: 026, F, 0, 0, 99, 1200, 1589, 1151, 2740
INVAR-88, Run: 027, F, 0, 0, 99, 2313, 3104, 2264, 5368
INVAR-88, Run: 028, F, 0, 99, 0, 803, 337, 853, 1190
INVAR-88, Run: 029, F, 0, 0, 99, 218, 536, 169, 705
INVAR-88, Run: 030, F, 0, 99, 0, 487, 314, 537, 851
INVAR-88, Run: 031, F, 0, 99, 0, 3442, 1738, 3492, 5230
INVAR-88, Run: 032, F, 0, 99, 0, 573, 600, 623, 1223
INVAR-88, Run: 033, F, 0, 99, 0, 2070, 2765, 2120, 4885
INVAR-88, Run: 034, F, 0, 99, 0, 249, 57, 299, 356
INVAR-88, Run: 035, F, 0, 99, 0, 245, 50, 295, 345
INVAR-88, Run: 036, F, 0, 0, 99, 1825, 2544, 1776, 4320
INVAR-88, Run: 037, F, 0, 99, 0, 187, 68, 237, 305
INVAR-88, Run: 038, F, 0, 99, 0, 833, 205, 883, 1088
INVAR-88, Run: 039, F, 0, 0, 99, 1023, 1571, 974, 2545
INVAR-88, Run: 040, F, 0, 99, 0, 607, 158, 657, 815
INVAR-88, Run: 041, F, 0, 0, 99, 252, 685, 203, 888
INVAR-88, Run: 042, F, 0, 0, 99, 1461, 4375, 1412, 5787
INVAR-88, Run: 043, F, 0, 0, 99, 346, 744, 297, 1041
INVAR-88, Run: 044, F, 0, 99, 0, 310, 90, 360, 450
INVAR-88, Run: 045, F, 0, 0, 99, 889, 1913, 840, 2753
INVAR-88, Run: 046, F, 0, 0, 99, 513, 967, 464, 1431
INVAR-88, Run: 047, F, 0, 0, 99, 1936, 3032, 1887, 4919
INVAR-88, Run: 048, F, 0, 0, 99, 403, 1142, 354, 1496
INVAR-88, Run: 049, F, 0, 99, 0, 1774, 541, 1824, 2365
INVAR-88, Run: 050, F, 0, 0, 99, 1718, 2889, 1669, 4558
INVAR-88, Run: 051, F, 0, 0, 99, 551, 958, 502, 1460
INVAR-88, Run: 052, F, 0, 99, 0, 524, 160, 574, 734
INVAR-88, Run: 053, F, 0, 99, 0, 232, 89, 282, 371
INVAR-88, Run: 054, F, 0, 0, 99, 404, 845, 355, 1200
INVAR-88, Run: 055, F, 0, 0, 99, 185, 1374, 136, 1510
INVAR-88, Run: 056, F, 0, 0, 99, 652, 2363, 603, 2966
INVAR-88, Run: 057, F, 0, 0, 99, 838, 2387, 789, 3176
INVAR-88, Run: 058, F, 0, 99, 0, 1007, 965, 1057, 2022
INVAR-88, Run: 059, F, 0, 99, 0, 1553, 1057, 1603, 2660
INVAR-88, Run: 060, F, 0, 99, 0, 167, 66, 217, 283
INVAR-88, Run: 061, F, 0, 0, 99, 1471, 1974, 1422, 3396
INVAR-88, Run: 062, F, 0, 99, 0, 822, 524, 872, 1396
INVAR-88, Run: 063, F, 0, 99, 0, 7991, 5062, 8041, 13103
INVAR-88, Run: 064, F, 0, 99, 0, 410, 176, 460, 636
INVAR-88, Run: 065, F, 0, 99, 0, 1276, 333, 1326, 1659
INVAR-88, Run: 066, F, 0, 99, 0, 1356, 2593, 1406, 3999
INVAR-88, Run: 067, F, 0, 0, 99, 2788, 2476, 2739, 5215
INVAR-88, Run: 068, F, 0, 99, 0, 1699, 1900, 1749, 3649
INVAR-88, Run: 069, F, 0, 99, 0, 849, 275, 899, 1174
INVAR-88, Run: 070, F, 0, 99, 0, 1313, 427, 1363, 1790
INVAR-88, Run: 071, F, 0, 0, 99, 775, 2880, 726, 3606
INVAR-88, Run: 072, F, 0, 99, 0, 3700, 1546, 3750, 5296
INVAR-88, Run: 073, F, 0, 99, 0, 880, 431, 930, 1361
INVAR-88, Run: 074, F, 0, 0, 99, 1435, 4468, 1386, 5854
INVAR-88, Run: 075, F, 0, 0, 99, 1035, 1645, 986, 2631
INVAR-88, Run: 076, F, 0, 99, 0, 901, 632, 951, 1583
INVAR-88, Run: 077, F, 0, 99, 0, 876, 635, 926, 1561
INVAR-88, Run: 078, F, 0, 99, 0, 414, 74, 464, 538
INVAR-88, Run: 079, F, 0, 0, 99, 1273, 4114, 1224, 5338
INVAR-88, Run: 080, F, 0, 99, 0, 505, 122, 555, 677
INVAR-88, Run: 081, F, 0, 0, 99, 1409, 2395, 1360, 3755
INVAR-88, Run: 082, F, 0, 0, 99, 665, 1494, 616, 2110
INVAR-88, Run: 083, F, 0, 0, 99, 3954, 4083, 3905, 7988
INVAR-88, Run: 084, F, 0, 99, 0, 3544, 2467, 3594, 6061
INVAR-88, Run: 085, F, 0, 99, 0, 397, 67, 447, 514
INVAR-88, Run: 086, F, 0, 0, 99, 1026, 1495, 977, 2472
INVAR-88, Run: 087, F, 0, 0, 99, 4719, 5649, 4670, 10319
INVAR-88, Run: 088, F, 0, 99, 0, 512, 134, 562, 696
INVAR-88, Run: 089, F, 0, 0, 99, 494, 1582, 445, 2027
INVAR-88, Run: 090, F, 0, 99, 0, 135, 50, 185, 235
INVAR-88, Run: 091, F, 0, 99, 0, 592, 343, 642, 985
INVAR-88, Run: 092, F, 0, 99, 0, 1885, 894, 1935, 2829
INVAR-88, Run: 093, F, 0, 99, 0, 499, 108, 549, 657
INVAR-88, Run: 094, F, 0, 0, 99, 413, 1732, 364, 2096
INVAR-88, Run: 095, F, 0, 0, 99, 1244, 2338, 1195, 3533
INVAR-88, Run: 096, F, 0, 99, 0, 785, 483, 835, 1318
INVAR-88, Run: 097, F, 0, 0, 99, 862, 1162, 813, 1975
INVAR-88, Run: 098, F, 0, 99, 0, 630, 379, 680, 1059
INVAR-88, Run: 099, F, 0, 0, 99, 542, 817, 493, 1310
INVAR-88, Run: 100, F, 0, 0, 99, 2133, 4819, 2084, 6903
INVAR-89, Run: 001, F, 0, 0, 177, 1634, 6963, 1557, 8520
INVAR-89, Run: 002, F, 0, 177, 0, 2470, 1014, 2570, 3584
INVAR-89, Run: 003, F, 0, 177, 0, 10565, 16951, 10665, 27616
INVAR-89, Run: 004, F, 0, 177, 0, 3107, 2680, 3207, 5887
INVAR-89, Run: 005, F, 0, 0, 177, 1280, 6787, 1203, 7990
INVAR-89, Run: 006, F, 0, 0, 177, 4642, 6471, 4565, 11036
INVAR-89, Run: 007, F, 0, 0, 177, 929, 2870, 852, 3722
INVAR-89, Run: 008, F, 0, 177, 0, 2601, 1412, 2701, 4113
INVAR-89, Run: 009, F, 0, 0, 177, 775, 2696, 698, 3394
INVAR-89, Run: 010, F, 0, 0, 177, 1736, 4132, 1659, 5791
INVAR-89, Run: 011, F, 0, 177, 0, 3137, 2724, 3237, 5961
INVAR-89, Run: 012, F, 0, 177, 0, 2938, 1131, 3038, 4169
INVAR-89, Run: 013, F, 0, 177, 0, 1462, 334, 1562, 1896
INVAR-89, Run: 014, F, 0, 177, 0, 2560, 922, 2660, 3582
INVAR-89, Run: 015, F, 0, 0, 177, 7140, 11454, 7063, 18517
INVAR-89, Run: 016, F, 0, 0, 177, 2920, 13882, 2843, 16725
INVAR-89, Run: 017, F, 0, 0, 177, 826, 2235, 749, 2984
INVAR-89, Run: 018, F, 0, 177, 0, 1303, 326, 1403, 1729
INVAR-89, Run: 019, F, 0, 0, 177, 4469, 16068, 4392, 20460
INVAR-89, Run: 020, F, 0, 0, 177, 1613, 3849, 1536, 5385
INVAR-89, Run: 021, F, 0, 0, 177, 2401, 2528, 2324, 4852
INVAR-89, Run: 022, F, 0, 177, 0, 1923, 917, 2023, 2940
INVAR-89, Run: 023, F, 0, 177, 0, 5981, 4257, 6081, 10338
INVAR-89, Run: 024, F, 0, 0, 177, 2420, 13703, 2343, 16046
INVAR-89, Run: 025, F, 0, 0, 177, 2878, 8615, 2801, 11416
INVAR-89, Run: 026, F, 0, 177, 0, 3203, 2270, 3303, 5573
INVAR-89, Run: 027, F, 0, 177, 0, 4304, 1907, 4404, 6311
INVAR-89, Run: 028, F, 0, 177, 0, 2040, 2903, 2140, 5043
INVAR-89, Run: 029, F, 0, 0, 177, 9378, 13210, 9301, 22511
INVAR-89, Run: 030, F, 0, 0, 177, 2284, 6471, 2207, 8678
INVAR-89, Run: 031, F, 0, 177, 0, 2000, 1792, 2100, 3892
INVAR-89, Run: 032, F, 0, 0, 177, 2923, 7183, 2846, 10029
INVAR-89, Run: 033, F, 0, 0, 177, 1536, 4963, 1459, 6422
INVAR-89, Run: 034, F, 0, 0, 177, 2081, 12415, 2004, 14419
INVAR-89, Run: 035, F, 0, 0, 177, 4750, 12840, 4673, 17513
INVAR-89, Run: 036, F, 0, 0, 177, 379, 1475, 302, 1777
INVAR-89, Run: 037, F, 0, 0, 177, 5481, 8315, 5404, 13719
INVAR-89, Run: 038, F, 0, 0, 177, 1705, 5454, 1628, 7082
INVAR-89, Run: 039, F, 0, 0, 177, 3080, 12906, 3003, 15909
INVAR-89, Run: 040, F, 0, 177, 0, 890, 296, 990, 1286
INVAR-89, Run: 041, F, 0, 0, 177, 4237, 11047, 4160, 15207
INVAR-89, Run: 042, F, 0, 0, 177, 6217, 8907, 6140, 15047
INVAR-89, Run: 043, F, 0, 177, 0, 842, 252, 942, 1194
INVAR-89, Run: 044, F, 0, 0, 177, 2684, 6432, 2607, 9039
INVAR-89, Run: 045, F, 0, 177, 0, 1996, 768, 2096, 2864
INVAR-89, Run: 046, F, 0, 0, 177, 3173, 11579, 3096, 14675
INVAR-89, Run: 047, F, 0, 0, 177, 2093, 4367, 2016, 6383
INVAR-89, Run: 048, F, 0, 0, 177, 2134, 6147, 2057, 8204
INVAR-89, Run: 049, F, 0, 177, 0, 3214, 1251, 3314, 4565
INVAR-89, Run: 050, F, 0, 177, 0, 2787, 646, 2887, 3533
INVAR-89, Run: 051, F, 0, 177, 0, 3602, 1097, 3702, 4799
INVAR-89, Run: 052, F, 0, 177, 0, 3414, 2482, 3514, 5996
INVAR-89, Run: 053, F, 0, 177, 0, 2717, 2122, 2817, 4939
INVAR-89, Run: 054, F, 0, 0, 177, 4355, 8689, 4278, 12967
INVAR-89, Run: 055, F, 0, 177, 0, 3004, 1638, 3104, 4742
INVAR-89, Run: 056, F, 0, 177, 0, 5095, 1885, 5195, 7080
INVAR-89, Run: 057, F, 0, 177, 0, 1066, 192, 1166, 1358
INVAR-89, Run: 058, F, 0, 177, 0, 2376, 1445, 2476, 3921
INVAR-89, Run: 059, F, 0, 0, 177, 5641, 17857, 5564, 23421
INVAR-89, Run: 060, F, 0, 177, 0, 1145, 379, 1245, 1624
INVAR-89, Run: 061, F, 0, 177, 0, 5787, 3269, 5887, 9156
INVAR-89, Run: 062, F, 0, 0, 177, 2828, 9312, 2751, 12063
INVAR-89, Run: 063, F, 0, 177, 0, 5609, 4769, 5709, 10478
INVAR-89, Run: 064, F, 0, 177, 0, 1797, 1044, 1897, 2941
INVAR-89, Run: 065, F, 0, 177, 0, 2459, 457, 2559, 3016
INVAR-89, Run: 066, F, 0, 0, 177, 7221, 20885, 7144, 28029
INVAR-89, Run: 067, F, 0, 177, 0, 904, 208, 1004, 1212
INVAR-89, Run: 068, F, 0, 177, 0, 2922, 1073, 3022, 4095
INVAR-89, Run: 069, F, 0, 0, 177, 446, 2419, 369, 2788
INVAR-89, Run: 070, F, 0, 0, 177, 2345, 4531, 2268, 6799
INVAR-89, Run: 071, F, 0, 0, 177, 4471, 6757, 4394, 11151
INVAR-89, Run: 072, F, 0, 0, 177, 714, 3327, 637, 3964
INVAR-89, Run: 073, F, 0, 177, 0, 11832, 24309, 11932, 36241
INVAR-89, Run: 074, F, 0, 177, 0, 1714, 497, 1814, 2311
INVAR-89, Run: 075, F, 0, 0, 177, 1204, 4560, 1127, 5687
INVAR-89, Run: 076, F, 0, 0, 177, 921, 3096, 844, 3940
INVAR-89, Run: 077, F, 0, 177, 0, 2369, 1156, 2469, 3625
INVAR-89, Run: 078, F, 0, 0, 177, 4479, 6057, 4402, 10459
INVAR-89, Run: 079, F, 0, 0, 177, 3533, 10814, 3456, 14270
INVAR-89, Run: 080, F, 0, 177, 0, 6889, 4435, 6989, 11424
INVAR-89, Run: 081, F, 0, 177, 0, 7072, 2739, 7172, 9911
INVAR-89, Run: 082, F, 0, 177, 0, 2266, 891, 2366, 3257
INVAR-89, Run: 083, F, 0, 177, 0, 7870, 6727, 7970, 14697
INVAR-89, Run: 084, F, 0, 177, 0, 3759, 879, 3859, 4738
INVAR-89, Run: 085, F, 0, 0, 177, 1292, 4591, 1215, 5806
INVAR-89, Run: 086, F, 0, 0, 177, 708, 2304, 631, 2935
INVAR-89, Run: 087, F, 0, 0, 177, 482, 3649, 405, 4054
INVAR-89, Run: 088, F, 0, 0, 177, 2354, 6815, 2277, 9092
INVAR-89, Run: 089, F, 0, 177, 0, 2069, 419, 2169, 2588
INVAR-89, Run: 090, F, 0, 0, 177, 278, 2750, 201, 2951
INVAR-89, Run: 091, F, 0, 177, 0, 8274, 6832, 8374, 15206
INVAR-89, Run: 092, F, 0, 177, 0, 2013, 1388, 2113, 3501
INVAR-89, Run: 093, F, 0, 0, 177, 2171, 4322, 2094, 6416
INVAR-89, Run: 094, F, 0, 0, 177, 614, 3902, 537, 4439
INVAR-89, Run: 095, F, 0, 177, 0, 2835, 1936, 2935, 4871
INVAR-89, Run: 096, F, 0, 0, 177, 3822, 9558, 3745, 13303
INVAR-89, Run: 097, F, 0, 0, 177, 2878, 13848, 2801, 16649
INVAR-89, Run: 098, F, 0, 0, 177, 2758, 6230, 2681, 8911
INVAR-89, Run: 099, F, 0, 0, 177, 1090, 6775, 1013, 7788
INVAR-89, Run: 100, F, 0, 177, 0, 3988, 2208, 4088, 6296
INVAR-9, Run: 001, F, 0, 0, 31, 21, 171, 13, 184
INVAR-9, Run: 002, F, 0, 31, 0, 125, 87, 148, 235
INVAR-9, Run: 003, F, 0, 31, 0, 317, 534, 340, 874
INVAR-9, Run: 004, F, 0, 0, 31, 34, 348, 26, 374
INVAR-9, Run: 005, F, 0, 0, 31, 52, 198, 44, 242
INVAR-9, Run: 006, F, 0, 0, 31, 36, 153, 28, 181
INVAR-9, Run: 007, F, 0, 0, 31, 150, 177, 142, 319
INVAR-9, Run: 008, F, 0, 0, 31, 115, 281, 107, 388
INVAR-9, Run: 009, F, 0, 31, 0, 381, 623, 404, 1027
INVAR-9, Run: 010, F, 0, 0, 31, 316, 436, 308, 744
INVAR-9, Run: 011, F, 0, 0, 31, 106, 159, 98, 257
INVAR-9, Run: 012, F, 0, 31, 0, 331, 429, 354, 783
INVAR-9, Run: 013, F, 0, 0, 31, 26, 49, 18, 67
INVAR-9, Run: 014, F, 0, 0, 31, 77, 182, 69, 251
INVAR-9, Run: 015, F, 0, 0, 31, 145, 225, 137, 362
INVAR-9, Run: 016, F, 0, 31, 0, 20, 9, 43, 52
INVAR-9, Run: 017, F, 0, 0, 31, 19, 100, 11, 111
INVAR-9, Run: 018, F, 0, 31, 0, 371, 366, 394, 760
INVAR-9, Run: 019, F, 0, 0, 31, 216, 141, 208, 349
INVAR-9, Run: 020, F, 0, 0, 31, 8, 41, 0, 41
INVAR-9, Run: 021, F, 0, 0, 31, 36, 160, 28, 188
INVAR-9, Run: 022, F, 0, 0, 31, 217, 376, 209, 585
INVAR-9, Run: 023, F, 0, 0, 31, 67, 396, 59, 455
INVAR-9, Run: 024, F, 0, 0, 31, 88, 296, 80, 376
INVAR-9, Run: 025, F, 0, 31, 0, 34, 36, 57, 93
INVAR-9, Run: 026, F, 0, 31, 0, 66, 88, 89, 177
INVAR-9, Run: 027, F, 0, 0, 31, 146, 589, 138, 727
INVAR-9, Run: 028, F, 0, 31, 0, 69, 40, 92, 132
INVAR-9, Run: 029, F, 0, 31, 0, 40, 29, 63, 92
INVAR-9, Run: 030, F, 0, 0, 31, 15, 62, 7, 69
INVAR-9, Run: 031, F, 0, 0, 31, 35, 130, 27, 157
INVAR-9, Run: 032, F, 0, 31, 0, 81, 50, 104, 154
INVAR-9, Run: 033, F, 0, 0, 31, 69, 121, 61, 182
INVAR-9, Run: 034, F, 0, 0, 31, 24, 151, 16, 167
INVAR-9, Run: 035, F, 0, 0, 31, 30, 127, 22, 149
INVAR-9, Run: 036, F, 0, 31, 0, 98, 84, 121, 205
INVAR-9, Run: 037, F, 0, 0, 31, 34, 147, 26, 173
INVAR-9, Run: 038, F, 0, 0, 31, 87, 189, 79, 268
INVAR-9, Run: 039, F, 0, 31, 0, 48, 33, 71, 104
INVAR-9, Run: 040, F, 0, 0, 31, 69, 267, 61, 328
INVAR-9, Run: 041, F, 0, 31, 0, 209, 149, 232, 381
INVAR-9, Run: 042, F, 0, 31, 0, 100, 191, 123, 314
INVAR-9, Run: 043, F, 0, 31, 0, 424, 322, 447, 769
INVAR-9, Run: 044, F, 0, 31, 0, 195, 157, 218, 375
INVAR-9, Run: 045, F, 0, 0, 31, 21, 72, 13, 85
INVAR-9, Run: 046, F, 0, 31, 0, 117, 106, 140, 246
INVAR-9, Run: 047, F, 0, 31, 0, 159, 73, 182, 255
INVAR-9, Run: 048, F, 0, 31, 0, 108, 217, 131, 348
INVAR-9, Run: 049, F, 0, 0, 31, 16, 54, 8, 62
INVAR-9, Run: 050, F, 0, 0, 31, 245, 215, 237, 452
INVAR-9, Run: 051, F, 0, 0, 31, 30, 171, 22, 193
INVAR-9, Run: 052, F, 0, 0, 31, 234, 460, 226, 686
INVAR-9, Run: 053, F, 0, 0, 31, 16, 60, 8, 68
INVAR-9, Run: 054, F, 0, 31, 0, 56, 73, 79, 152
INVAR-9, Run: 055, F, 0, 0, 31, 26, 140, 18, 158
INVAR-9, Run: 056, F, 0, 0, 31, 29, 171, 21, 192
INVAR-9, Run: 057, F, 0, 0, 31, 40, 200, 32, 232
INVAR-9, Run: 058, F, 0, 0, 31, 15, 117, 7, 124
INVAR-9, Run: 059, F, 0, 31, 0, 89, 107, 112, 219
INVAR-9, Run: 060, F, 0, 0, 31, 73, 264, 65, 329
INVAR-9, Run: 061, F, 0, 0, 31, 17, 115, 9, 124
INVAR-9, Run: 062, F, 0, 0, 31, 14, 90, 6, 96
INVAR-9, Run: 063, F, 0, 0, 31, 56, 327, 48, 375
INVAR-9, Run: 064, F, 0, 0, 31, 103, 244, 95, 339
INVAR-9, Run: 065, F, 0, 0, 31, 45, 120, 37, 157
INVAR-9, Run: 066, F, 0, 0, 31, 67, 280, 59, 339
INVAR-9, Run: 067, F, 0, 0, 31, 74, 161, 66, 227
INVAR-9, Run: 068, F, 0, 31, 0, 50, 29, 73, 102
INVAR-9, Run: 069, F, 0, 31, 0, 232, 372, 255, 627
INVAR-9, Run: 070, F, 0, 0, 31, 12, 78, 4, 82
INVAR-9, Run: 071, F, 0, 31, 0, 49, 32, 72, 104
INVAR-9, Run: 072, F, 0, 0, 31, 84, 367, 76, 443
INVAR-9, Run: 073, F, 0, 0, 31, 56, 190, 48, 238
INVAR-9, Run: 074, F, 0, 0, 31, 84, 416, 76, 492
INVAR-9, Run: 075, F, 0, 0, 31, 89, 299, 81, 380
INVAR-9, Run: 076, F, 0, 0, 31, 314, 542, 306, 848
INVAR-9, Run: 077, F, 0, 0, 31, 92, 287, 84, 371
INVAR-9, Run: 078, F, 0, 0, 31, 247, 344, 239, 583
INVAR-9, Run: 079, F, 0, 0, 31, 24, 73, 16, 89
INVAR-9, Run: 080, F, 0, 0, 31, 179, 302, 171, 473
INVAR-9, Run: 081, F, 0, 31, 0, 158, 156, 181, 337
INVAR-9, Run: 082, F, 0, 31, 0, 149, 139, 172, 311
INVAR-9, Run: 083, F, 0, 0, 31, 293, 468, 285, 753
INVAR-9, Run: 084, F, 0, 0, 31, 79, 136, 71, 207
INVAR-9, Run: 085, F, 0, 0, 31, 12, 68, 4, 72
INVAR-9, Run: 086, F, 0, 0, 31, 38, 135, 30, 165
INVAR-9, Run: 087, F, 0, 31, 0, 50, 56, 73, 129
INVAR-9, Run: 088, F, 0, 0, 31, 27, 128, 19, 147
INVAR-9, Run: 089, F, 0, 0, 31, 59, 150, 51, 201
INVAR-9, Run: 090, F, 0, 0, 31, 155, 285, 147, 432
INVAR-9, Run: 091, F, 0, 0, 31, 156, 226, 148, 374
INVAR-9, Run: 092, F, 0, 0, 31, 14, 39, 6, 45
INVAR-9, Run: 093, F, 0, 0, 31, 24, 59, 16, 75
INVAR-9, Run: 094, F, 0, 0, 31, 63, 146, 55, 201
INVAR-9, Run: 095, F, 0, 31, 0, 46, 38, 69, 107
INVAR-9, Run: 096, F, 0, 0, 31, 18, 82, 10, 92
INVAR-9, Run: 097, F, 0, 0, 31, 246, 254, 238, 492
INVAR-9, Run: 098, F, 0, 31, 0, 59, 19, 82, 101
INVAR-9, Run: 099, F, 0, 0, 31, 141, 267, 133, 400
INVAR-9, Run: 100, F, 0, 0, 31, 257, 259, 249, 508
INVAR-90, Run: 001, F, 0, 341, 0, 19206, 8254, 19406, 27660
INVAR-90, Run: 002, F, 0, 0, 341, 21369, 46316, 21228, 67544
INVAR-90, Run: 003, F, 0, 0, 341, 2871, 10953, 2730, 13683
INVAR-90, Run: 004, F, 0, 341, 0, 2615, 614, 2815, 3429
INVAR-90, Run: 005, F, 0, 0, 341, 59633, 36000, 59492, 95492
INVAR-90, Run: 006, F, 0, 0, 341, 19531, 25360, 19390, 44750
INVAR-90, Run: 007, F, 0, 0, 341, 36326, 53461, 36185, 89646
INVAR-90, Run: 008, F, 0, 0, 341, 20777, 56754, 20636, 77390
INVAR-90, Run: 009, F, 0, 341, 0, 5856, 2227, 6056, 8283
INVAR-90, Run: 010, F, 0, 341, 0, 18836, 15903, 19036, 34939
INVAR-90, Run: 011, F, 0, 341, 0, 12183, 5570, 12383, 17953
INVAR-90, Run: 012, F, 0, 341, 0, 12253, 9734, 12453, 22187
INVAR-90, Run: 013, F, 0, 341, 0, 10839, 16119, 11039, 27158
INVAR-90, Run: 014, F, 0, 341, 0, 19965, 12761, 20165, 32926
INVAR-90, Run: 015, F, 0, 0, 341, 5762, 19106, 5621, 24727
INVAR-90, Run: 016, F, 0, 341, 0, 12300, 7585, 12500, 20085
INVAR-90, Run: 017, F, 0, 341, 0, 26332, 12701, 26532, 39233
INVAR-90, Run: 018, F, 0, 0, 341, 24781, 25010, 24640, 49650
INVAR-90, Run: 019, F, 0, 0, 341, 9947, 36354, 9806, 46160
INVAR-90, Run: 020, F, 0, 0, 341, 10729, 24702, 10588, 35290
INVAR-90, Run: 021, F, 0, 0, 341, 53854, 60558, 53713, 114271
INVAR-90, Run: 022, F, 0, 341, 0, 13926, 13263, 14126, 27389
INVAR-90, Run: 023, F, 0, 341, 0, 3002, 739, 3202, 3941
INVAR-90, Run: 024, F, 0, 0, 341, 8711, 36879, 8570, 45449
INVAR-90, Run: 025, F, 0, 0, 341, 1136, 7515, 995, 8510
INVAR-90, Run: 026, F, 0, 0, 341, 31289, 47337, 31148, 78485
INVAR-90, Run: 027, F, 0, 0, 341, 19980, 40527, 19839, 60366
INVAR-90, Run: 028, F, 0, 0, 341, 14858, 51999, 14717, 66716
INVAR-90, Run: 029, F, 0, 0, 341, 13735, 51203, 13594, 64797
INVAR-90, Run: 030, F, 0, 341, 0, 10438, 3638, 10638, 14276
INVAR-90, Run: 031, F, 0, 341, 0, 21899, 18123, 22099, 40222
INVAR-90, Run: 032, F, 0, 341, 0, 7092, 1232, 7292, 8524
INVAR-90, Run: 033, F, 0, 0, 341, 18168, 60913, 18027, 78940
INVAR-90, Run: 034, F, 0, 0, 341, 35837, 31873, 35696, 67569
INVAR-90, Run: 035, F, 0, 341, 0, 21149, 12864, 21349, 34213
INVAR-90, Run: 036, F, 0, 341, 0, 9919, 5517, 10119, 15636
INVAR-90, Run: 037, F, 0, 0, 341, 2725, 7447, 2584, 10031
INVAR-90, Run: 038, F, 0, 0, 341, 3763, 12786, 3622, 16408
INVAR-90, Run: 039, F, 0, 341, 0, 19620, 41785, 19820, 61605
INVAR-90, Run: 040, F, 0, 341, 0, 3340, 1042, 3540, 4582
INVAR-90, Run: 041, F, 0, 0, 341, 18603, 20657, 18462, 39119
INVAR-90, Run: 042, F, 0, 341, 0, 20210, 33500, 20410, 53910
INVAR-90, Run: 043, F, 0, 0, 341, 23710, 57604, 23569, 81173
INVAR-90, Run: 044, F, 0, 341, 0, 53186, 36632, 53386, 90018
INVAR-90, Run: 045, F, 0, 341, 0, 28793, 25890, 28993, 54883
INVAR-90, Run: 046, F, 0, 341, 0, 21071, 13439, 21271, 34710
INVAR-90, Run: 047, F, 0, 341, 0, 4577, 1521, 4777, 6298
INVAR-90, Run: 048, F, 0, 0, 341, 1669, 10725, 1528, 12253
INVAR-90, Run: 049, F, 0, 0, 341, 11375, 39010, 11234, 50244
INVAR-90, Run: 050, F, 0, 341, 0, 14134, 11500, 14334, 25834
INVAR-90, Run: 051, F, 0, 341, 0, 50099, 28303, 50299, 78602
INVAR-90, Run: 052, F, 0, 341, 0, 22745, 12598, 22945, 35543
INVAR-90, Run: 053, F, 0, 341, 0, 5643, 1686, 5843, 7529
INVAR-90, Run: 054, F, 0, 341, 0, 18380, 40873, 18580, 59453
INVAR-90, Run: 055, F, 0, 0, 341, 6513, 16473, 6372, 22845
INVAR-90, Run: 056, F, 0, 0, 341, 18703, 17117, 18562, 35679
INVAR-90, Run: 057, F, 0, 341, 0, 9637, 4623, 9837, 14460
INVAR-90, Run: 058, F, 0, 0, 341, 33061, 51346, 32920, 84266
INVAR-90, Run: 059, F, 0, 341, 0, 12563, 4762, 12763, 17525
INVAR-90, Run: 060, F, 0, 0, 341, 16745, 34997, 16604, 51601
INVAR-90, Run: 061, F, 0, 0, 341, 5812, 24364, 5671, 30035
INVAR-90, Run: 062, F, 0, 341, 0, 3470, 1873, 3670, 5543
INVAR-90, Run: 063, F, 0, 0, 341, 19765, 21459, 19624, 41083
INVAR-90, Run: 064, F, 0, 341, 0, 7542, 3738, 7742, 11480
INVAR-90, Run: 065, F, 0, 0, 341, 48502, 108243, 48361, 156604
INVAR-90, Run: 066, F, 0, 0, 341, 9106, 30527, 8965, 39492
INVAR-90, Run: 067, F, 0, 341, 0, 4887, 1623, 5087, 6710
INVAR-90, Run: 068, F, 0, 0, 341, 10150, 25255, 10009, 35264
INVAR-90, Run: 069, F, 0, 341, 0, 9230, 23256, 9430, 32686
INVAR-90, Run: 070, F, 0, 341, 0, 14301, 15164, 14501, 29665
INVAR-90, Run: 071, F, 0, 341, 0, 9280, 7056, 9480, 16536
INVAR-90, Run: 072, F, 0, 0, 341, 8827, 12421, 8686, 21107
INVAR-90, Run: 073, F, 0, 0, 341, 7842, 18236, 7701, 25937
INVAR-90, Run: 074, F, 0, 0, 341, 2868, 16356, 2727, 19083
INVAR-90, Run: 075, F, 0, 341, 0, 9391, 2153, 9591, 11744
INVAR-90, Run: 076, F, 0, 0, 341, 3054, 15178, 2913, 18091
INVAR-90, Run: 077, F, 0, 341, 0, 10424, 4608, 10624, 15232
INVAR-90, Run: 078, F, 0, 0, 341, 14522, 48397, 14381, 62778
INVAR-90, Run: 079, F, 0, 0, 341, 9971, 21225, 9830, 31055
INVAR-90, Run: 080, F, 0, 0, 341, 4845, 15467, 4704, 20171
INVAR-90, Run: 081, F, 0, 0, 341, 37182, 58628, 37041, 95669
INVAR-90, Run: 082, F, 0, 341, 0, 13691, 22540, 13891, 36431
INVAR-90, Run: 083, F, 0, 0, 341, 6074, 27367, 5933, 33300
INVAR-90, Run: 084, F, 0, 341, 0, 13153, 4950, 13353, 18303
INVAR-90, Run: 085, F, 0, 0, 341, 23733, 73700, 23592, 97292
INVAR-90, Run: 086, F, 0, 0, 341, 6216, 12046, 6075, 18121
INVAR-90, Run: 087, F, 0, 341, 0, 3815, 1154, 4015, 5169
INVAR-90, Run: 088, F, 0, 0, 341, 1670, 13362, 1529, 14891
INVAR-90, Run: 089, F, 0, 0, 341, 20449, 69197, 20308, 89505
INVAR-90, Run: 090, F, 0, 0, 341, 3369, 18574, 3228, 21802
INVAR-90, Run: 091, F, 0, 0, 341, 37367, 59499, 37226, 96725
INVAR-90, Run: 092, F, 0, 0, 341, 4624, 24828, 4483, 29311
INVAR-90, Run: 093, F, 0, 341, 0, 21958, 14943, 22158, 37101
INVAR-90, Run: 094, F, 0, 0, 341, 29912, 79202, 29771, 108973
INVAR-90, Run: 095, F, 0, 0, 341, 6065, 16389, 5924, 22313
INVAR-90, Run: 096, F, 0, 0, 341, 11748, 49604, 11607, 61211
INVAR-90, Run: 097, F, 0, 0, 341, 24418, 41335, 24277, 65612
INVAR-90, Run: 098, F, 0, 0, 341, 1877, 6334, 1736, 8070
INVAR-90, Run: 099, F, 0, 0, 341, 30866, 38913, 30725, 69638
INVAR-90, Run: 100, F, 0, 341, 0, 7165, 2351, 7365, 9716
INVAR-91, Run: 001, P, 0, 0, 50, 0, 0, 0, 0
INVAR-91, Run: 002, P, 0, 0, 50, 0, 0, 0, 0
INVAR-91, Run: 003, P, 0, 0, 50, 0, 0, 0, 0
INVAR-91, Run: 004, P, 0, 0, 50, 0, 0, 0, 0
INVAR-91, Run: 005, P, 0, 0, 50, 0, 0, 0, 0
INVAR-91, Run: 006, P, 0, 0, 50, 0, 0, 0, 0
INVAR-91, Run: 007, P, 0, 0, 50, 0, 0, 0, 0
INVAR-91, Run: 008, P, 0, 0, 50, 0, 0, 0, 0
INVAR-91, Run: 009, P, 0, 0, 50, 0, 0, 0, 0
INVAR-91, Run: 010, P, 0, 0, 50, 0, 0, 0, 0
INVAR-91, Run: 011, P, 0, 0, 50, 0, 0, 0, 0
INVAR-91, Run: 012, P, 0, 0, 50, 0, 0, 0, 0
INVAR-91, Run: 013, P, 0, 0, 50, 0, 0, 0, 0
INVAR-91, Run: 014, P, 0, 0, 50, 0, 0, 0, 0
INVAR-91, Run: 015, P, 0, 0, 50, 0, 0, 0, 0
INVAR-91, Run: 016, P, 0, 0, 50, 0, 0, 0, 0
INVAR-91, Run: 017, P, 0, 0, 50, 0, 0, 0, 0
INVAR-91, Run: 018, P, 0, 0, 50, 0, 0, 0, 0
INVAR-91, Run: 019, P, 0, 0, 50, 0, 0, 0, 0
INVAR-91, Run: 020, P, 0, 0, 50, 0, 0, 0, 0
INVAR-91, Run: 021, P, 0, 0, 50, 0, 0, 0, 0
INVAR-91, Run: 022, P, 0, 0, 50, 0, 0, 0, 0
INVAR-91, Run: 023, P, 0, 0, 50, 0, 0, 0, 0
INVAR-91, Run: 024, P, 0, 0, 50, 0, 0, 0, 0
INVAR-91, Run: 025, P, 0, 0, 50, 0, 0, 0, 0
INVAR-91, Run: 026, P, 0, 0, 50, 0, 0, 0, 0
INVAR-91, Run: 027, P, 0, 0, 50, 0, 0, 0, 0
INVAR-91, Run: 028, P, 0, 0, 50, 0, 0, 0, 0
INVAR-91, Run: 029, P, 0, 0, 50, 0, 0, 0, 0
INVAR-91, Run: 030, P, 0, 0, 50, 0, 0, 0, 0
INVAR-91, Run: 031, P, 0, 0, 50, 0, 0, 0, 0
INVAR-91, Run: 032, P, 0, 0, 50, 0, 0, 0, 0
INVAR-91, Run: 033, P, 0, 0, 50, 0, 0, 0, 0
INVAR-91, Run: 034, P, 0, 0, 50, 0, 0, 0, 0
INVAR-91, Run: 035, P, 0, 0, 50, 0, 0, 0, 0
INVAR-91, Run: 036, P, 0, 0, 50, 0, 0, 0, 0
INVAR-91, Run: 037, P, 0, 0, 50, 0, 0, 0, 0
INVAR-91, Run: 038, P, 0, 0, 50, 0, 0, 0, 0
INVAR-91, Run: 039, P, 0, 0, 50, 0, 0, 0, 0
INVAR-91, Run: 040, P, 0, 0, 50, 0, 0, 0, 0
INVAR-91, Run: 041, P, 0, 0, 50, 0, 0, 0, 0
INVAR-91, Run: 042, P, 0, 0, 50, 0, 0, 0, 0
INVAR-91, Run: 043, P, 0, 0, 50, 0, 0, 0, 0
INVAR-91, Run: 044, P, 0, 0, 50, 0, 0, 0, 0
INVAR-91, Run: 045, P, 0, 0, 50, 0, 0, 0, 0
INVAR-91, Run: 046, P, 0, 0, 50, 0, 0, 0, 0
INVAR-91, Run: 047, P, 0, 0, 50, 0, 0, 0, 0
INVAR-91, Run: 048, P, 0, 0, 50, 0, 0, 0, 0
INVAR-91, Run: 049, P, 0, 0, 50, 0, 0, 0, 0
INVAR-91, Run: 050, P, 0, 0, 50, 0, 0, 0, 0
INVAR-91, Run: 051, P, 0, 0, 50, 0, 0, 0, 0
INVAR-91, Run: 052, P, 0, 0, 50, 0, 0, 0, 0
INVAR-91, Run: 053, P, 0, 0, 50, 0, 0, 0, 0
INVAR-91, Run: 054, P, 0, 0, 50, 0, 0, 0, 0
INVAR-91, Run: 055, P, 0, 0, 50, 0, 0, 0, 0
INVAR-91, Run: 056, P, 0, 0, 50, 0, 0, 0, 0
INVAR-91, Run: 057, P, 0, 0, 50, 0, 0, 0, 0
INVAR-91, Run: 058, P, 0, 0, 50, 0, 0, 0, 0
INVAR-91, Run: 059, P, 0, 0, 50, 0, 0, 0, 0
INVAR-91, Run: 060, P, 0, 0, 50, 0, 0, 0, 0
INVAR-91, Run: 061, P, 0, 0, 50, 0, 0, 0, 0
INVAR-91, Run: 062, P, 0, 0, 50, 0, 0, 0, 0
INVAR-91, Run: 063, P, 0, 0, 50, 0, 0, 0, 0
INVAR-91, Run: 064, P, 0, 0, 50, 0, 0, 0, 0
INVAR-91, Run: 065, P, 0, 0, 50, 0, 0, 0, 0
INVAR-91, Run: 066, P, 0, 0, 50, 0, 0, 0, 0
INVAR-91, Run: 067, P, 0, 0, 50, 0, 0, 0, 0
INVAR-91, Run: 068, P, 0, 0, 50, 0, 0, 0, 0
INVAR-91, Run: 069, P, 0, 0, 50, 0, 0, 0, 0
INVAR-91, Run: 070, P, 0, 0, 50, 0, 0, 0, 0
INVAR-91, Run: 071, P, 0, 0, 50, 0, 0, 0, 0
INVAR-91, Run: 072, P, 0, 0, 50, 0, 0, 0, 0
INVAR-91, Run: 073, P, 0, 0, 50, 0, 0, 0, 0
INVAR-91, Run: 074, P, 0, 0, 50, 0, 0, 0, 0
INVAR-91, Run: 075, P, 0, 0, 50, 0, 0, 0, 0
INVAR-91, Run: 076, P, 0, 0, 50, 0, 0, 0, 0
INVAR-91, Run: 077, P, 0, 0, 50, 0, 0, 0, 0
INVAR-91, Run: 078, P, 0, 0, 50, 0, 0, 0, 0
INVAR-91, Run: 079, P, 0, 0, 50, 0, 0, 0, 0
INVAR-91, Run: 080, P, 0, 0, 50, 0, 0, 0, 0
INVAR-91, Run: 081, P, 0, 0, 50, 0, 0, 0, 0
INVAR-91, Run: 082, P, 0, 0, 50, 0, 0, 0, 0
INVAR-91, Run: 083, P, 0, 0, 50, 0, 0, 0, 0
INVAR-91, Run: 084, P, 0, 0, 50, 0, 0, 0, 0
INVAR-91, Run: 085, P, 0, 0, 50, 0, 0, 0, 0
INVAR-91, Run: 086, P, 0, 0, 50, 0, 0, 0, 0
INVAR-91, Run: 087, P, 0, 0, 50, 0, 0, 0, 0
INVAR-91, Run: 088, P, 0, 0, 50, 0, 0, 0, 0
INVAR-91, Run: 089, P, 0, 0, 50, 0, 0, 0, 0
INVAR-91, Run: 090, P, 0, 0, 50, 0, 0, 0, 0
INVAR-91, Run: 091, P, 0, 0, 50, 0, 0, 0, 0
INVAR-91, Run: 092, P, 0, 0, 50, 0, 0, 0, 0
INVAR-91, Run: 093, P, 0, 0, 50, 0, 0, 0, 0
INVAR-91, Run: 094, P, 0, 0, 50, 0, 0, 0, 0
INVAR-91, Run: 095, P, 0, 0, 50, 0, 0, 0, 0
INVAR-91, Run: 096, P, 0, 0, 50, 0, 0, 0, 0
INVAR-91, Run: 097, P, 0, 0, 50, 0, 0, 0, 0
INVAR-91, Run: 098, P, 0, 0, 50, 0, 0, 0, 0
INVAR-91, Run: 099, P, 0, 0, 50, 0, 0, 0, 0
INVAR-91, Run: 100, P, 0, 0, 50, 0, 0, 0, 0
INVAR-92, Run: 001, P, 0, 0, 100, 0, 0, 0, 0
INVAR-92, Run: 002, P, 0, 0, 100, 0, 0, 0, 0
INVAR-92, Run: 003, P, 0, 0, 100, 0, 0, 0, 0
INVAR-92, Run: 004, P, 0, 0, 100, 0, 0, 0, 0
INVAR-92, Run: 005, P, 0, 0, 100, 0, 0, 0, 0
INVAR-92, Run: 006, P, 0, 0, 100, 0, 0, 0, 0
INVAR-92, Run: 007, P, 0, 0, 100, 0, 0, 0, 0
INVAR-92, Run: 008, P, 0, 0, 100, 0, 0, 0, 0
INVAR-92, Run: 009, P, 0, 0, 100, 0, 0, 0, 0
INVAR-92, Run: 010, P, 0, 0, 100, 0, 0, 0, 0
INVAR-92, Run: 011, P, 0, 0, 100, 0, 0, 0, 0
INVAR-92, Run: 012, P, 0, 0, 100, 0, 0, 0, 0
INVAR-92, Run: 013, P, 0, 0, 100, 0, 0, 0, 0
INVAR-92, Run: 014, P, 0, 0, 100, 0, 0, 0, 0
INVAR-92, Run: 015, P, 0, 0, 100, 0, 0, 0, 0
INVAR-92, Run: 016, P, 0, 0, 100, 0, 0, 0, 0
INVAR-92, Run: 017, P, 0, 0, 100, 0, 0, 0, 0
INVAR-92, Run: 018, P, 0, 0, 100, 0, 0, 0, 0
INVAR-92, Run: 019, P, 0, 0, 100, 0, 0, 0, 0
INVAR-92, Run: 020, P, 0, 0, 100, 0, 0, 0, 0
INVAR-92, Run: 021, P, 0, 0, 100, 0, 0, 0, 0
INVAR-92, Run: 022, P, 0, 0, 100, 0, 0, 0, 0
INVAR-92, Run: 023, P, 0, 0, 100, 0, 0, 0, 0
INVAR-92, Run: 024, P, 0, 0, 100, 0, 0, 0, 0
INVAR-92, Run: 025, P, 0, 0, 100, 0, 0, 0, 0
INVAR-92, Run: 026, P, 0, 0, 100, 0, 0, 0, 0
INVAR-92, Run: 027, P, 0, 0, 100, 0, 0, 0, 0
INVAR-92, Run: 028, P, 0, 0, 100, 0, 0, 0, 0
INVAR-92, Run: 029, P, 0, 0, 100, 0, 0, 0, 0
INVAR-92, Run: 030, P, 0, 0, 100, 0, 0, 0, 0
INVAR-92, Run: 031, P, 0, 0, 100, 0, 0, 0, 0
INVAR-92, Run: 032, P, 0, 0, 100, 0, 0, 0, 0
INVAR-92, Run: 033, P, 0, 0, 100, 0, 0, 0, 0
INVAR-92, Run: 034, P, 0, 0, 100, 0, 0, 0, 0
INVAR-92, Run: 035, P, 0, 0, 100, 0, 0, 0, 0
INVAR-92, Run: 036, P, 0, 0, 100, 0, 0, 0, 0
INVAR-92, Run: 037, P, 0, 0, 100, 0, 0, 0, 0
INVAR-92, Run: 038, P, 0, 0, 100, 0, 0, 0, 0
INVAR-92, Run: 039, P, 0, 0, 100, 0, 0, 0, 0
INVAR-92, Run: 040, P, 0, 0, 100, 0, 0, 0, 0
INVAR-92, Run: 041, P, 0, 0, 100, 0, 0, 0, 0
INVAR-92, Run: 042, P, 0, 0, 100, 0, 0, 0, 0
INVAR-92, Run: 043, P, 0, 0, 100, 0, 0, 0, 0
INVAR-92, Run: 044, P, 0, 0, 100, 0, 0, 0, 0
INVAR-92, Run: 045, P, 0, 0, 100, 0, 0, 0, 0
INVAR-92, Run: 046, P, 0, 0, 100, 0, 0, 0, 0
INVAR-92, Run: 047, P, 0, 0, 100, 0, 0, 0, 0
INVAR-92, Run: 048, P, 0, 0, 100, 0, 0, 0, 0
INVAR-92, Run: 049, P, 0, 0, 100, 0, 0, 0, 0
INVAR-92, Run: 050, P, 0, 0, 100, 0, 0, 0, 0
INVAR-92, Run: 051, P, 0, 0, 100, 0, 0, 0, 0
INVAR-92, Run: 052, P, 0, 0, 100, 0, 0, 0, 0
INVAR-92, Run: 053, P, 0, 0, 100, 0, 0, 0, 0
INVAR-92, Run: 054, P, 0, 0, 100, 0, 0, 0, 0
INVAR-92, Run: 055, P, 0, 0, 100, 0, 0, 0, 0
INVAR-92, Run: 056, P, 0, 0, 100, 0, 0, 0, 0
INVAR-92, Run: 057, P, 0, 0, 100, 0, 0, 0, 0
INVAR-92, Run: 058, P, 0, 0, 100, 0, 0, 0, 0
INVAR-92, Run: 059, P, 0, 0, 100, 0, 0, 0, 0
INVAR-92, Run: 060, P, 0, 0, 100, 0, 0, 0, 0
INVAR-92, Run: 061, P, 0, 0, 100, 0, 0, 0, 0
INVAR-92, Run: 062, P, 0, 0, 100, 0, 0, 0, 0
INVAR-92, Run: 063, P, 0, 0, 100, 0, 0, 0, 0
INVAR-92, Run: 064, P, 0, 0, 100, 0, 0, 0, 0
INVAR-92, Run: 065, P, 0, 0, 100, 0, 0, 0, 0
INVAR-92, Run: 066, P, 0, 0, 100, 0, 0, 0, 0
INVAR-92, Run: 067, P, 0, 0, 100, 0, 0, 0, 0
INVAR-92, Run: 068, P, 0, 0, 100, 0, 0, 0, 0
INVAR-92, Run: 069, P, 0, 0, 100, 0, 0, 0, 0
INVAR-92, Run: 070, P, 0, 0, 100, 0, 0, 0, 0
INVAR-92, Run: 071, P, 0, 0, 100, 0, 0, 0, 0
INVAR-92, Run: 072, P, 0, 0, 100, 0, 0, 0, 0
INVAR-92, Run: 073, P, 0, 0, 100, 0, 0, 0, 0
INVAR-92, Run: 074, P, 0, 0, 100, 0, 0, 0, 0
INVAR-92, Run: 075, P, 0, 0, 100, 0, 0, 0, 0
INVAR-92, Run: 076, P, 0, 0, 100, 0, 0, 0, 0
INVAR-92, Run: 077, P, 0, 0, 100, 0, 0, 0, 0
INVAR-92, Run: 078, P, 0, 0, 100, 0, 0, 0, 0
INVAR-92, Run: 079, P, 0, 0, 100, 0, 0, 0, 0
INVAR-92, Run: 080, P, 0, 0, 100, 0, 0, 0, 0
INVAR-92, Run: 081, P, 0, 0, 100, 0, 0, 0, 0
INVAR-92, Run: 082, P, 0, 0, 100, 0, 0, 0, 0
INVAR-92, Run: 083, P, 0, 0, 100, 0, 0, 0, 0
INVAR-92, Run: 084, P, 0, 0, 100, 0, 0, 0, 0
INVAR-92, Run: 085, P, 0, 0, 100, 0, 0, 0, 0
INVAR-92, Run: 086, P, 0, 0, 100, 0, 0, 0, 0
INVAR-92, Run: 087, P, 0, 0, 100, 0, 0, 0, 0
INVAR-92, Run: 088, P, 0, 0, 100, 0, 0, 0, 0
INVAR-92, Run: 089, P, 0, 0, 100, 0, 0, 0, 0
INVAR-92, Run: 090, P, 0, 0, 100, 0, 0, 0, 0
INVAR-92, Run: 091, P, 0, 0, 100, 0, 0, 0, 0
INVAR-92, Run: 092, P, 0, 0, 100, 0, 0, 0, 0
INVAR-92, Run: 093, P, 0, 0, 100, 0, 0, 0, 0
INVAR-92, Run: 094, P, 0, 0, 100, 0, 0, 0, 0
INVAR-92, Run: 095, P, 0, 0, 100, 0, 0, 0, 0
INVAR-92, Run: 096, P, 0, 0, 100, 0, 0, 0, 0
INVAR-92, Run: 097, P, 0, 0, 100, 0, 0, 0, 0
INVAR-92, Run: 098, P, 0, 0, 100, 0, 0, 0, 0
INVAR-92, Run: 099, P, 0, 0, 100, 0, 0, 0, 0
INVAR-92, Run: 100, P, 0, 0, 100, 0, 0, 0, 0
INVAR-93, Run: 001, P, 0, 0, 200, 0, 0, 0, 0
INVAR-93, Run: 002, P, 0, 0, 200, 0, 0, 0, 0
INVAR-93, Run: 003, P, 0, 0, 200, 0, 0, 0, 0
INVAR-93, Run: 004, P, 0, 0, 200, 0, 0, 0, 0
INVAR-93, Run: 005, P, 0, 0, 200, 0, 0, 0, 0
INVAR-93, Run: 006, P, 0, 0, 200, 0, 0, 0, 0
INVAR-93, Run: 007, P, 0, 0, 200, 0, 0, 0, 0
INVAR-93, Run: 008, P, 0, 0, 200, 0, 0, 0, 0
INVAR-93, Run: 009, P, 0, 0, 200, 0, 0, 0, 0
INVAR-93, Run: 010, P, 0, 0, 200, 0, 0, 0, 0
INVAR-93, Run: 011, P, 0, 0, 200, 0, 0, 0, 0
INVAR-93, Run: 012, P, 0, 0, 200, 0, 0, 0, 0
INVAR-93, Run: 013, P, 0, 0, 200, 0, 0, 0, 0
INVAR-93, Run: 014, P, 0, 0, 200, 0, 0, 0, 0
INVAR-93, Run: 015, P, 0, 0, 200, 0, 0, 0, 0
INVAR-93, Run: 016, P, 0, 0, 200, 0, 0, 0, 0
INVAR-93, Run: 017, P, 0, 0, 200, 0, 0, 0, 0
INVAR-93, Run: 018, P, 0, 0, 200, 0, 0, 0, 0
INVAR-93, Run: 019, P, 0, 0, 200, 0, 0, 0, 0
INVAR-93, Run: 020, P, 0, 0, 200, 0, 0, 0, 0
INVAR-93, Run: 021, P, 0, 0, 200, 0, 0, 0, 0
INVAR-93, Run: 022, P, 0, 0, 200, 0, 0, 0, 0
INVAR-93, Run: 023, P, 0, 0, 200, 0, 0, 0, 0
INVAR-93, Run: 024, P, 0, 0, 200, 0, 0, 0, 0
INVAR-93, Run: 025, P, 0, 0, 200, 0, 0, 0, 0
INVAR-93, Run: 026, P, 0, 0, 200, 0, 0, 0, 0
INVAR-93, Run: 027, P, 0, 0, 200, 0, 0, 0, 0
INVAR-93, Run: 028, P, 0, 0, 200, 0, 0, 0, 0
INVAR-93, Run: 029, P, 0, 0, 200, 0, 0, 0, 0
INVAR-93, Run: 030, P, 0, 0, 200, 0, 0, 0, 0
INVAR-93, Run: 031, P, 0, 0, 200, 0, 0, 0, 0
INVAR-93, Run: 032, P, 0, 0, 200, 0, 0, 0, 0
INVAR-93, Run: 033, P, 0, 0, 200, 0, 0, 0, 0
INVAR-93, Run: 034, P, 0, 0, 200, 0, 0, 0, 0
INVAR-93, Run: 035, P, 0, 0, 200, 0, 0, 0, 0
INVAR-93, Run: 036, P, 0, 0, 200, 0, 0, 0, 0
INVAR-93, Run: 037, P, 0, 0, 200, 0, 0, 0, 0
INVAR-93, Run: 038, P, 0, 0, 200, 0, 0, 0, 0
INVAR-93, Run: 039, P, 0, 0, 200, 0, 0, 0, 0
INVAR-93, Run: 040, P, 0, 0, 200, 0, 0, 0, 0
INVAR-93, Run: 041, P, 0, 0, 200, 0, 0, 0, 0
INVAR-93, Run: 042, P, 0, 0, 200, 0, 0, 0, 0
INVAR-93, Run: 043, P, 0, 0, 200, 0, 0, 0, 0
INVAR-93, Run: 044, P, 0, 0, 200, 0, 0, 0, 0
INVAR-93, Run: 045, P, 0, 0, 200, 0, 0, 0, 0
INVAR-93, Run: 046, P, 0, 0, 200, 0, 0, 0, 0
INVAR-93, Run: 047, P, 0, 0, 200, 0, 0, 0, 0
INVAR-93, Run: 048, P, 0, 0, 200, 0, 0, 0, 0
INVAR-93, Run: 049, P, 0, 0, 200, 0, 0, 0, 0
INVAR-93, Run: 050, P, 0, 0, 200, 0, 0, 0, 0
INVAR-93, Run: 051, P, 0, 0, 200, 0, 0, 0, 0
INVAR-93, Run: 052, P, 0, 0, 200, 0, 0, 0, 0
INVAR-93, Run: 053, P, 0, 0, 200, 0, 0, 0, 0
INVAR-93, Run: 054, P, 0, 0, 200, 0, 0, 0, 0
INVAR-93, Run: 055, P, 0, 0, 200, 0, 0, 0, 0
INVAR-93, Run: 056, P, 0, 0, 200, 0, 0, 0, 0
INVAR-93, Run: 057, P, 0, 0, 200, 0, 0, 0, 0
INVAR-93, Run: 058, P, 0, 0, 200, 0, 0, 0, 0
INVAR-93, Run: 059, P, 0, 0, 200, 0, 0, 0, 0
INVAR-93, Run: 060, P, 0, 0, 200, 0, 0, 0, 0
INVAR-93, Run: 061, P, 0, 0, 200, 0, 0, 0, 0
INVAR-93, Run: 062, P, 0, 0, 200, 0, 0, 0, 0
INVAR-93, Run: 063, P, 0, 0, 200, 0, 0, 0, 0
INVAR-93, Run: 064, P, 0, 0, 200, 0, 0, 0, 0
INVAR-93, Run: 065, P, 0, 0, 200, 0, 0, 0, 0
INVAR-93, Run: 066, P, 0, 0, 200, 0, 0, 0, 0
INVAR-93, Run: 067, P, 0, 0, 200, 0, 0, 0, 0
INVAR-93, Run: 068, P, 0, 0, 200, 0, 0, 0, 0
INVAR-93, Run: 069, P, 0, 0, 200, 0, 0, 0, 0
INVAR-93, Run: 070, P, 0, 0, 200, 0, 0, 0, 0
INVAR-93, Run: 071, P, 0, 0, 200, 0, 0, 0, 0
INVAR-93, Run: 072, P, 0, 0, 200, 0, 0, 0, 0
INVAR-93, Run: 073, P, 0, 0, 200, 0, 0, 0, 0
INVAR-93, Run: 074, P, 0, 0, 200, 0, 0, 0, 0
INVAR-93, Run: 075, P, 0, 0, 200, 0, 0, 0, 0
INVAR-93, Run: 076, P, 0, 0, 200, 0, 0, 0, 0
INVAR-93, Run: 077, P, 0, 0, 200, 0, 0, 0, 0
INVAR-93, Run: 078, P, 0, 0, 200, 0, 0, 0, 0
INVAR-93, Run: 079, P, 0, 0, 200, 0, 0, 0, 0
INVAR-93, Run: 080, P, 0, 0, 200, 0, 0, 0, 0
INVAR-93, Run: 081, P, 0, 0, 200, 0, 0, 0, 0
INVAR-93, Run: 082, P, 0, 0, 200, 0, 0, 0, 0
INVAR-93, Run: 083, P, 0, 0, 200, 0, 0, 0, 0
INVAR-93, Run: 084, P, 0, 0, 200, 0, 0, 0, 0
INVAR-93, Run: 085, P, 0, 0, 200, 0, 0, 0, 0
INVAR-93, Run: 086, P, 0, 0, 200, 0, 0, 0, 0
INVAR-93, Run: 087, P, 0, 0, 200, 0, 0, 0, 0
INVAR-93, Run: 088, P, 0, 0, 200, 0, 0, 0, 0
INVAR-93, Run: 089, P, 0, 0, 200, 0, 0, 0, 0
INVAR-93, Run: 090, P, 0, 0, 200, 0, 0, 0, 0
INVAR-93, Run: 091, P, 0, 0, 200, 0, 0, 0, 0
INVAR-93, Run: 092, P, 0, 0, 200, 0, 0, 0, 0
INVAR-93, Run: 093, P, 0, 0, 200, 0, 0, 0, 0
INVAR-93, Run: 094, P, 0, 0, 200, 0, 0, 0, 0
INVAR-93, Run: 095, P, 0, 0, 200, 0, 0, 0, 0
INVAR-93, Run: 096, P, 0, 0, 200, 0, 0, 0, 0
INVAR-93, Run: 097, P, 0, 0, 200, 0, 0, 0, 0
INVAR-93, Run: 098, P, 0, 0, 200, 0, 0, 0, 0
INVAR-93, Run: 099, P, 0, 0, 200, 0, 0, 0, 0
INVAR-93, Run: 100, P, 0, 0, 200, 0, 0, 0, 0
