Input Number, Run_Number, Result@ 100, X2, X1, Y, NEW_REACTION, Reaction1, Reaction2
INVAR-1, Run: 001, F, 0, 0, 26, 6, 44, 18
INVAR-1, Run: 002, F, 0, 0, 22, 4, 42, 20
INVAR-1, Run: 003, F, 0, 0, 30, 8, 46, 16
INVAR-1, Run: 004, F, 0, 0, 28, 7, 45, 17
INVAR-1, Run: 005, F, 0, 0, 30, 8, 46, 16
INVAR-1, Run: 006, F, 0, 0, 30, 8, 46, 16
INVAR-1, Run: 007, F, 0, 0, 36, 11, 49, 13
INVAR-1, Run: 008, F, 0, 0, 28, 7, 45, 17
INVAR-1, Run: 009, F, 0, 0, 30, 8, 46, 16
INVAR-1, Run: 010, F, 0, 0, 28, 7, 45, 17
INVAR-1, Run: 011, F, 0, 0, 36, 11, 49, 13
INVAR-1, Run: 012, F, 0, 0, 34, 10, 48, 14
INVAR-1, Run: 013, F, 0, 0, 28, 7, 45, 17
INVAR-1, Run: 014, F, 0, 0, 30, 8, 46, 16
INVAR-1, Run: 015, F, 0, 0, 32, 9, 47, 15
INVAR-1, Run: 016, F, 0, 0, 22, 4, 42, 20
INVAR-1, Run: 017, F, 0, 0, 32, 9, 47, 15
INVAR-1, Run: 018, F, 0, 0, 32, 9, 47, 15
INVAR-1, Run: 019, F, 0, 0, 30, 8, 46, 16
INVAR-1, Run: 020, F, 0, 0, 30, 8, 46, 16
INVAR-1, Run: 021, F, 0, 0, 32, 9, 47, 15
INVAR-1, Run: 022, F, 0, 0, 26, 6, 44, 18
INVAR-1, Run: 023, F, 0, 0, 28, 7, 45, 17
INVAR-1, Run: 024, F, 0, 0, 28, 7, 45, 17
INVAR-1, Run: 025, F, 0, 0, 28, 7, 45, 17
INVAR-1, Run: 026, F, 0, 0, 26, 6, 44, 18
INVAR-1, Run: 027, F, 0, 0, 32, 9, 47, 15
INVAR-1, Run: 028, F, 0, 0, 24, 5, 43, 19
INVAR-1, Run: 029, F, 0, 0, 34, 10, 48, 14
INVAR-1, Run: 030, F, 0, 0, 28, 7, 45, 17
INVAR-1, Run: 031, F, 0, 0, 34, 10, 48, 14
INVAR-1, Run: 032, F, 0, 0, 30, 8, 46, 16
INVAR-1, Run: 033, F, 0, 0, 30, 8, 46, 16
INVAR-1, Run: 034, F, 0, 0, 32, 9, 47, 15
INVAR-1, Run: 035, F, 0, 0, 30, 8, 46, 16
INVAR-1, Run: 036, F, 0, 0, 32, 9, 47, 15
INVAR-1, Run: 037, F, 0, 0, 28, 7, 45, 17
INVAR-1, Run: 038, F, 0, 0, 24, 5, 43, 19
INVAR-1, Run: 039, F, 0, 0, 30, 8, 46, 16
INVAR-1, Run: 040, F, 0, 0, 30, 8, 46, 16
INVAR-1, Run: 041, F, 0, 0, 30, 8, 46, 16
INVAR-1, Run: 042, F, 0, 0, 26, 6, 44, 18
INVAR-1, Run: 043, F, 0, 0, 34, 10, 48, 14
INVAR-1, Run: 044, F, 0, 0, 26, 6, 44, 18
INVAR-1, Run: 045, F, 0, 0, 28, 7, 45, 17
INVAR-1, Run: 046, F, 0, 0, 24, 5, 43, 19
INVAR-1, Run: 047, F, 0, 0, 34, 10, 48, 14
INVAR-1, Run: 048, F, 0, 0, 22, 4, 42, 20
INVAR-1, Run: 049, F, 0, 0, 32, 9, 47, 15
INVAR-1, Run: 050, F, 0, 0, 34, 10, 48, 14
INVAR-1, Run: 051, F, 0, 0, 28, 7, 45, 17
INVAR-1, Run: 052, F, 0, 0, 26, 6, 44, 18
INVAR-1, Run: 053, F, 0, 0, 34, 10, 48, 14
INVAR-1, Run: 054, F, 0, 0, 32, 9, 47, 15
INVAR-1, Run: 055, F, 0, 0, 26, 6, 44, 18
INVAR-1, Run: 056, F, 0, 0, 30, 8, 46, 16
INVAR-1, Run: 057, F, 0, 0, 26, 6, 44, 18
INVAR-1, Run: 058, F, 0, 0, 24, 5, 43, 19
INVAR-1, Run: 059, F, 0, 0, 30, 8, 46, 16
INVAR-1, Run: 060, F, 0, 0, 34, 10, 48, 14
INVAR-1, Run: 061, F, 0, 0, 28, 7, 45, 17
INVAR-1, Run: 062, F, 0, 0, 32, 9, 47, 15
INVAR-1, Run: 063, F, 0, 0, 34, 10, 48, 14
INVAR-1, Run: 064, F, 0, 0, 32, 9, 47, 15
INVAR-1, Run: 065, F, 0, 0, 28, 7, 45, 17
INVAR-1, Run: 066, F, 0, 0, 24, 5, 43, 19
INVAR-1, Run: 067, F, 0, 0, 32, 9, 47, 15
INVAR-1, Run: 068, F, 0, 0, 24, 5, 43, 19
INVAR-1, Run: 069, F, 0, 0, 32, 9, 47, 15
INVAR-1, Run: 070, F, 0, 0, 28, 7, 45, 17
INVAR-1, Run: 071, F, 0, 0, 32, 9, 47, 15
INVAR-1, Run: 072, F, 0, 0, 32, 9, 47, 15
INVAR-1, Run: 073, F, 0, 0, 34, 10, 48, 14
INVAR-1, Run: 074, F, 0, 0, 26, 6, 44, 18
INVAR-1, Run: 075, F, 0, 0, 28, 7, 45, 17
INVAR-1, Run: 076, F, 0, 0, 30, 8, 46, 16
INVAR-1, Run: 077, F, 0, 0, 34, 10, 48, 14
INVAR-1, Run: 078, F, 0, 0, 38, 12, 50, 12
INVAR-1, Run: 079, F, 0, 0, 38, 12, 50, 12
INVAR-1, Run: 080, F, 0, 0, 30, 8, 46, 16
INVAR-1, Run: 081, F, 0, 0, 34, 10, 48, 14
INVAR-1, Run: 082, F, 0, 0, 28, 7, 45, 17
INVAR-1, Run: 083, F, 0, 0, 26, 6, 44, 18
INVAR-1, Run: 084, F, 0, 0, 28, 7, 45, 17
INVAR-1, Run: 085, F, 0, 0, 32, 9, 47, 15
INVAR-1, Run: 086, F, 0, 0, 22, 4, 42, 20
INVAR-1, Run: 087, F, 0, 0, 24, 5, 43, 19
INVAR-1, Run: 088, F, 0, 0, 22, 4, 42, 20
INVAR-1, Run: 089, F, 0, 0, 32, 9, 47, 15
INVAR-1, Run: 090, F, 0, 0, 32, 9, 47, 15
INVAR-1, Run: 091, F, 0, 0, 32, 9, 47, 15
INVAR-1, Run: 092, F, 0, 0, 28, 7, 45, 17
INVAR-1, Run: 093, F, 0, 0, 32, 9, 47, 15
INVAR-1, Run: 094, F, 0, 0, 30, 8, 46, 16
INVAR-1, Run: 095, F, 0, 0, 26, 6, 44, 18
INVAR-1, Run: 096, F, 0, 0, 28, 7, 45, 17
INVAR-1, Run: 097, F, 0, 0, 28, 7, 45, 17
INVAR-1, Run: 098, F, 0, 0, 36, 11, 49, 13
INVAR-1, Run: 099, F, 0, 0, 30, 8, 46, 16
INVAR-1, Run: 100, F, 0, 0, 30, 8, 46, 16
INVAR-10, Run: 001, F, 0, 0, 30, 11, 61, 31
INVAR-10, Run: 002, F, 0, 0, 36, 14, 64, 28
INVAR-10, Run: 003, F, 0, 0, 32, 12, 62, 30
INVAR-10, Run: 004, F, 0, 0, 34, 13, 63, 29
INVAR-10, Run: 005, F, 0, 0, 38, 15, 65, 27
INVAR-10, Run: 006, F, 0, 0, 30, 11, 61, 31
INVAR-10, Run: 007, F, 0, 0, 28, 10, 60, 32
INVAR-10, Run: 008, F, 0, 0, 38, 15, 65, 27
INVAR-10, Run: 009, F, 0, 0, 38, 15, 65, 27
INVAR-10, Run: 010, F, 0, 0, 38, 15, 65, 27
INVAR-10, Run: 011, F, 0, 0, 40, 16, 66, 26
INVAR-10, Run: 012, F, 0, 0, 36, 14, 64, 28
INVAR-10, Run: 013, F, 0, 0, 34, 13, 63, 29
INVAR-10, Run: 014, F, 0, 0, 36, 14, 64, 28
INVAR-10, Run: 015, F, 0, 0, 36, 14, 64, 28
INVAR-10, Run: 016, F, 0, 0, 34, 13, 63, 29
INVAR-10, Run: 017, F, 0, 0, 30, 11, 61, 31
INVAR-10, Run: 018, F, 0, 0, 36, 14, 64, 28
INVAR-10, Run: 019, F, 0, 0, 36, 14, 64, 28
INVAR-10, Run: 020, F, 0, 0, 38, 15, 65, 27
INVAR-10, Run: 021, F, 0, 0, 32, 12, 62, 30
INVAR-10, Run: 022, F, 0, 0, 42, 17, 67, 25
INVAR-10, Run: 023, F, 0, 0, 40, 16, 66, 26
INVAR-10, Run: 024, F, 0, 0, 40, 16, 66, 26
INVAR-10, Run: 025, F, 0, 0, 32, 12, 62, 30
INVAR-10, Run: 026, F, 0, 0, 50, 21, 71, 21
INVAR-10, Run: 027, F, 0, 0, 36, 14, 64, 28
INVAR-10, Run: 028, F, 0, 0, 32, 12, 62, 30
INVAR-10, Run: 029, F, 0, 0, 22, 7, 57, 35
INVAR-10, Run: 030, F, 0, 0, 32, 12, 62, 30
INVAR-10, Run: 031, F, 0, 0, 36, 14, 64, 28
INVAR-10, Run: 032, F, 0, 0, 40, 16, 66, 26
INVAR-10, Run: 033, F, 0, 0, 34, 13, 63, 29
INVAR-10, Run: 034, F, 0, 0, 26, 9, 59, 33
INVAR-10, Run: 035, F, 0, 0, 36, 14, 64, 28
INVAR-10, Run: 036, F, 0, 0, 42, 17, 67, 25
INVAR-10, Run: 037, F, 0, 0, 34, 13, 63, 29
INVAR-10, Run: 038, F, 0, 0, 28, 10, 60, 32
INVAR-10, Run: 039, F, 0, 0, 44, 18, 68, 24
INVAR-10, Run: 040, F, 0, 0, 38, 15, 65, 27
INVAR-10, Run: 041, F, 0, 0, 22, 7, 57, 35
INVAR-10, Run: 042, F, 0, 0, 32, 12, 62, 30
INVAR-10, Run: 043, F, 0, 0, 28, 10, 60, 32
INVAR-10, Run: 044, F, 0, 0, 36, 14, 64, 28
INVAR-10, Run: 045, F, 0, 0, 38, 15, 65, 27
INVAR-10, Run: 046, F, 0, 0, 36, 14, 64, 28
INVAR-10, Run: 047, F, 0, 0, 36, 14, 64, 28
INVAR-10, Run: 048, F, 0, 0, 36, 14, 64, 28
INVAR-10, Run: 049, F, 0, 0, 32, 12, 62, 30
INVAR-10, Run: 050, F, 0, 0, 38, 15, 65, 27
INVAR-10, Run: 051, F, 0, 0, 38, 15, 65, 27
INVAR-10, Run: 052, F, 0, 0, 40, 16, 66, 26
INVAR-10, Run: 053, F, 0, 0, 34, 13, 63, 29
INVAR-10, Run: 054, F, 0, 0, 30, 11, 61, 31
INVAR-10, Run: 055, F, 0, 0, 32, 12, 62, 30
INVAR-10, Run: 056, F, 0, 0, 32, 12, 62, 30
INVAR-10, Run: 057, F, 0, 0, 40, 16, 66, 26
INVAR-10, Run: 058, F, 0, 0, 46, 19, 69, 23
INVAR-10, Run: 059, F, 0, 0, 40, 16, 66, 26
INVAR-10, Run: 060, F, 0, 0, 34, 13, 63, 29
INVAR-10, Run: 061, F, 0, 0, 42, 17, 67, 25
INVAR-10, Run: 062, F, 0, 0, 38, 15, 65, 27
INVAR-10, Run: 063, F, 0, 0, 36, 14, 64, 28
INVAR-10, Run: 064, F, 0, 0, 34, 13, 63, 29
INVAR-10, Run: 065, F, 0, 0, 34, 13, 63, 29
INVAR-10, Run: 066, F, 0, 0, 32, 12, 62, 30
INVAR-10, Run: 067, F, 0, 0, 54, 23, 73, 19
INVAR-10, Run: 068, F, 0, 0, 32, 12, 62, 30
INVAR-10, Run: 069, F, 0, 0, 36, 14, 64, 28
INVAR-10, Run: 070, F, 0, 0, 42, 17, 67, 25
INVAR-10, Run: 071, F, 0, 0, 40, 16, 66, 26
INVAR-10, Run: 072, F, 0, 0, 44, 18, 68, 24
INVAR-10, Run: 073, F, 0, 0, 32, 12, 62, 30
INVAR-10, Run: 074, F, 0, 0, 30, 11, 61, 31
INVAR-10, Run: 075, F, 0, 0, 30, 11, 61, 31
INVAR-10, Run: 076, F, 0, 0, 40, 16, 66, 26
INVAR-10, Run: 077, F, 0, 0, 36, 14, 64, 28
INVAR-10, Run: 078, F, 0, 0, 36, 14, 64, 28
INVAR-10, Run: 079, F, 0, 0, 38, 15, 65, 27
INVAR-10, Run: 080, F, 0, 0, 38, 15, 65, 27
INVAR-10, Run: 081, F, 0, 0, 36, 14, 64, 28
INVAR-10, Run: 082, F, 0, 0, 40, 16, 66, 26
INVAR-10, Run: 083, F, 0, 0, 34, 13, 63, 29
INVAR-10, Run: 084, F, 0, 0, 32, 12, 62, 30
INVAR-10, Run: 085, F, 0, 0, 30, 11, 61, 31
INVAR-10, Run: 086, F, 0, 0, 40, 16, 66, 26
INVAR-10, Run: 087, F, 0, 0, 30, 11, 61, 31
INVAR-10, Run: 088, F, 0, 0, 46, 19, 69, 23
INVAR-10, Run: 089, F, 0, 0, 38, 15, 65, 27
INVAR-10, Run: 090, F, 0, 0, 30, 11, 61, 31
INVAR-10, Run: 091, F, 0, 0, 34, 13, 63, 29
INVAR-10, Run: 092, F, 0, 0, 32, 12, 62, 30
INVAR-10, Run: 093, F, 0, 0, 42, 17, 67, 25
INVAR-10, Run: 094, F, 0, 0, 38, 15, 65, 27
INVAR-10, Run: 095, F, 0, 0, 30, 11, 61, 31
INVAR-10, Run: 096, F, 0, 0, 38, 15, 65, 27
INVAR-10, Run: 097, F, 0, 0, 30, 11, 61, 31
INVAR-10, Run: 098, F, 0, 0, 38, 15, 65, 27
INVAR-10, Run: 099, F, 0, 0, 48, 20, 70, 22
INVAR-10, Run: 100, F, 0, 0, 36, 14, 64, 28
INVAR-11, Run: 001, F, 0, 0, 66, 12, 112, 46
INVAR-11, Run: 002, F, 0, 0, 66, 12, 112, 46
INVAR-11, Run: 003, F, 0, 0, 64, 11, 111, 47
INVAR-11, Run: 004, F, 0, 0, 74, 16, 116, 42
INVAR-11, Run: 005, F, 0, 0, 68, 13, 113, 45
INVAR-11, Run: 006, F, 0, 0, 78, 18, 118, 40
INVAR-11, Run: 007, F, 0, 0, 76, 17, 117, 41
INVAR-11, Run: 008, F, 0, 0, 68, 13, 113, 45
INVAR-11, Run: 009, F, 0, 0, 82, 20, 120, 38
INVAR-11, Run: 010, F, 0, 0, 68, 13, 113, 45
INVAR-11, Run: 011, F, 0, 0, 68, 13, 113, 45
INVAR-11, Run: 012, F, 0, 0, 72, 15, 115, 43
INVAR-11, Run: 013, F, 0, 0, 76, 17, 117, 41
INVAR-11, Run: 014, F, 0, 0, 76, 17, 117, 41
INVAR-11, Run: 015, F, 0, 0, 70, 14, 114, 44
INVAR-11, Run: 016, F, 0, 0, 68, 13, 113, 45
INVAR-11, Run: 017, F, 0, 0, 84, 21, 121, 37
INVAR-11, Run: 018, F, 0, 0, 78, 18, 118, 40
INVAR-11, Run: 019, F, 0, 0, 68, 13, 113, 45
INVAR-11, Run: 020, F, 0, 0, 80, 19, 119, 39
INVAR-11, Run: 021, F, 0, 0, 80, 19, 119, 39
INVAR-11, Run: 022, F, 0, 0, 70, 14, 114, 44
INVAR-11, Run: 023, F, 0, 0, 84, 21, 121, 37
INVAR-11, Run: 024, F, 0, 0, 76, 17, 117, 41
INVAR-11, Run: 025, F, 0, 0, 72, 15, 115, 43
INVAR-11, Run: 026, F, 0, 0, 70, 14, 114, 44
INVAR-11, Run: 027, F, 0, 0, 70, 14, 114, 44
INVAR-11, Run: 028, F, 0, 0, 78, 18, 118, 40
INVAR-11, Run: 029, F, 0, 0, 74, 16, 116, 42
INVAR-11, Run: 030, F, 0, 0, 80, 19, 119, 39
INVAR-11, Run: 031, F, 0, 0, 68, 13, 113, 45
INVAR-11, Run: 032, F, 0, 0, 74, 16, 116, 42
INVAR-11, Run: 033, F, 0, 0, 68, 13, 113, 45
INVAR-11, Run: 034, F, 0, 0, 74, 16, 116, 42
INVAR-11, Run: 035, F, 0, 0, 72, 15, 115, 43
INVAR-11, Run: 036, F, 0, 0, 70, 14, 114, 44
INVAR-11, Run: 037, F, 0, 0, 78, 18, 118, 40
INVAR-11, Run: 038, F, 0, 0, 78, 18, 118, 40
INVAR-11, Run: 039, F, 0, 0, 62, 10, 110, 48
INVAR-11, Run: 040, F, 0, 0, 72, 15, 115, 43
INVAR-11, Run: 041, F, 0, 0, 86, 22, 122, 36
INVAR-11, Run: 042, F, 0, 0, 72, 15, 115, 43
INVAR-11, Run: 043, F, 0, 0, 68, 13, 113, 45
INVAR-11, Run: 044, F, 0, 0, 68, 13, 113, 45
INVAR-11, Run: 045, F, 0, 0, 78, 18, 118, 40
INVAR-11, Run: 046, F, 0, 0, 62, 10, 110, 48
INVAR-11, Run: 047, F, 0, 0, 60, 9, 109, 49
INVAR-11, Run: 048, F, 0, 0, 62, 10, 110, 48
INVAR-11, Run: 049, F, 0, 0, 72, 15, 115, 43
INVAR-11, Run: 050, F, 0, 0, 64, 11, 111, 47
INVAR-11, Run: 051, F, 0, 0, 80, 19, 119, 39
INVAR-11, Run: 052, F, 0, 0, 80, 19, 119, 39
INVAR-11, Run: 053, F, 0, 0, 68, 13, 113, 45
INVAR-11, Run: 054, F, 0, 0, 70, 14, 114, 44
INVAR-11, Run: 055, F, 0, 0, 68, 13, 113, 45
INVAR-11, Run: 056, F, 0, 0, 74, 16, 116, 42
INVAR-11, Run: 057, F, 0, 0, 78, 18, 118, 40
INVAR-11, Run: 058, F, 0, 0, 66, 12, 112, 46
INVAR-11, Run: 059, F, 0, 0, 70, 14, 114, 44
INVAR-11, Run: 060, F, 0, 0, 64, 11, 111, 47
INVAR-11, Run: 061, F, 0, 0, 80, 19, 119, 39
INVAR-11, Run: 062, F, 0, 0, 72, 15, 115, 43
INVAR-11, Run: 063, F, 0, 0, 72, 15, 115, 43
INVAR-11, Run: 064, F, 0, 0, 78, 18, 118, 40
INVAR-11, Run: 065, F, 0, 0, 66, 12, 112, 46
INVAR-11, Run: 066, F, 0, 0, 72, 15, 115, 43
INVAR-11, Run: 067, F, 0, 0, 68, 13, 113, 45
INVAR-11, Run: 068, F, 0, 0, 70, 14, 114, 44
INVAR-11, Run: 069, F, 0, 0, 78, 18, 118, 40
INVAR-11, Run: 070, F, 0, 0, 66, 12, 112, 46
INVAR-11, Run: 071, F, 0, 0, 74, 16, 116, 42
INVAR-11, Run: 072, F, 0, 0, 76, 17, 117, 41
INVAR-11, Run: 073, F, 0, 0, 78, 18, 118, 40
INVAR-11, Run: 074, F, 0, 0, 70, 14, 114, 44
INVAR-11, Run: 075, F, 0, 0, 86, 22, 122, 36
INVAR-11, Run: 076, F, 0, 0, 64, 11, 111, 47
INVAR-11, Run: 077, F, 0, 0, 64, 11, 111, 47
INVAR-11, Run: 078, F, 0, 0, 68, 13, 113, 45
INVAR-11, Run: 079, F, 0, 0, 68, 13, 113, 45
INVAR-11, Run: 080, F, 0, 0, 74, 16, 116, 42
INVAR-11, Run: 081, F, 0, 0, 80, 19, 119, 39
INVAR-11, Run: 082, F, 0, 0, 72, 15, 115, 43
INVAR-11, Run: 083, F, 0, 0, 66, 12, 112, 46
INVAR-11, Run: 084, F, 0, 0, 76, 17, 117, 41
INVAR-11, Run: 085, F, 0, 0, 74, 16, 116, 42
INVAR-11, Run: 086, F, 0, 0, 70, 14, 114, 44
INVAR-11, Run: 087, F, 0, 0, 84, 21, 121, 37
INVAR-11, Run: 088, F, 0, 0, 66, 12, 112, 46
INVAR-11, Run: 089, F, 0, 0, 70, 14, 114, 44
INVAR-11, Run: 090, F, 0, 0, 70, 14, 114, 44
INVAR-11, Run: 091, F, 0, 0, 72, 15, 115, 43
INVAR-11, Run: 092, F, 0, 0, 90, 24, 124, 34
INVAR-11, Run: 093, F, 0, 0, 66, 12, 112, 46
INVAR-11, Run: 094, F, 0, 0, 68, 13, 113, 45
INVAR-11, Run: 095, F, 0, 0, 66, 12, 112, 46
INVAR-11, Run: 096, F, 0, 0, 70, 14, 114, 44
INVAR-11, Run: 097, F, 0, 0, 78, 18, 118, 40
INVAR-11, Run: 098, F, 0, 0, 78, 18, 118, 40
INVAR-11, Run: 099, F, 0, 0, 70, 14, 114, 44
INVAR-11, Run: 100, F, 0, 0, 64, 11, 111, 47
INVAR-12, Run: 001, F, 0, 0, 140, 35, 235, 95
INVAR-12, Run: 002, F, 0, 0, 136, 33, 233, 97
INVAR-12, Run: 003, F, 0, 0, 142, 36, 236, 94
INVAR-12, Run: 004, F, 0, 0, 138, 34, 234, 96
INVAR-12, Run: 005, F, 0, 0, 144, 37, 237, 93
INVAR-12, Run: 006, F, 0, 0, 138, 34, 234, 96
INVAR-12, Run: 007, F, 0, 0, 136, 33, 233, 97
INVAR-12, Run: 008, F, 0, 0, 140, 35, 235, 95
INVAR-12, Run: 009, F, 0, 0, 120, 25, 225, 105
INVAR-12, Run: 010, F, 0, 0, 132, 31, 231, 99
INVAR-12, Run: 011, F, 0, 0, 136, 33, 233, 97
INVAR-12, Run: 012, F, 0, 0, 132, 31, 231, 99
INVAR-12, Run: 013, F, 0, 0, 134, 32, 232, 98
INVAR-12, Run: 014, F, 0, 0, 150, 40, 240, 90
INVAR-12, Run: 015, F, 0, 0, 134, 32, 232, 98
INVAR-12, Run: 016, F, 0, 0, 134, 32, 232, 98
INVAR-12, Run: 017, F, 0, 0, 128, 29, 229, 101
INVAR-12, Run: 018, F, 0, 0, 160, 45, 245, 85
INVAR-12, Run: 019, F, 0, 0, 136, 33, 233, 97
INVAR-12, Run: 020, F, 0, 0, 132, 31, 231, 99
INVAR-12, Run: 021, F, 0, 0, 148, 39, 239, 91
INVAR-12, Run: 022, F, 0, 0, 142, 36, 236, 94
INVAR-12, Run: 023, F, 0, 0, 144, 37, 237, 93
INVAR-12, Run: 024, F, 0, 0, 140, 35, 235, 95
INVAR-12, Run: 025, F, 0, 0, 142, 36, 236, 94
INVAR-12, Run: 026, F, 0, 0, 136, 33, 233, 97
INVAR-12, Run: 027, F, 0, 0, 128, 29, 229, 101
INVAR-12, Run: 028, F, 0, 0, 116, 23, 223, 107
INVAR-12, Run: 029, F, 0, 0, 130, 30, 230, 100
INVAR-12, Run: 030, F, 0, 0, 138, 34, 234, 96
INVAR-12, Run: 031, F, 0, 0, 150, 40, 240, 90
INVAR-12, Run: 032, F, 0, 0, 146, 38, 238, 92
INVAR-12, Run: 033, F, 0, 0, 126, 28, 228, 102
INVAR-12, Run: 034, F, 0, 0, 144, 37, 237, 93
INVAR-12, Run: 035, F, 0, 0, 138, 34, 234, 96
INVAR-12, Run: 036, F, 0, 0, 156, 43, 243, 87
INVAR-12, Run: 037, F, 0, 0, 144, 37, 237, 93
INVAR-12, Run: 038, F, 0, 0, 132, 31, 231, 99
INVAR-12, Run: 039, F, 0, 0, 134, 32, 232, 98
INVAR-12, Run: 040, F, 0, 0, 142, 36, 236, 94
INVAR-12, Run: 041, F, 0, 0, 144, 37, 237, 93
INVAR-12, Run: 042, F, 0, 0, 140, 35, 235, 95
INVAR-12, Run: 043, F, 0, 0, 146, 38, 238, 92
INVAR-12, Run: 044, F, 0, 0, 150, 40, 240, 90
INVAR-12, Run: 045, F, 0, 0, 160, 45, 245, 85
INVAR-12, Run: 046, F, 0, 0, 148, 39, 239, 91
INVAR-12, Run: 047, F, 0, 0, 140, 35, 235, 95
INVAR-12, Run: 048, F, 0, 0, 130, 30, 230, 100
INVAR-12, Run: 049, F, 0, 0, 136, 33, 233, 97
INVAR-12, Run: 050, F, 0, 0, 120, 25, 225, 105
INVAR-12, Run: 051, F, 0, 0, 134, 32, 232, 98
INVAR-12, Run: 052, F, 0, 0, 144, 37, 237, 93
INVAR-12, Run: 053, F, 0, 0, 148, 39, 239, 91
INVAR-12, Run: 054, F, 0, 0, 134, 32, 232, 98
INVAR-12, Run: 055, F, 0, 0, 148, 39, 239, 91
INVAR-12, Run: 056, F, 0, 0, 156, 43, 243, 87
INVAR-12, Run: 057, F, 0, 0, 154, 42, 242, 88
INVAR-12, Run: 058, F, 0, 0, 142, 36, 236, 94
INVAR-12, Run: 059, F, 0, 0, 140, 35, 235, 95
INVAR-12, Run: 060, F, 0, 0, 126, 28, 228, 102
INVAR-12, Run: 061, F, 0, 0, 142, 36, 236, 94
INVAR-12, Run: 062, F, 0, 0, 140, 35, 235, 95
INVAR-12, Run: 063, F, 0, 0, 142, 36, 236, 94
INVAR-12, Run: 064, F, 0, 0, 144, 37, 237, 93
INVAR-12, Run: 065, F, 0, 0, 138, 34, 234, 96
INVAR-12, Run: 066, F, 0, 0, 132, 31, 231, 99
INVAR-12, Run: 067, F, 0, 0, 146, 38, 238, 92
INVAR-12, Run: 068, F, 0, 0, 140, 35, 235, 95
INVAR-12, Run: 069, F, 0, 0, 152, 41, 241, 89
INVAR-12, Run: 070, F, 0, 0, 144, 37, 237, 93
INVAR-12, Run: 071, F, 0, 0, 150, 40, 240, 90
INVAR-12, Run: 072, F, 0, 0, 130, 30, 230, 100
INVAR-12, Run: 073, F, 0, 0, 140, 35, 235, 95
INVAR-12, Run: 074, F, 0, 0, 150, 40, 240, 90
INVAR-12, Run: 075, F, 0, 0, 132, 31, 231, 99
INVAR-12, Run: 076, F, 0, 0, 150, 40, 240, 90
INVAR-12, Run: 077, F, 0, 0, 156, 43, 243, 87
INVAR-12, Run: 078, F, 0, 0, 150, 40, 240, 90
INVAR-12, Run: 079, F, 0, 0, 150, 40, 240, 90
INVAR-12, Run: 080, F, 0, 0, 138, 34, 234, 96
INVAR-12, Run: 081, F, 0, 0, 136, 33, 233, 97
INVAR-12, Run: 082, F, 0, 0, 152, 41, 241, 89
INVAR-12, Run: 083, F, 0, 0, 142, 36, 236, 94
INVAR-12, Run: 084, F, 0, 0, 144, 37, 237, 93
INVAR-12, Run: 085, F, 0, 0, 140, 35, 235, 95
INVAR-12, Run: 086, F, 0, 0, 142, 36, 236, 94
INVAR-12, Run: 087, F, 0, 0, 146, 38, 238, 92
INVAR-12, Run: 088, F, 0, 0, 140, 35, 235, 95
INVAR-12, Run: 089, F, 0, 0, 130, 30, 230, 100
INVAR-12, Run: 090, F, 0, 0, 128, 29, 229, 101
INVAR-12, Run: 091, F, 0, 0, 146, 38, 238, 92
INVAR-12, Run: 092, F, 0, 0, 132, 31, 231, 99
INVAR-12, Run: 093, F, 0, 0, 128, 29, 229, 101
INVAR-12, Run: 094, F, 0, 0, 140, 35, 235, 95
INVAR-12, Run: 095, F, 0, 0, 134, 32, 232, 98
INVAR-12, Run: 096, F, 0, 0, 146, 38, 238, 92
INVAR-12, Run: 097, F, 0, 0, 124, 27, 227, 103
INVAR-12, Run: 098, F, 0, 0, 140, 35, 235, 95
INVAR-12, Run: 099, F, 0, 0, 140, 35, 235, 95
INVAR-12, Run: 100, F, 0, 0, 132, 31, 231, 99
INVAR-13, Run: 001, F, 0, 0, 15, 1, 19, 4
INVAR-13, Run: 002, F, 0, 0, 17, 2, 20, 3
INVAR-13, Run: 003, F, 0, 0, 15, 1, 19, 4
INVAR-13, Run: 004, F, 0, 0, 15, 1, 19, 4
INVAR-13, Run: 005, F, 0, 0, 21, 4, 22, 1
INVAR-13, Run: 006, F, 0, 0, 19, 3, 21, 2
INVAR-13, Run: 007, F, 0, 0, 17, 2, 20, 3
INVAR-13, Run: 008, F, 0, 0, 15, 1, 19, 4
INVAR-13, Run: 009, F, 0, 0, 15, 1, 19, 4
INVAR-13, Run: 010, F, 0, 0, 17, 2, 20, 3
INVAR-13, Run: 011, F, 0, 0, 19, 3, 21, 2
INVAR-13, Run: 012, F, 0, 0, 21, 4, 22, 1
INVAR-13, Run: 013, F, 0, 0, 15, 1, 19, 4
INVAR-13, Run: 014, F, 0, 0, 15, 1, 19, 4
INVAR-13, Run: 015, F, 0, 0, 17, 2, 20, 3
INVAR-13, Run: 016, F, 0, 0, 15, 1, 19, 4
INVAR-13, Run: 017, P, 0, 0, 13, 0, 18, 5
INVAR-13, Run: 018, F, 0, 0, 15, 1, 19, 4
INVAR-13, Run: 019, F, 0, 0, 15, 1, 19, 4
INVAR-13, Run: 020, F, 0, 0, 15, 1, 19, 4
INVAR-13, Run: 021, F, 0, 0, 15, 1, 19, 4
INVAR-13, Run: 022, F, 0, 0, 17, 2, 20, 3
INVAR-13, Run: 023, F, 0, 0, 15, 1, 19, 4
INVAR-13, Run: 024, F, 0, 0, 15, 1, 19, 4
INVAR-13, Run: 025, F, 0, 0, 17, 2, 20, 3
INVAR-13, Run: 026, F, 0, 0, 17, 2, 20, 3
INVAR-13, Run: 027, F, 0, 0, 15, 1, 19, 4
INVAR-13, Run: 028, F, 0, 0, 15, 1, 19, 4
INVAR-13, Run: 029, F, 0, 0, 15, 1, 19, 4
INVAR-13, Run: 030, P, 0, 0, 13, 0, 18, 5
INVAR-13, Run: 031, P, 0, 0, 13, 0, 18, 5
INVAR-13, Run: 032, F, 0, 0, 17, 2, 20, 3
INVAR-13, Run: 033, P, 0, 0, 13, 0, 18, 5
INVAR-13, Run: 034, F, 0, 0, 15, 1, 19, 4
INVAR-13, Run: 035, P, 0, 0, 13, 0, 18, 5
INVAR-13, Run: 036, F, 0, 0, 17, 2, 20, 3
INVAR-13, Run: 037, F, 0, 0, 15, 1, 19, 4
INVAR-13, Run: 038, F, 0, 0, 15, 1, 19, 4
INVAR-13, Run: 039, F, 0, 0, 15, 1, 19, 4
INVAR-13, Run: 040, F, 0, 0, 19, 3, 21, 2
INVAR-13, Run: 041, P, 0, 0, 13, 0, 18, 5
INVAR-13, Run: 042, P, 0, 0, 13, 0, 18, 5
INVAR-13, Run: 043, F, 0, 0, 15, 1, 19, 4
INVAR-13, Run: 044, F, 0, 0, 15, 1, 19, 4
INVAR-13, Run: 045, F, 0, 0, 19, 3, 21, 2
INVAR-13, Run: 046, P, 0, 0, 13, 0, 18, 5
INVAR-13, Run: 047, F, 0, 0, 15, 1, 19, 4
INVAR-13, Run: 048, F, 0, 0, 15, 1, 19, 4
INVAR-13, Run: 049, F, 0, 0, 15, 1, 19, 4
INVAR-13, Run: 050, F, 0, 0, 15, 1, 19, 4
INVAR-13, Run: 051, F, 0, 0, 17, 2, 20, 3
INVAR-13, Run: 052, F, 0, 0, 17, 2, 20, 3
INVAR-13, Run: 053, F, 0, 0, 15, 1, 19, 4
INVAR-13, Run: 054, F, 0, 0, 15, 1, 19, 4
INVAR-13, Run: 055, F, 0, 0, 15, 1, 19, 4
INVAR-13, Run: 056, F, 0, 0, 17, 2, 20, 3
INVAR-13, Run: 057, F, 0, 0, 17, 2, 20, 3
INVAR-13, Run: 058, F, 0, 0, 17, 2, 20, 3
INVAR-13, Run: 059, F, 0, 0, 19, 3, 21, 2
INVAR-13, Run: 060, F, 0, 0, 17, 2, 20, 3
INVAR-13, Run: 061, F, 0, 0, 15, 1, 19, 4
INVAR-13, Run: 062, F, 0, 0, 19, 3, 21, 2
INVAR-13, Run: 063, F, 0, 0, 19, 3, 21, 2
INVAR-13, Run: 064, F, 0, 0, 19, 3, 21, 2
INVAR-13, Run: 065, F, 0, 0, 17, 2, 20, 3
INVAR-13, Run: 066, F, 0, 0, 15, 1, 19, 4
INVAR-13, Run: 067, F, 0, 0, 17, 2, 20, 3
INVAR-13, Run: 068, F, 0, 0, 19, 3, 21, 2
INVAR-13, Run: 069, F, 0, 0, 21, 4, 22, 1
INVAR-13, Run: 070, F, 0, 0, 17, 2, 20, 3
INVAR-13, Run: 071, F, 0, 0, 15, 1, 19, 4
INVAR-13, Run: 072, F, 0, 0, 15, 1, 19, 4
INVAR-13, Run: 073, P, 0, 0, 13, 0, 18, 5
INVAR-13, Run: 074, F, 0, 0, 17, 2, 20, 3
INVAR-13, Run: 075, F, 0, 0, 15, 1, 19, 4
INVAR-13, Run: 076, F, 0, 0, 15, 1, 19, 4
INVAR-13, Run: 077, F, 0, 0, 17, 2, 20, 3
INVAR-13, Run: 078, F, 0, 0, 15, 1, 19, 4
INVAR-13, Run: 079, F, 0, 0, 15, 1, 19, 4
INVAR-13, Run: 080, F, 0, 0, 17, 2, 20, 3
INVAR-13, Run: 081, F, 0, 0, 15, 1, 19, 4
INVAR-13, Run: 082, F, 0, 0, 15, 1, 19, 4
INVAR-13, Run: 083, F, 0, 0, 17, 2, 20, 3
INVAR-13, Run: 084, F, 0, 0, 17, 2, 20, 3
INVAR-13, Run: 085, F, 0, 0, 17, 2, 20, 3
INVAR-13, Run: 086, F, 0, 0, 15, 1, 19, 4
INVAR-13, Run: 087, F, 0, 0, 15, 1, 19, 4
INVAR-13, Run: 088, P, 0, 0, 13, 0, 18, 5
INVAR-13, Run: 089, F, 0, 0, 17, 2, 20, 3
INVAR-13, Run: 090, F, 0, 0, 19, 3, 21, 2
INVAR-13, Run: 091, F, 0, 0, 15, 1, 19, 4
INVAR-13, Run: 092, F, 0, 0, 17, 2, 20, 3
INVAR-13, Run: 093, F, 0, 0, 17, 2, 20, 3
INVAR-13, Run: 094, F, 0, 0, 15, 1, 19, 4
INVAR-13, Run: 095, P, 0, 0, 13, 0, 18, 5
INVAR-13, Run: 096, F, 0, 0, 17, 2, 20, 3
INVAR-13, Run: 097, P, 0, 0, 13, 0, 18, 5
INVAR-13, Run: 098, F, 0, 0, 15, 1, 19, 4
INVAR-13, Run: 099, P, 0, 0, 13, 0, 18, 5
INVAR-13, Run: 100, P, 0, 0, 13, 0, 18, 5
INVAR-14, Run: 001, F, 0, 0, 65, 29, 122, 57
INVAR-14, Run: 002, F, 0, 0, 53, 23, 116, 63
INVAR-14, Run: 003, F, 0, 0, 59, 26, 119, 60
INVAR-14, Run: 004, F, 0, 0, 69, 31, 124, 55
INVAR-14, Run: 005, F, 0, 0, 63, 28, 121, 58
INVAR-14, Run: 006, F, 0, 0, 73, 33, 126, 53
INVAR-14, Run: 007, F, 0, 0, 61, 27, 120, 59
INVAR-14, Run: 008, F, 0, 0, 67, 30, 123, 56
INVAR-14, Run: 009, F, 0, 0, 69, 31, 124, 55
INVAR-14, Run: 010, F, 0, 0, 69, 31, 124, 55
INVAR-14, Run: 011, F, 0, 0, 69, 31, 124, 55
INVAR-14, Run: 012, F, 0, 0, 73, 33, 126, 53
INVAR-14, Run: 013, F, 0, 0, 65, 29, 122, 57
INVAR-14, Run: 014, F, 0, 0, 73, 33, 126, 53
INVAR-14, Run: 015, F, 0, 0, 69, 31, 124, 55
INVAR-14, Run: 016, F, 0, 0, 71, 32, 125, 54
INVAR-14, Run: 017, F, 0, 0, 73, 33, 126, 53
INVAR-14, Run: 018, F, 0, 0, 69, 31, 124, 55
INVAR-14, Run: 019, F, 0, 0, 69, 31, 124, 55
INVAR-14, Run: 020, F, 0, 0, 73, 33, 126, 53
INVAR-14, Run: 021, F, 0, 0, 63, 28, 121, 58
INVAR-14, Run: 022, F, 0, 0, 57, 25, 118, 61
INVAR-14, Run: 023, F, 0, 0, 67, 30, 123, 56
INVAR-14, Run: 024, F, 0, 0, 63, 28, 121, 58
INVAR-14, Run: 025, F, 0, 0, 67, 30, 123, 56
INVAR-14, Run: 026, F, 0, 0, 65, 29, 122, 57
INVAR-14, Run: 027, F, 0, 0, 61, 27, 120, 59
INVAR-14, Run: 028, F, 0, 0, 69, 31, 124, 55
INVAR-14, Run: 029, F, 0, 0, 63, 28, 121, 58
INVAR-14, Run: 030, F, 0, 0, 55, 24, 117, 62
INVAR-14, Run: 031, F, 0, 0, 67, 30, 123, 56
INVAR-14, Run: 032, F, 0, 0, 67, 30, 123, 56
INVAR-14, Run: 033, F, 0, 0, 71, 32, 125, 54
INVAR-14, Run: 034, F, 0, 0, 71, 32, 125, 54
INVAR-14, Run: 035, F, 0, 0, 61, 27, 120, 59
INVAR-14, Run: 036, F, 0, 0, 65, 29, 122, 57
INVAR-14, Run: 037, F, 0, 0, 65, 29, 122, 57
INVAR-14, Run: 038, F, 0, 0, 63, 28, 121, 58
INVAR-14, Run: 039, F, 0, 0, 59, 26, 119, 60
INVAR-14, Run: 040, F, 0, 0, 61, 27, 120, 59
INVAR-14, Run: 041, F, 0, 0, 77, 35, 128, 51
INVAR-14, Run: 042, F, 0, 0, 63, 28, 121, 58
INVAR-14, Run: 043, F, 0, 0, 75, 34, 127, 52
INVAR-14, Run: 044, F, 0, 0, 53, 23, 116, 63
INVAR-14, Run: 045, F, 0, 0, 59, 26, 119, 60
INVAR-14, Run: 046, F, 0, 0, 73, 33, 126, 53
INVAR-14, Run: 047, F, 0, 0, 65, 29, 122, 57
INVAR-14, Run: 048, F, 0, 0, 65, 29, 122, 57
INVAR-14, Run: 049, F, 0, 0, 77, 35, 128, 51
INVAR-14, Run: 050, F, 0, 0, 63, 28, 121, 58
INVAR-14, Run: 051, F, 0, 0, 69, 31, 124, 55
INVAR-14, Run: 052, F, 0, 0, 69, 31, 124, 55
INVAR-14, Run: 053, F, 0, 0, 55, 24, 117, 62
INVAR-14, Run: 054, F, 0, 0, 65, 29, 122, 57
INVAR-14, Run: 055, F, 0, 0, 63, 28, 121, 58
INVAR-14, Run: 056, F, 0, 0, 63, 28, 121, 58
INVAR-14, Run: 057, F, 0, 0, 65, 29, 122, 57
INVAR-14, Run: 058, F, 0, 0, 57, 25, 118, 61
INVAR-14, Run: 059, F, 0, 0, 77, 35, 128, 51
INVAR-14, Run: 060, F, 0, 0, 65, 29, 122, 57
INVAR-14, Run: 061, F, 0, 0, 75, 34, 127, 52
INVAR-14, Run: 062, F, 0, 0, 55, 24, 117, 62
INVAR-14, Run: 063, F, 0, 0, 65, 29, 122, 57
INVAR-14, Run: 064, F, 0, 0, 59, 26, 119, 60
INVAR-14, Run: 065, F, 0, 0, 69, 31, 124, 55
INVAR-14, Run: 066, F, 0, 0, 63, 28, 121, 58
INVAR-14, Run: 067, F, 0, 0, 67, 30, 123, 56
INVAR-14, Run: 068, F, 0, 0, 55, 24, 117, 62
INVAR-14, Run: 069, F, 0, 0, 65, 29, 122, 57
INVAR-14, Run: 070, F, 0, 0, 63, 28, 121, 58
INVAR-14, Run: 071, F, 0, 0, 73, 33, 126, 53
INVAR-14, Run: 072, F, 0, 0, 69, 31, 124, 55
INVAR-14, Run: 073, F, 0, 0, 63, 28, 121, 58
INVAR-14, Run: 074, F, 0, 0, 59, 26, 119, 60
INVAR-14, Run: 075, F, 0, 0, 63, 28, 121, 58
INVAR-14, Run: 076, F, 0, 0, 61, 27, 120, 59
INVAR-14, Run: 077, F, 0, 0, 55, 24, 117, 62
INVAR-14, Run: 078, F, 0, 0, 69, 31, 124, 55
INVAR-14, Run: 079, F, 0, 0, 67, 30, 123, 56
INVAR-14, Run: 080, F, 0, 0, 67, 30, 123, 56
INVAR-14, Run: 081, F, 0, 0, 71, 32, 125, 54
INVAR-14, Run: 082, F, 0, 0, 71, 32, 125, 54
INVAR-14, Run: 083, F, 0, 0, 69, 31, 124, 55
INVAR-14, Run: 084, F, 0, 0, 51, 22, 115, 64
INVAR-14, Run: 085, F, 0, 0, 65, 29, 122, 57
INVAR-14, Run: 086, F, 0, 0, 75, 34, 127, 52
INVAR-14, Run: 087, F, 0, 0, 61, 27, 120, 59
INVAR-14, Run: 088, F, 0, 0, 65, 29, 122, 57
INVAR-14, Run: 089, F, 0, 0, 71, 32, 125, 54
INVAR-14, Run: 090, F, 0, 0, 59, 26, 119, 60
INVAR-14, Run: 091, F, 0, 0, 57, 25, 118, 61
INVAR-14, Run: 092, F, 0, 0, 57, 25, 118, 61
INVAR-14, Run: 093, F, 0, 0, 55, 24, 117, 62
INVAR-14, Run: 094, F, 0, 0, 67, 30, 123, 56
INVAR-14, Run: 095, F, 0, 0, 63, 28, 121, 58
INVAR-14, Run: 096, F, 0, 0, 61, 27, 120, 59
INVAR-14, Run: 097, F, 0, 0, 63, 28, 121, 58
INVAR-14, Run: 098, F, 0, 0, 59, 26, 119, 60
INVAR-14, Run: 099, F, 0, 0, 57, 25, 118, 61
INVAR-14, Run: 100, F, 0, 0, 69, 31, 124, 55
INVAR-15, Run: 001, F, 0, 0, 127, 58, 231, 104
INVAR-15, Run: 002, F, 0, 0, 119, 54, 227, 108
INVAR-15, Run: 003, F, 0, 0, 103, 46, 219, 116
INVAR-15, Run: 004, F, 0, 0, 131, 60, 233, 102
INVAR-15, Run: 005, F, 0, 0, 113, 51, 224, 111
INVAR-15, Run: 006, F, 0, 0, 115, 52, 225, 110
INVAR-15, Run: 007, F, 0, 0, 109, 49, 222, 113
INVAR-15, Run: 008, F, 0, 0, 107, 48, 221, 114
INVAR-15, Run: 009, F, 0, 0, 105, 47, 220, 115
INVAR-15, Run: 010, F, 0, 0, 127, 58, 231, 104
INVAR-15, Run: 011, F, 0, 0, 103, 46, 219, 116
INVAR-15, Run: 012, F, 0, 0, 131, 60, 233, 102
INVAR-15, Run: 013, F, 0, 0, 139, 64, 237, 98
INVAR-15, Run: 014, F, 0, 0, 121, 55, 228, 107
INVAR-15, Run: 015, F, 0, 0, 121, 55, 228, 107
INVAR-15, Run: 016, F, 0, 0, 113, 51, 224, 111
INVAR-15, Run: 017, F, 0, 0, 129, 59, 232, 103
INVAR-15, Run: 018, F, 0, 0, 115, 52, 225, 110
INVAR-15, Run: 019, F, 0, 0, 119, 54, 227, 108
INVAR-15, Run: 020, F, 0, 0, 125, 57, 230, 105
INVAR-15, Run: 021, F, 0, 0, 111, 50, 223, 112
INVAR-15, Run: 022, F, 0, 0, 115, 52, 225, 110
INVAR-15, Run: 023, F, 0, 0, 123, 56, 229, 106
INVAR-15, Run: 024, F, 0, 0, 123, 56, 229, 106
INVAR-15, Run: 025, F, 0, 0, 123, 56, 229, 106
INVAR-15, Run: 026, F, 0, 0, 101, 45, 218, 117
INVAR-15, Run: 027, F, 0, 0, 133, 61, 234, 101
INVAR-15, Run: 028, F, 0, 0, 117, 53, 226, 109
INVAR-15, Run: 029, F, 0, 0, 111, 50, 223, 112
INVAR-15, Run: 030, F, 0, 0, 129, 59, 232, 103
INVAR-15, Run: 031, F, 0, 0, 109, 49, 222, 113
INVAR-15, Run: 032, F, 0, 0, 115, 52, 225, 110
INVAR-15, Run: 033, F, 0, 0, 103, 46, 219, 116
INVAR-15, Run: 034, F, 0, 0, 119, 54, 227, 108
INVAR-15, Run: 035, F, 0, 0, 103, 46, 219, 116
INVAR-15, Run: 036, F, 0, 0, 115, 52, 225, 110
INVAR-15, Run: 037, F, 0, 0, 101, 45, 218, 117
INVAR-15, Run: 038, F, 0, 0, 131, 60, 233, 102
INVAR-15, Run: 039, F, 0, 0, 117, 53, 226, 109
INVAR-15, Run: 040, F, 0, 0, 123, 56, 229, 106
INVAR-15, Run: 041, F, 0, 0, 117, 53, 226, 109
INVAR-15, Run: 042, F, 0, 0, 117, 53, 226, 109
INVAR-15, Run: 043, F, 0, 0, 121, 55, 228, 107
INVAR-15, Run: 044, F, 0, 0, 103, 46, 219, 116
INVAR-15, Run: 045, F, 0, 0, 121, 55, 228, 107
INVAR-15, Run: 046, F, 0, 0, 111, 50, 223, 112
INVAR-15, Run: 047, F, 0, 0, 123, 56, 229, 106
INVAR-15, Run: 048, F, 0, 0, 125, 57, 230, 105
INVAR-15, Run: 049, F, 0, 0, 135, 62, 235, 100
INVAR-15, Run: 050, F, 0, 0, 125, 57, 230, 105
INVAR-15, Run: 051, F, 0, 0, 131, 60, 233, 102
INVAR-15, Run: 052, F, 0, 0, 111, 50, 223, 112
INVAR-15, Run: 053, F, 0, 0, 109, 49, 222, 113
INVAR-15, Run: 054, F, 0, 0, 115, 52, 225, 110
INVAR-15, Run: 055, F, 0, 0, 113, 51, 224, 111
INVAR-15, Run: 056, F, 0, 0, 115, 52, 225, 110
INVAR-15, Run: 057, F, 0, 0, 119, 54, 227, 108
INVAR-15, Run: 058, F, 0, 0, 125, 57, 230, 105
INVAR-15, Run: 059, F, 0, 0, 135, 62, 235, 100
INVAR-15, Run: 060, F, 0, 0, 131, 60, 233, 102
INVAR-15, Run: 061, F, 0, 0, 139, 64, 237, 98
INVAR-15, Run: 062, F, 0, 0, 131, 60, 233, 102
INVAR-15, Run: 063, F, 0, 0, 123, 56, 229, 106
INVAR-15, Run: 064, F, 0, 0, 107, 48, 221, 114
INVAR-15, Run: 065, F, 0, 0, 129, 59, 232, 103
INVAR-15, Run: 066, F, 0, 0, 103, 46, 219, 116
INVAR-15, Run: 067, F, 0, 0, 109, 49, 222, 113
INVAR-15, Run: 068, F, 0, 0, 115, 52, 225, 110
INVAR-15, Run: 069, F, 0, 0, 109, 49, 222, 113
INVAR-15, Run: 070, F, 0, 0, 111, 50, 223, 112
INVAR-15, Run: 071, F, 0, 0, 105, 47, 220, 115
INVAR-15, Run: 072, F, 0, 0, 105, 47, 220, 115
INVAR-15, Run: 073, F, 0, 0, 103, 46, 219, 116
INVAR-15, Run: 074, F, 0, 0, 121, 55, 228, 107
INVAR-15, Run: 075, F, 0, 0, 117, 53, 226, 109
INVAR-15, Run: 076, F, 0, 0, 121, 55, 228, 107
INVAR-15, Run: 077, F, 0, 0, 143, 66, 239, 96
INVAR-15, Run: 078, F, 0, 0, 115, 52, 225, 110
INVAR-15, Run: 079, F, 0, 0, 125, 57, 230, 105
INVAR-15, Run: 080, F, 0, 0, 125, 57, 230, 105
INVAR-15, Run: 081, F, 0, 0, 115, 52, 225, 110
INVAR-15, Run: 082, F, 0, 0, 115, 52, 225, 110
INVAR-15, Run: 083, F, 0, 0, 137, 63, 236, 99
INVAR-15, Run: 084, F, 0, 0, 123, 56, 229, 106
INVAR-15, Run: 085, F, 0, 0, 123, 56, 229, 106
INVAR-15, Run: 086, F, 0, 0, 121, 55, 228, 107
INVAR-15, Run: 087, F, 0, 0, 125, 57, 230, 105
INVAR-15, Run: 088, F, 0, 0, 125, 57, 230, 105
INVAR-15, Run: 089, F, 0, 0, 131, 60, 233, 102
INVAR-15, Run: 090, F, 0, 0, 107, 48, 221, 114
INVAR-15, Run: 091, F, 0, 0, 127, 58, 231, 104
INVAR-15, Run: 092, F, 0, 0, 113, 51, 224, 111
INVAR-15, Run: 093, F, 0, 0, 133, 61, 234, 101
INVAR-15, Run: 094, F, 0, 0, 117, 53, 226, 109
INVAR-15, Run: 095, F, 0, 0, 109, 49, 222, 113
INVAR-15, Run: 096, F, 0, 0, 123, 56, 229, 106
INVAR-15, Run: 097, F, 0, 0, 125, 57, 230, 105
INVAR-15, Run: 098, F, 0, 0, 111, 50, 223, 112
INVAR-15, Run: 099, F, 0, 0, 105, 47, 220, 115
INVAR-15, Run: 100, F, 0, 0, 103, 46, 219, 116
INVAR-16, Run: 001, F, 0, 0, 10, 5, 20, 10
INVAR-16, Run: 002, F, 0, 0, 12, 6, 21, 9
INVAR-16, Run: 003, F, 0, 0, 10, 5, 20, 10
INVAR-16, Run: 004, F, 0, 0, 14, 7, 22, 8
INVAR-16, Run: 005, F, 0, 0, 14, 7, 22, 8
INVAR-16, Run: 006, F, 0, 0, 14, 7, 22, 8
INVAR-16, Run: 007, F, 0, 0, 10, 5, 20, 10
INVAR-16, Run: 008, F, 0, 0, 12, 6, 21, 9
INVAR-16, Run: 009, F, 0, 0, 18, 9, 24, 6
INVAR-16, Run: 010, F, 0, 0, 12, 6, 21, 9
INVAR-16, Run: 011, F, 0, 0, 8, 4, 19, 11
INVAR-16, Run: 012, F, 0, 0, 14, 7, 22, 8
INVAR-16, Run: 013, F, 0, 0, 12, 6, 21, 9
INVAR-16, Run: 014, F, 0, 0, 12, 6, 21, 9
INVAR-16, Run: 015, F, 0, 0, 16, 8, 23, 7
INVAR-16, Run: 016, F, 0, 0, 10, 5, 20, 10
INVAR-16, Run: 017, F, 0, 0, 14, 7, 22, 8
INVAR-16, Run: 018, F, 0, 0, 18, 9, 24, 6
INVAR-16, Run: 019, F, 0, 0, 10, 5, 20, 10
INVAR-16, Run: 020, F, 0, 0, 14, 7, 22, 8
INVAR-16, Run: 021, F, 0, 0, 14, 7, 22, 8
INVAR-16, Run: 022, F, 0, 0, 10, 5, 20, 10
INVAR-16, Run: 023, F, 0, 0, 10, 5, 20, 10
INVAR-16, Run: 024, F, 0, 0, 12, 6, 21, 9
INVAR-16, Run: 025, F, 0, 0, 18, 9, 24, 6
INVAR-16, Run: 026, F, 0, 0, 14, 7, 22, 8
INVAR-16, Run: 027, F, 0, 0, 10, 5, 20, 10
INVAR-16, Run: 028, F, 0, 0, 18, 9, 24, 6
INVAR-16, Run: 029, F, 0, 0, 12, 6, 21, 9
INVAR-16, Run: 030, F, 0, 0, 14, 7, 22, 8
INVAR-16, Run: 031, F, 0, 0, 18, 9, 24, 6
INVAR-16, Run: 032, F, 0, 0, 14, 7, 22, 8
INVAR-16, Run: 033, F, 0, 0, 8, 4, 19, 11
INVAR-16, Run: 034, F, 0, 0, 16, 8, 23, 7
INVAR-16, Run: 035, F, 0, 0, 12, 6, 21, 9
INVAR-16, Run: 036, F, 0, 0, 14, 7, 22, 8
INVAR-16, Run: 037, F, 0, 0, 12, 6, 21, 9
INVAR-16, Run: 038, F, 0, 0, 10, 5, 20, 10
INVAR-16, Run: 039, F, 0, 0, 12, 6, 21, 9
INVAR-16, Run: 040, F, 0, 0, 12, 6, 21, 9
INVAR-16, Run: 041, F, 0, 0, 18, 9, 24, 6
INVAR-16, Run: 042, F, 0, 0, 8, 4, 19, 11
INVAR-16, Run: 043, F, 0, 0, 14, 7, 22, 8
INVAR-16, Run: 044, F, 0, 0, 16, 8, 23, 7
INVAR-16, Run: 045, F, 0, 0, 14, 7, 22, 8
INVAR-16, Run: 046, F, 0, 0, 10, 5, 20, 10
INVAR-16, Run: 047, F, 0, 0, 14, 7, 22, 8
INVAR-16, Run: 048, F, 0, 0, 16, 8, 23, 7
INVAR-16, Run: 049, F, 0, 0, 10, 5, 20, 10
INVAR-16, Run: 050, F, 0, 0, 12, 6, 21, 9
INVAR-16, Run: 051, F, 0, 0, 14, 7, 22, 8
INVAR-16, Run: 052, F, 0, 0, 12, 6, 21, 9
INVAR-16, Run: 053, F, 0, 0, 8, 4, 19, 11
INVAR-16, Run: 054, F, 0, 0, 12, 6, 21, 9
INVAR-16, Run: 055, F, 0, 0, 10, 5, 20, 10
INVAR-16, Run: 056, F, 0, 0, 8, 4, 19, 11
INVAR-16, Run: 057, F, 0, 0, 12, 6, 21, 9
INVAR-16, Run: 058, F, 0, 0, 14, 7, 22, 8
INVAR-16, Run: 059, F, 0, 0, 12, 6, 21, 9
INVAR-16, Run: 060, F, 0, 0, 14, 7, 22, 8
INVAR-16, Run: 061, F, 0, 0, 20, 10, 25, 5
INVAR-16, Run: 062, F, 0, 0, 8, 4, 19, 11
INVAR-16, Run: 063, F, 0, 0, 10, 5, 20, 10
INVAR-16, Run: 064, F, 0, 0, 16, 8, 23, 7
INVAR-16, Run: 065, F, 0, 0, 10, 5, 20, 10
INVAR-16, Run: 066, F, 0, 0, 10, 5, 20, 10
INVAR-16, Run: 067, F, 0, 0, 10, 5, 20, 10
INVAR-16, Run: 068, F, 0, 0, 14, 7, 22, 8
INVAR-16, Run: 069, F, 0, 0, 12, 6, 21, 9
INVAR-16, Run: 070, F, 0, 0, 12, 6, 21, 9
INVAR-16, Run: 071, F, 0, 0, 6, 3, 18, 12
INVAR-16, Run: 072, F, 0, 0, 14, 7, 22, 8
INVAR-16, Run: 073, F, 0, 0, 12, 6, 21, 9
INVAR-16, Run: 074, F, 0, 0, 16, 8, 23, 7
INVAR-16, Run: 075, F, 0, 0, 12, 6, 21, 9
INVAR-16, Run: 076, F, 0, 0, 14, 7, 22, 8
INVAR-16, Run: 077, F, 0, 0, 10, 5, 20, 10
INVAR-16, Run: 078, F, 0, 0, 10, 5, 20, 10
INVAR-16, Run: 079, F, 0, 0, 12, 6, 21, 9
INVAR-16, Run: 080, F, 0, 0, 16, 8, 23, 7
INVAR-16, Run: 081, F, 0, 0, 14, 7, 22, 8
INVAR-16, Run: 082, F, 0, 0, 12, 6, 21, 9
INVAR-16, Run: 083, F, 0, 0, 12, 6, 21, 9
INVAR-16, Run: 084, F, 0, 0, 16, 8, 23, 7
INVAR-16, Run: 085, F, 0, 0, 14, 7, 22, 8
INVAR-16, Run: 086, F, 0, 0, 8, 4, 19, 11
INVAR-16, Run: 087, F, 0, 0, 10, 5, 20, 10
INVAR-16, Run: 088, F, 0, 0, 10, 5, 20, 10
INVAR-16, Run: 089, F, 0, 0, 18, 9, 24, 6
INVAR-16, Run: 090, F, 0, 0, 10, 5, 20, 10
INVAR-16, Run: 091, F, 0, 0, 14, 7, 22, 8
INVAR-16, Run: 092, F, 0, 0, 14, 7, 22, 8
INVAR-16, Run: 093, F, 0, 0, 10, 5, 20, 10
INVAR-16, Run: 094, F, 0, 0, 10, 5, 20, 10
INVAR-16, Run: 095, F, 0, 0, 14, 7, 22, 8
INVAR-16, Run: 096, F, 0, 0, 12, 6, 21, 9
INVAR-16, Run: 097, F, 0, 0, 10, 5, 20, 10
INVAR-16, Run: 098, F, 0, 0, 12, 6, 21, 9
INVAR-16, Run: 099, F, 0, 0, 16, 8, 23, 7
INVAR-16, Run: 100, F, 0, 0, 12, 6, 21, 9
INVAR-17, Run: 001, F, 0, 0, 64, 24, 105, 41
INVAR-17, Run: 002, F, 0, 0, 62, 23, 104, 42
INVAR-17, Run: 003, F, 0, 0, 52, 18, 99, 47
INVAR-17, Run: 004, F, 0, 0, 62, 23, 104, 42
INVAR-17, Run: 005, F, 0, 0, 56, 20, 101, 45
INVAR-17, Run: 006, F, 0, 0, 64, 24, 105, 41
INVAR-17, Run: 007, F, 0, 0, 66, 25, 106, 40
INVAR-17, Run: 008, F, 0, 0, 50, 17, 98, 48
INVAR-17, Run: 009, F, 0, 0, 56, 20, 101, 45
INVAR-17, Run: 010, F, 0, 0, 52, 18, 99, 47
INVAR-17, Run: 011, F, 0, 0, 52, 18, 99, 47
INVAR-17, Run: 012, F, 0, 0, 60, 22, 103, 43
INVAR-17, Run: 013, F, 0, 0, 56, 20, 101, 45
INVAR-17, Run: 014, F, 0, 0, 48, 16, 97, 49
INVAR-17, Run: 015, F, 0, 0, 58, 21, 102, 44
INVAR-17, Run: 016, F, 0, 0, 66, 25, 106, 40
INVAR-17, Run: 017, F, 0, 0, 60, 22, 103, 43
INVAR-17, Run: 018, F, 0, 0, 60, 22, 103, 43
INVAR-17, Run: 019, F, 0, 0, 48, 16, 97, 49
INVAR-17, Run: 020, F, 0, 0, 52, 18, 99, 47
INVAR-17, Run: 021, F, 0, 0, 68, 26, 107, 39
INVAR-17, Run: 022, F, 0, 0, 54, 19, 100, 46
INVAR-17, Run: 023, F, 0, 0, 58, 21, 102, 44
INVAR-17, Run: 024, F, 0, 0, 54, 19, 100, 46
INVAR-17, Run: 025, F, 0, 0, 46, 15, 96, 50
INVAR-17, Run: 026, F, 0, 0, 64, 24, 105, 41
INVAR-17, Run: 027, F, 0, 0, 42, 13, 94, 52
INVAR-17, Run: 028, F, 0, 0, 52, 18, 99, 47
INVAR-17, Run: 029, F, 0, 0, 54, 19, 100, 46
INVAR-17, Run: 030, F, 0, 0, 54, 19, 100, 46
INVAR-17, Run: 031, F, 0, 0, 54, 19, 100, 46
INVAR-17, Run: 032, F, 0, 0, 56, 20, 101, 45
INVAR-17, Run: 033, F, 0, 0, 58, 21, 102, 44
INVAR-17, Run: 034, F, 0, 0, 60, 22, 103, 43
INVAR-17, Run: 035, F, 0, 0, 68, 26, 107, 39
INVAR-17, Run: 036, F, 0, 0, 58, 21, 102, 44
INVAR-17, Run: 037, F, 0, 0, 52, 18, 99, 47
INVAR-17, Run: 038, F, 0, 0, 52, 18, 99, 47
INVAR-17, Run: 039, F, 0, 0, 56, 20, 101, 45
INVAR-17, Run: 040, F, 0, 0, 56, 20, 101, 45
INVAR-17, Run: 041, F, 0, 0, 52, 18, 99, 47
INVAR-17, Run: 042, F, 0, 0, 58, 21, 102, 44
INVAR-17, Run: 043, F, 0, 0, 48, 16, 97, 49
INVAR-17, Run: 044, F, 0, 0, 56, 20, 101, 45
INVAR-17, Run: 045, F, 0, 0, 52, 18, 99, 47
INVAR-17, Run: 046, F, 0, 0, 62, 23, 104, 42
INVAR-17, Run: 047, F, 0, 0, 68, 26, 107, 39
INVAR-17, Run: 048, F, 0, 0, 50, 17, 98, 48
INVAR-17, Run: 049, F, 0, 0, 58, 21, 102, 44
INVAR-17, Run: 050, F, 0, 0, 68, 26, 107, 39
INVAR-17, Run: 051, F, 0, 0, 54, 19, 100, 46
INVAR-17, Run: 052, F, 0, 0, 52, 18, 99, 47
INVAR-17, Run: 053, F, 0, 0, 58, 21, 102, 44
INVAR-17, Run: 054, F, 0, 0, 56, 20, 101, 45
INVAR-17, Run: 055, F, 0, 0, 54, 19, 100, 46
INVAR-17, Run: 056, F, 0, 0, 54, 19, 100, 46
INVAR-17, Run: 057, F, 0, 0, 60, 22, 103, 43
INVAR-17, Run: 058, F, 0, 0, 54, 19, 100, 46
INVAR-17, Run: 059, F, 0, 0, 58, 21, 102, 44
INVAR-17, Run: 060, F, 0, 0, 64, 24, 105, 41
INVAR-17, Run: 061, F, 0, 0, 58, 21, 102, 44
INVAR-17, Run: 062, F, 0, 0, 54, 19, 100, 46
INVAR-17, Run: 063, F, 0, 0, 66, 25, 106, 40
INVAR-17, Run: 064, F, 0, 0, 56, 20, 101, 45
INVAR-17, Run: 065, F, 0, 0, 52, 18, 99, 47
INVAR-17, Run: 066, F, 0, 0, 50, 17, 98, 48
INVAR-17, Run: 067, F, 0, 0, 54, 19, 100, 46
INVAR-17, Run: 068, F, 0, 0, 70, 27, 108, 38
INVAR-17, Run: 069, F, 0, 0, 56, 20, 101, 45
INVAR-17, Run: 070, F, 0, 0, 56, 20, 101, 45
INVAR-17, Run: 071, F, 0, 0, 54, 19, 100, 46
INVAR-17, Run: 072, F, 0, 0, 62, 23, 104, 42
INVAR-17, Run: 073, F, 0, 0, 66, 25, 106, 40
INVAR-17, Run: 074, F, 0, 0, 60, 22, 103, 43
INVAR-17, Run: 075, F, 0, 0, 66, 25, 106, 40
INVAR-17, Run: 076, F, 0, 0, 54, 19, 100, 46
INVAR-17, Run: 077, F, 0, 0, 54, 19, 100, 46
INVAR-17, Run: 078, F, 0, 0, 56, 20, 101, 45
INVAR-17, Run: 079, F, 0, 0, 56, 20, 101, 45
INVAR-17, Run: 080, F, 0, 0, 58, 21, 102, 44
INVAR-17, Run: 081, F, 0, 0, 64, 24, 105, 41
INVAR-17, Run: 082, F, 0, 0, 52, 18, 99, 47
INVAR-17, Run: 083, F, 0, 0, 60, 22, 103, 43
INVAR-17, Run: 084, F, 0, 0, 56, 20, 101, 45
INVAR-17, Run: 085, F, 0, 0, 70, 27, 108, 38
INVAR-17, Run: 086, F, 0, 0, 52, 18, 99, 47
INVAR-17, Run: 087, F, 0, 0, 52, 18, 99, 47
INVAR-17, Run: 088, F, 0, 0, 68, 26, 107, 39
INVAR-17, Run: 089, F, 0, 0, 76, 30, 111, 35
INVAR-17, Run: 090, F, 0, 0, 66, 25, 106, 40
INVAR-17, Run: 091, F, 0, 0, 56, 20, 101, 45
INVAR-17, Run: 092, F, 0, 0, 66, 25, 106, 40
INVAR-17, Run: 093, F, 0, 0, 58, 21, 102, 44
INVAR-17, Run: 094, F, 0, 0, 58, 21, 102, 44
INVAR-17, Run: 095, F, 0, 0, 58, 21, 102, 44
INVAR-17, Run: 096, F, 0, 0, 62, 23, 104, 42
INVAR-17, Run: 097, F, 0, 0, 60, 22, 103, 43
INVAR-17, Run: 098, F, 0, 0, 58, 21, 102, 44
INVAR-17, Run: 099, F, 0, 0, 58, 21, 102, 44
INVAR-17, Run: 100, F, 0, 0, 58, 21, 102, 44
INVAR-18, Run: 001, F, 0, 0, 122, 61, 226, 104
INVAR-18, Run: 002, F, 0, 0, 92, 46, 211, 119
INVAR-18, Run: 003, F, 0, 0, 106, 53, 218, 112
INVAR-18, Run: 004, F, 0, 0, 112, 56, 221, 109
INVAR-18, Run: 005, F, 0, 0, 108, 54, 219, 111
INVAR-18, Run: 006, F, 0, 0, 120, 60, 225, 105
INVAR-18, Run: 007, F, 0, 0, 114, 57, 222, 108
INVAR-18, Run: 008, F, 0, 0, 94, 47, 212, 118
INVAR-18, Run: 009, F, 0, 0, 102, 51, 216, 114
INVAR-18, Run: 010, F, 0, 0, 108, 54, 219, 111
INVAR-18, Run: 011, F, 0, 0, 102, 51, 216, 114
INVAR-18, Run: 012, F, 0, 0, 132, 66, 231, 99
INVAR-18, Run: 013, F, 0, 0, 106, 53, 218, 112
INVAR-18, Run: 014, F, 0, 0, 94, 47, 212, 118
INVAR-18, Run: 015, F, 0, 0, 132, 66, 231, 99
INVAR-18, Run: 016, F, 0, 0, 108, 54, 219, 111
INVAR-18, Run: 017, F, 0, 0, 102, 51, 216, 114
INVAR-18, Run: 018, F, 0, 0, 98, 49, 214, 116
INVAR-18, Run: 019, F, 0, 0, 126, 63, 228, 102
INVAR-18, Run: 020, F, 0, 0, 116, 58, 223, 107
INVAR-18, Run: 021, F, 0, 0, 124, 62, 227, 103
INVAR-18, Run: 022, F, 0, 0, 120, 60, 225, 105
INVAR-18, Run: 023, F, 0, 0, 114, 57, 222, 108
INVAR-18, Run: 024, F, 0, 0, 114, 57, 222, 108
INVAR-18, Run: 025, F, 0, 0, 114, 57, 222, 108
INVAR-18, Run: 026, F, 0, 0, 120, 60, 225, 105
INVAR-18, Run: 027, F, 0, 0, 104, 52, 217, 113
INVAR-18, Run: 028, F, 0, 0, 98, 49, 214, 116
INVAR-18, Run: 029, F, 0, 0, 120, 60, 225, 105
INVAR-18, Run: 030, F, 0, 0, 132, 66, 231, 99
INVAR-18, Run: 031, F, 0, 0, 124, 62, 227, 103
INVAR-18, Run: 032, F, 0, 0, 120, 60, 225, 105
INVAR-18, Run: 033, F, 0, 0, 118, 59, 224, 106
INVAR-18, Run: 034, F, 0, 0, 98, 49, 214, 116
INVAR-18, Run: 035, F, 0, 0, 138, 69, 234, 96
INVAR-18, Run: 036, F, 0, 0, 98, 49, 214, 116
INVAR-18, Run: 037, F, 0, 0, 118, 59, 224, 106
INVAR-18, Run: 038, F, 0, 0, 114, 57, 222, 108
INVAR-18, Run: 039, F, 0, 0, 130, 65, 230, 100
INVAR-18, Run: 040, F, 0, 0, 116, 58, 223, 107
INVAR-18, Run: 041, F, 0, 0, 118, 59, 224, 106
INVAR-18, Run: 042, F, 0, 0, 120, 60, 225, 105
INVAR-18, Run: 043, F, 0, 0, 102, 51, 216, 114
INVAR-18, Run: 044, F, 0, 0, 124, 62, 227, 103
INVAR-18, Run: 045, F, 0, 0, 114, 57, 222, 108
INVAR-18, Run: 046, F, 0, 0, 126, 63, 228, 102
INVAR-18, Run: 047, F, 0, 0, 130, 65, 230, 100
INVAR-18, Run: 048, F, 0, 0, 118, 59, 224, 106
INVAR-18, Run: 049, F, 0, 0, 124, 62, 227, 103
INVAR-18, Run: 050, F, 0, 0, 110, 55, 220, 110
INVAR-18, Run: 051, F, 0, 0, 108, 54, 219, 111
INVAR-18, Run: 052, F, 0, 0, 114, 57, 222, 108
INVAR-18, Run: 053, F, 0, 0, 116, 58, 223, 107
INVAR-18, Run: 054, F, 0, 0, 96, 48, 213, 117
INVAR-18, Run: 055, F, 0, 0, 102, 51, 216, 114
INVAR-18, Run: 056, F, 0, 0, 106, 53, 218, 112
INVAR-18, Run: 057, F, 0, 0, 110, 55, 220, 110
INVAR-18, Run: 058, F, 0, 0, 110, 55, 220, 110
INVAR-18, Run: 059, F, 0, 0, 110, 55, 220, 110
INVAR-18, Run: 060, F, 0, 0, 106, 53, 218, 112
INVAR-18, Run: 061, F, 0, 0, 116, 58, 223, 107
INVAR-18, Run: 062, F, 0, 0, 102, 51, 216, 114
INVAR-18, Run: 063, F, 0, 0, 110, 55, 220, 110
INVAR-18, Run: 064, F, 0, 0, 110, 55, 220, 110
INVAR-18, Run: 065, F, 0, 0, 106, 53, 218, 112
INVAR-18, Run: 066, F, 0, 0, 114, 57, 222, 108
INVAR-18, Run: 067, F, 0, 0, 110, 55, 220, 110
INVAR-18, Run: 068, F, 0, 0, 114, 57, 222, 108
INVAR-18, Run: 069, F, 0, 0, 106, 53, 218, 112
INVAR-18, Run: 070, F, 0, 0, 90, 45, 210, 120
INVAR-18, Run: 071, F, 0, 0, 104, 52, 217, 113
INVAR-18, Run: 072, F, 0, 0, 112, 56, 221, 109
INVAR-18, Run: 073, F, 0, 0, 124, 62, 227, 103
INVAR-18, Run: 074, F, 0, 0, 102, 51, 216, 114
INVAR-18, Run: 075, F, 0, 0, 116, 58, 223, 107
INVAR-18, Run: 076, F, 0, 0, 116, 58, 223, 107
INVAR-18, Run: 077, F, 0, 0, 106, 53, 218, 112
INVAR-18, Run: 078, F, 0, 0, 108, 54, 219, 111
INVAR-18, Run: 079, F, 0, 0, 118, 59, 224, 106
INVAR-18, Run: 080, F, 0, 0, 100, 50, 215, 115
INVAR-18, Run: 081, F, 0, 0, 104, 52, 217, 113
INVAR-18, Run: 082, F, 0, 0, 126, 63, 228, 102
INVAR-18, Run: 083, F, 0, 0, 112, 56, 221, 109
INVAR-18, Run: 084, F, 0, 0, 104, 52, 217, 113
INVAR-18, Run: 085, F, 0, 0, 90, 45, 210, 120
INVAR-18, Run: 086, F, 0, 0, 110, 55, 220, 110
INVAR-18, Run: 087, F, 0, 0, 120, 60, 225, 105
INVAR-18, Run: 088, F, 0, 0, 116, 58, 223, 107
INVAR-18, Run: 089, F, 0, 0, 108, 54, 219, 111
INVAR-18, Run: 090, F, 0, 0, 100, 50, 215, 115
INVAR-18, Run: 091, F, 0, 0, 120, 60, 225, 105
INVAR-18, Run: 092, F, 0, 0, 114, 57, 222, 108
INVAR-18, Run: 093, F, 0, 0, 116, 58, 223, 107
INVAR-18, Run: 094, F, 0, 0, 110, 55, 220, 110
INVAR-18, Run: 095, F, 0, 0, 104, 52, 217, 113
INVAR-18, Run: 096, F, 0, 0, 108, 54, 219, 111
INVAR-18, Run: 097, F, 0, 0, 98, 49, 214, 116
INVAR-18, Run: 098, F, 0, 0, 100, 50, 215, 115
INVAR-18, Run: 099, F, 0, 0, 114, 57, 222, 108
INVAR-18, Run: 100, F, 0, 0, 114, 57, 222, 108
INVAR-19, Run: 001, P, 0, 0, 35, 0, 35, 0
INVAR-19, Run: 002, P, 0, 0, 35, 0, 35, 0
INVAR-19, Run: 003, P, 0, 0, 35, 0, 35, 0
INVAR-19, Run: 004, P, 0, 0, 35, 0, 35, 0
INVAR-19, Run: 005, P, 0, 0, 35, 0, 35, 0
INVAR-19, Run: 006, P, 0, 0, 35, 0, 35, 0
INVAR-19, Run: 007, P, 0, 0, 35, 0, 35, 0
INVAR-19, Run: 008, P, 0, 0, 35, 0, 35, 0
INVAR-19, Run: 009, P, 0, 0, 35, 0, 35, 0
INVAR-19, Run: 010, P, 0, 0, 35, 0, 35, 0
INVAR-19, Run: 011, P, 0, 0, 35, 0, 35, 0
INVAR-19, Run: 012, P, 0, 0, 35, 0, 35, 0
INVAR-19, Run: 013, P, 0, 0, 35, 0, 35, 0
INVAR-19, Run: 014, P, 0, 0, 35, 0, 35, 0
INVAR-19, Run: 015, P, 0, 0, 35, 0, 35, 0
INVAR-19, Run: 016, P, 0, 0, 35, 0, 35, 0
INVAR-19, Run: 017, P, 0, 0, 35, 0, 35, 0
INVAR-19, Run: 018, P, 0, 0, 35, 0, 35, 0
INVAR-19, Run: 019, P, 0, 0, 35, 0, 35, 0
INVAR-19, Run: 020, P, 0, 0, 35, 0, 35, 0
INVAR-19, Run: 021, P, 0, 0, 35, 0, 35, 0
INVAR-19, Run: 022, P, 0, 0, 35, 0, 35, 0
INVAR-19, Run: 023, P, 0, 0, 35, 0, 35, 0
INVAR-19, Run: 024, P, 0, 0, 35, 0, 35, 0
INVAR-19, Run: 025, P, 0, 0, 35, 0, 35, 0
INVAR-19, Run: 026, P, 0, 0, 35, 0, 35, 0
INVAR-19, Run: 027, P, 0, 0, 35, 0, 35, 0
INVAR-19, Run: 028, P, 0, 0, 35, 0, 35, 0
INVAR-19, Run: 029, P, 0, 0, 35, 0, 35, 0
INVAR-19, Run: 030, P, 0, 0, 35, 0, 35, 0
INVAR-19, Run: 031, P, 0, 0, 35, 0, 35, 0
INVAR-19, Run: 032, P, 0, 0, 35, 0, 35, 0
INVAR-19, Run: 033, P, 0, 0, 35, 0, 35, 0
INVAR-19, Run: 034, P, 0, 0, 35, 0, 35, 0
INVAR-19, Run: 035, P, 0, 0, 35, 0, 35, 0
INVAR-19, Run: 036, P, 0, 0, 35, 0, 35, 0
INVAR-19, Run: 037, P, 0, 0, 35, 0, 35, 0
INVAR-19, Run: 038, P, 0, 0, 35, 0, 35, 0
INVAR-19, Run: 039, P, 0, 0, 35, 0, 35, 0
INVAR-19, Run: 040, P, 0, 0, 35, 0, 35, 0
INVAR-19, Run: 041, P, 0, 0, 35, 0, 35, 0
INVAR-19, Run: 042, P, 0, 0, 35, 0, 35, 0
INVAR-19, Run: 043, P, 0, 0, 35, 0, 35, 0
INVAR-19, Run: 044, P, 0, 0, 35, 0, 35, 0
INVAR-19, Run: 045, P, 0, 0, 35, 0, 35, 0
INVAR-19, Run: 046, P, 0, 0, 35, 0, 35, 0
INVAR-19, Run: 047, P, 0, 0, 35, 0, 35, 0
INVAR-19, Run: 048, P, 0, 0, 35, 0, 35, 0
INVAR-19, Run: 049, P, 0, 0, 35, 0, 35, 0
INVAR-19, Run: 050, P, 0, 0, 35, 0, 35, 0
INVAR-19, Run: 051, P, 0, 0, 35, 0, 35, 0
INVAR-19, Run: 052, P, 0, 0, 35, 0, 35, 0
INVAR-19, Run: 053, P, 0, 0, 35, 0, 35, 0
INVAR-19, Run: 054, P, 0, 0, 35, 0, 35, 0
INVAR-19, Run: 055, P, 0, 0, 35, 0, 35, 0
INVAR-19, Run: 056, P, 0, 0, 35, 0, 35, 0
INVAR-19, Run: 057, P, 0, 0, 35, 0, 35, 0
INVAR-19, Run: 058, P, 0, 0, 35, 0, 35, 0
INVAR-19, Run: 059, P, 0, 0, 35, 0, 35, 0
INVAR-19, Run: 060, P, 0, 0, 35, 0, 35, 0
INVAR-19, Run: 061, P, 0, 0, 35, 0, 35, 0
INVAR-19, Run: 062, P, 0, 0, 35, 0, 35, 0
INVAR-19, Run: 063, P, 0, 0, 35, 0, 35, 0
INVAR-19, Run: 064, P, 0, 0, 35, 0, 35, 0
INVAR-19, Run: 065, P, 0, 0, 35, 0, 35, 0
INVAR-19, Run: 066, P, 0, 0, 35, 0, 35, 0
INVAR-19, Run: 067, P, 0, 0, 35, 0, 35, 0
INVAR-19, Run: 068, P, 0, 0, 35, 0, 35, 0
INVAR-19, Run: 069, P, 0, 0, 35, 0, 35, 0
INVAR-19, Run: 070, P, 0, 0, 35, 0, 35, 0
INVAR-19, Run: 071, P, 0, 0, 35, 0, 35, 0
INVAR-19, Run: 072, P, 0, 0, 35, 0, 35, 0
INVAR-19, Run: 073, P, 0, 0, 35, 0, 35, 0
INVAR-19, Run: 074, P, 0, 0, 35, 0, 35, 0
INVAR-19, Run: 075, P, 0, 0, 35, 0, 35, 0
INVAR-19, Run: 076, P, 0, 0, 35, 0, 35, 0
INVAR-19, Run: 077, P, 0, 0, 35, 0, 35, 0
INVAR-19, Run: 078, P, 0, 0, 35, 0, 35, 0
INVAR-19, Run: 079, P, 0, 0, 35, 0, 35, 0
INVAR-19, Run: 080, P, 0, 0, 35, 0, 35, 0
INVAR-19, Run: 081, P, 0, 0, 35, 0, 35, 0
INVAR-19, Run: 082, P, 0, 0, 35, 0, 35, 0
INVAR-19, Run: 083, P, 0, 0, 35, 0, 35, 0
INVAR-19, Run: 084, P, 0, 0, 35, 0, 35, 0
INVAR-19, Run: 085, P, 0, 0, 35, 0, 35, 0
INVAR-19, Run: 086, P, 0, 0, 35, 0, 35, 0
INVAR-19, Run: 087, P, 0, 0, 35, 0, 35, 0
INVAR-19, Run: 088, P, 0, 0, 35, 0, 35, 0
INVAR-19, Run: 089, P, 0, 0, 35, 0, 35, 0
INVAR-19, Run: 090, P, 0, 0, 35, 0, 35, 0
INVAR-19, Run: 091, P, 0, 0, 35, 0, 35, 0
INVAR-19, Run: 092, P, 0, 0, 35, 0, 35, 0
INVAR-19, Run: 093, P, 0, 0, 35, 0, 35, 0
INVAR-19, Run: 094, P, 0, 0, 35, 0, 35, 0
INVAR-19, Run: 095, P, 0, 0, 35, 0, 35, 0
INVAR-19, Run: 096, P, 0, 0, 35, 0, 35, 0
INVAR-19, Run: 097, P, 0, 0, 35, 0, 35, 0
INVAR-19, Run: 098, P, 0, 0, 35, 0, 35, 0
INVAR-19, Run: 099, P, 0, 0, 35, 0, 35, 0
INVAR-19, Run: 100, P, 0, 0, 35, 0, 35, 0
INVAR-2, Run: 001, F, 0, 0, 50, 21, 89, 39
INVAR-2, Run: 002, F, 0, 0, 56, 24, 92, 36
INVAR-2, Run: 003, F, 0, 0, 48, 20, 88, 40
INVAR-2, Run: 004, F, 0, 0, 50, 21, 89, 39
INVAR-2, Run: 005, F, 0, 0, 54, 23, 91, 37
INVAR-2, Run: 006, F, 0, 0, 42, 17, 85, 43
INVAR-2, Run: 007, F, 0, 0, 50, 21, 89, 39
INVAR-2, Run: 008, F, 0, 0, 60, 26, 94, 34
INVAR-2, Run: 009, F, 0, 0, 48, 20, 88, 40
INVAR-2, Run: 010, F, 0, 0, 44, 18, 86, 42
INVAR-2, Run: 011, F, 0, 0, 60, 26, 94, 34
INVAR-2, Run: 012, F, 0, 0, 52, 22, 90, 38
INVAR-2, Run: 013, F, 0, 0, 54, 23, 91, 37
INVAR-2, Run: 014, F, 0, 0, 54, 23, 91, 37
INVAR-2, Run: 015, F, 0, 0, 50, 21, 89, 39
INVAR-2, Run: 016, F, 0, 0, 54, 23, 91, 37
INVAR-2, Run: 017, F, 0, 0, 46, 19, 87, 41
INVAR-2, Run: 018, F, 0, 0, 46, 19, 87, 41
INVAR-2, Run: 019, F, 0, 0, 46, 19, 87, 41
INVAR-2, Run: 020, F, 0, 0, 36, 14, 82, 46
INVAR-2, Run: 021, F, 0, 0, 46, 19, 87, 41
INVAR-2, Run: 022, F, 0, 0, 50, 21, 89, 39
INVAR-2, Run: 023, F, 0, 0, 40, 16, 84, 44
INVAR-2, Run: 024, F, 0, 0, 48, 20, 88, 40
INVAR-2, Run: 025, F, 0, 0, 44, 18, 86, 42
INVAR-2, Run: 026, F, 0, 0, 44, 18, 86, 42
INVAR-2, Run: 027, F, 0, 0, 44, 18, 86, 42
INVAR-2, Run: 028, F, 0, 0, 46, 19, 87, 41
INVAR-2, Run: 029, F, 0, 0, 48, 20, 88, 40
INVAR-2, Run: 030, F, 0, 0, 52, 22, 90, 38
INVAR-2, Run: 031, F, 0, 0, 44, 18, 86, 42
INVAR-2, Run: 032, F, 0, 0, 48, 20, 88, 40
INVAR-2, Run: 033, F, 0, 0, 44, 18, 86, 42
INVAR-2, Run: 034, F, 0, 0, 52, 22, 90, 38
INVAR-2, Run: 035, F, 0, 0, 54, 23, 91, 37
INVAR-2, Run: 036, F, 0, 0, 44, 18, 86, 42
INVAR-2, Run: 037, F, 0, 0, 48, 20, 88, 40
INVAR-2, Run: 038, F, 0, 0, 50, 21, 89, 39
INVAR-2, Run: 039, F, 0, 0, 42, 17, 85, 43
INVAR-2, Run: 040, F, 0, 0, 56, 24, 92, 36
INVAR-2, Run: 041, F, 0, 0, 52, 22, 90, 38
INVAR-2, Run: 042, F, 0, 0, 38, 15, 83, 45
INVAR-2, Run: 043, F, 0, 0, 58, 25, 93, 35
INVAR-2, Run: 044, F, 0, 0, 50, 21, 89, 39
INVAR-2, Run: 045, F, 0, 0, 54, 23, 91, 37
INVAR-2, Run: 046, F, 0, 0, 46, 19, 87, 41
INVAR-2, Run: 047, F, 0, 0, 36, 14, 82, 46
INVAR-2, Run: 048, F, 0, 0, 46, 19, 87, 41
INVAR-2, Run: 049, F, 0, 0, 54, 23, 91, 37
INVAR-2, Run: 050, F, 0, 0, 40, 16, 84, 44
INVAR-2, Run: 051, F, 0, 0, 48, 20, 88, 40
INVAR-2, Run: 052, F, 0, 0, 58, 25, 93, 35
INVAR-2, Run: 053, F, 0, 0, 56, 24, 92, 36
INVAR-2, Run: 054, F, 0, 0, 52, 22, 90, 38
INVAR-2, Run: 055, F, 0, 0, 52, 22, 90, 38
INVAR-2, Run: 056, F, 0, 0, 52, 22, 90, 38
INVAR-2, Run: 057, F, 0, 0, 52, 22, 90, 38
INVAR-2, Run: 058, F, 0, 0, 50, 21, 89, 39
INVAR-2, Run: 059, F, 0, 0, 48, 20, 88, 40
INVAR-2, Run: 060, F, 0, 0, 46, 19, 87, 41
INVAR-2, Run: 061, F, 0, 0, 50, 21, 89, 39
INVAR-2, Run: 062, F, 0, 0, 38, 15, 83, 45
INVAR-2, Run: 063, F, 0, 0, 46, 19, 87, 41
INVAR-2, Run: 064, F, 0, 0, 48, 20, 88, 40
INVAR-2, Run: 065, F, 0, 0, 54, 23, 91, 37
INVAR-2, Run: 066, F, 0, 0, 48, 20, 88, 40
INVAR-2, Run: 067, F, 0, 0, 46, 19, 87, 41
INVAR-2, Run: 068, F, 0, 0, 52, 22, 90, 38
INVAR-2, Run: 069, F, 0, 0, 42, 17, 85, 43
INVAR-2, Run: 070, F, 0, 0, 36, 14, 82, 46
INVAR-2, Run: 071, F, 0, 0, 52, 22, 90, 38
INVAR-2, Run: 072, F, 0, 0, 50, 21, 89, 39
INVAR-2, Run: 073, F, 0, 0, 42, 17, 85, 43
INVAR-2, Run: 074, F, 0, 0, 52, 22, 90, 38
INVAR-2, Run: 075, F, 0, 0, 38, 15, 83, 45
INVAR-2, Run: 076, F, 0, 0, 42, 17, 85, 43
INVAR-2, Run: 077, F, 0, 0, 46, 19, 87, 41
INVAR-2, Run: 078, F, 0, 0, 50, 21, 89, 39
INVAR-2, Run: 079, F, 0, 0, 44, 18, 86, 42
INVAR-2, Run: 080, F, 0, 0, 46, 19, 87, 41
INVAR-2, Run: 081, F, 0, 0, 50, 21, 89, 39
INVAR-2, Run: 082, F, 0, 0, 46, 19, 87, 41
INVAR-2, Run: 083, F, 0, 0, 56, 24, 92, 36
INVAR-2, Run: 084, F, 0, 0, 48, 20, 88, 40
INVAR-2, Run: 085, F, 0, 0, 60, 26, 94, 34
INVAR-2, Run: 086, F, 0, 0, 50, 21, 89, 39
INVAR-2, Run: 087, F, 0, 0, 50, 21, 89, 39
INVAR-2, Run: 088, F, 0, 0, 50, 21, 89, 39
INVAR-2, Run: 089, F, 0, 0, 48, 20, 88, 40
INVAR-2, Run: 090, F, 0, 0, 46, 19, 87, 41
INVAR-2, Run: 091, F, 0, 0, 46, 19, 87, 41
INVAR-2, Run: 092, F, 0, 0, 42, 17, 85, 43
INVAR-2, Run: 093, F, 0, 0, 52, 22, 90, 38
INVAR-2, Run: 094, F, 0, 0, 38, 15, 83, 45
INVAR-2, Run: 095, F, 0, 0, 58, 25, 93, 35
INVAR-2, Run: 096, F, 0, 0, 40, 16, 84, 44
INVAR-2, Run: 097, F, 0, 0, 52, 22, 90, 38
INVAR-2, Run: 098, F, 0, 0, 42, 17, 85, 43
INVAR-2, Run: 099, F, 0, 0, 50, 21, 89, 39
INVAR-2, Run: 100, F, 0, 0, 50, 21, 89, 39
INVAR-20, Run: 001, P, 0, 0, 91, 0, 91, 0
INVAR-20, Run: 002, P, 0, 0, 91, 0, 91, 0
INVAR-20, Run: 003, P, 0, 0, 91, 0, 91, 0
INVAR-20, Run: 004, P, 0, 0, 91, 0, 91, 0
INVAR-20, Run: 005, P, 0, 0, 91, 0, 91, 0
INVAR-20, Run: 006, P, 0, 0, 91, 0, 91, 0
INVAR-20, Run: 007, P, 0, 0, 91, 0, 91, 0
INVAR-20, Run: 008, P, 0, 0, 91, 0, 91, 0
INVAR-20, Run: 009, P, 0, 0, 91, 0, 91, 0
INVAR-20, Run: 010, P, 0, 0, 91, 0, 91, 0
INVAR-20, Run: 011, P, 0, 0, 91, 0, 91, 0
INVAR-20, Run: 012, P, 0, 0, 91, 0, 91, 0
INVAR-20, Run: 013, P, 0, 0, 91, 0, 91, 0
INVAR-20, Run: 014, P, 0, 0, 91, 0, 91, 0
INVAR-20, Run: 015, P, 0, 0, 91, 0, 91, 0
INVAR-20, Run: 016, P, 0, 0, 91, 0, 91, 0
INVAR-20, Run: 017, P, 0, 0, 91, 0, 91, 0
INVAR-20, Run: 018, P, 0, 0, 91, 0, 91, 0
INVAR-20, Run: 019, P, 0, 0, 91, 0, 91, 0
INVAR-20, Run: 020, P, 0, 0, 91, 0, 91, 0
INVAR-20, Run: 021, P, 0, 0, 91, 0, 91, 0
INVAR-20, Run: 022, P, 0, 0, 91, 0, 91, 0
INVAR-20, Run: 023, P, 0, 0, 91, 0, 91, 0
INVAR-20, Run: 024, P, 0, 0, 91, 0, 91, 0
INVAR-20, Run: 025, P, 0, 0, 91, 0, 91, 0
INVAR-20, Run: 026, P, 0, 0, 91, 0, 91, 0
INVAR-20, Run: 027, P, 0, 0, 91, 0, 91, 0
INVAR-20, Run: 028, P, 0, 0, 91, 0, 91, 0
INVAR-20, Run: 029, P, 0, 0, 91, 0, 91, 0
INVAR-20, Run: 030, P, 0, 0, 91, 0, 91, 0
INVAR-20, Run: 031, P, 0, 0, 91, 0, 91, 0
INVAR-20, Run: 032, P, 0, 0, 91, 0, 91, 0
INVAR-20, Run: 033, P, 0, 0, 91, 0, 91, 0
INVAR-20, Run: 034, P, 0, 0, 91, 0, 91, 0
INVAR-20, Run: 035, P, 0, 0, 91, 0, 91, 0
INVAR-20, Run: 036, P, 0, 0, 91, 0, 91, 0
INVAR-20, Run: 037, P, 0, 0, 91, 0, 91, 0
INVAR-20, Run: 038, P, 0, 0, 91, 0, 91, 0
INVAR-20, Run: 039, P, 0, 0, 91, 0, 91, 0
INVAR-20, Run: 040, P, 0, 0, 91, 0, 91, 0
INVAR-20, Run: 041, P, 0, 0, 91, 0, 91, 0
INVAR-20, Run: 042, P, 0, 0, 91, 0, 91, 0
INVAR-20, Run: 043, P, 0, 0, 91, 0, 91, 0
INVAR-20, Run: 044, P, 0, 0, 91, 0, 91, 0
INVAR-20, Run: 045, P, 0, 0, 91, 0, 91, 0
INVAR-20, Run: 046, P, 0, 0, 91, 0, 91, 0
INVAR-20, Run: 047, P, 0, 0, 91, 0, 91, 0
INVAR-20, Run: 048, P, 0, 0, 91, 0, 91, 0
INVAR-20, Run: 049, P, 0, 0, 91, 0, 91, 0
INVAR-20, Run: 050, P, 0, 0, 91, 0, 91, 0
INVAR-20, Run: 051, P, 0, 0, 91, 0, 91, 0
INVAR-20, Run: 052, P, 0, 0, 91, 0, 91, 0
INVAR-20, Run: 053, P, 0, 0, 91, 0, 91, 0
INVAR-20, Run: 054, P, 0, 0, 91, 0, 91, 0
INVAR-20, Run: 055, P, 0, 0, 91, 0, 91, 0
INVAR-20, Run: 056, P, 0, 0, 91, 0, 91, 0
INVAR-20, Run: 057, P, 0, 0, 91, 0, 91, 0
INVAR-20, Run: 058, P, 0, 0, 91, 0, 91, 0
INVAR-20, Run: 059, P, 0, 0, 91, 0, 91, 0
INVAR-20, Run: 060, P, 0, 0, 91, 0, 91, 0
INVAR-20, Run: 061, P, 0, 0, 91, 0, 91, 0
INVAR-20, Run: 062, P, 0, 0, 91, 0, 91, 0
INVAR-20, Run: 063, P, 0, 0, 91, 0, 91, 0
INVAR-20, Run: 064, P, 0, 0, 91, 0, 91, 0
INVAR-20, Run: 065, P, 0, 0, 91, 0, 91, 0
INVAR-20, Run: 066, P, 0, 0, 91, 0, 91, 0
INVAR-20, Run: 067, P, 0, 0, 91, 0, 91, 0
INVAR-20, Run: 068, P, 0, 0, 91, 0, 91, 0
INVAR-20, Run: 069, P, 0, 0, 91, 0, 91, 0
INVAR-20, Run: 070, P, 0, 0, 91, 0, 91, 0
INVAR-20, Run: 071, P, 0, 0, 91, 0, 91, 0
INVAR-20, Run: 072, P, 0, 0, 91, 0, 91, 0
INVAR-20, Run: 073, P, 0, 0, 91, 0, 91, 0
INVAR-20, Run: 074, P, 0, 0, 91, 0, 91, 0
INVAR-20, Run: 075, P, 0, 0, 91, 0, 91, 0
INVAR-20, Run: 076, P, 0, 0, 91, 0, 91, 0
INVAR-20, Run: 077, P, 0, 0, 91, 0, 91, 0
INVAR-20, Run: 078, P, 0, 0, 91, 0, 91, 0
INVAR-20, Run: 079, P, 0, 0, 91, 0, 91, 0
INVAR-20, Run: 080, P, 0, 0, 91, 0, 91, 0
INVAR-20, Run: 081, P, 0, 0, 91, 0, 91, 0
INVAR-20, Run: 082, P, 0, 0, 91, 0, 91, 0
INVAR-20, Run: 083, P, 0, 0, 91, 0, 91, 0
INVAR-20, Run: 084, P, 0, 0, 91, 0, 91, 0
INVAR-20, Run: 085, P, 0, 0, 91, 0, 91, 0
INVAR-20, Run: 086, P, 0, 0, 91, 0, 91, 0
INVAR-20, Run: 087, P, 0, 0, 91, 0, 91, 0
INVAR-20, Run: 088, P, 0, 0, 91, 0, 91, 0
INVAR-20, Run: 089, P, 0, 0, 91, 0, 91, 0
INVAR-20, Run: 090, P, 0, 0, 91, 0, 91, 0
INVAR-20, Run: 091, P, 0, 0, 91, 0, 91, 0
INVAR-20, Run: 092, P, 0, 0, 91, 0, 91, 0
INVAR-20, Run: 093, P, 0, 0, 91, 0, 91, 0
INVAR-20, Run: 094, P, 0, 0, 91, 0, 91, 0
INVAR-20, Run: 095, P, 0, 0, 91, 0, 91, 0
INVAR-20, Run: 096, P, 0, 0, 91, 0, 91, 0
INVAR-20, Run: 097, P, 0, 0, 91, 0, 91, 0
INVAR-20, Run: 098, P, 0, 0, 91, 0, 91, 0
INVAR-20, Run: 099, P, 0, 0, 91, 0, 91, 0
INVAR-20, Run: 100, P, 0, 0, 91, 0, 91, 0
INVAR-21, Run: 001, P, 0, 0, 133, 0, 133, 0
INVAR-21, Run: 002, P, 0, 0, 133, 0, 133, 0
INVAR-21, Run: 003, P, 0, 0, 133, 0, 133, 0
INVAR-21, Run: 004, P, 0, 0, 133, 0, 133, 0
INVAR-21, Run: 005, P, 0, 0, 133, 0, 133, 0
INVAR-21, Run: 006, P, 0, 0, 133, 0, 133, 0
INVAR-21, Run: 007, P, 0, 0, 133, 0, 133, 0
INVAR-21, Run: 008, P, 0, 0, 133, 0, 133, 0
INVAR-21, Run: 009, P, 0, 0, 133, 0, 133, 0
INVAR-21, Run: 010, P, 0, 0, 133, 0, 133, 0
INVAR-21, Run: 011, P, 0, 0, 133, 0, 133, 0
INVAR-21, Run: 012, P, 0, 0, 133, 0, 133, 0
INVAR-21, Run: 013, P, 0, 0, 133, 0, 133, 0
INVAR-21, Run: 014, P, 0, 0, 133, 0, 133, 0
INVAR-21, Run: 015, P, 0, 0, 133, 0, 133, 0
INVAR-21, Run: 016, P, 0, 0, 133, 0, 133, 0
INVAR-21, Run: 017, P, 0, 0, 133, 0, 133, 0
INVAR-21, Run: 018, P, 0, 0, 133, 0, 133, 0
INVAR-21, Run: 019, P, 0, 0, 133, 0, 133, 0
INVAR-21, Run: 020, P, 0, 0, 133, 0, 133, 0
INVAR-21, Run: 021, P, 0, 0, 133, 0, 133, 0
INVAR-21, Run: 022, P, 0, 0, 133, 0, 133, 0
INVAR-21, Run: 023, P, 0, 0, 133, 0, 133, 0
INVAR-21, Run: 024, P, 0, 0, 133, 0, 133, 0
INVAR-21, Run: 025, P, 0, 0, 133, 0, 133, 0
INVAR-21, Run: 026, P, 0, 0, 133, 0, 133, 0
INVAR-21, Run: 027, P, 0, 0, 133, 0, 133, 0
INVAR-21, Run: 028, P, 0, 0, 133, 0, 133, 0
INVAR-21, Run: 029, P, 0, 0, 133, 0, 133, 0
INVAR-21, Run: 030, P, 0, 0, 133, 0, 133, 0
INVAR-21, Run: 031, P, 0, 0, 133, 0, 133, 0
INVAR-21, Run: 032, P, 0, 0, 133, 0, 133, 0
INVAR-21, Run: 033, P, 0, 0, 133, 0, 133, 0
INVAR-21, Run: 034, P, 0, 0, 133, 0, 133, 0
INVAR-21, Run: 035, P, 0, 0, 133, 0, 133, 0
INVAR-21, Run: 036, P, 0, 0, 133, 0, 133, 0
INVAR-21, Run: 037, P, 0, 0, 133, 0, 133, 0
INVAR-21, Run: 038, P, 0, 0, 133, 0, 133, 0
INVAR-21, Run: 039, P, 0, 0, 133, 0, 133, 0
INVAR-21, Run: 040, P, 0, 0, 133, 0, 133, 0
INVAR-21, Run: 041, P, 0, 0, 133, 0, 133, 0
INVAR-21, Run: 042, P, 0, 0, 133, 0, 133, 0
INVAR-21, Run: 043, P, 0, 0, 133, 0, 133, 0
INVAR-21, Run: 044, P, 0, 0, 133, 0, 133, 0
INVAR-21, Run: 045, P, 0, 0, 133, 0, 133, 0
INVAR-21, Run: 046, P, 0, 0, 133, 0, 133, 0
INVAR-21, Run: 047, P, 0, 0, 133, 0, 133, 0
INVAR-21, Run: 048, P, 0, 0, 133, 0, 133, 0
INVAR-21, Run: 049, P, 0, 0, 133, 0, 133, 0
INVAR-21, Run: 050, P, 0, 0, 133, 0, 133, 0
INVAR-21, Run: 051, P, 0, 0, 133, 0, 133, 0
INVAR-21, Run: 052, P, 0, 0, 133, 0, 133, 0
INVAR-21, Run: 053, P, 0, 0, 133, 0, 133, 0
INVAR-21, Run: 054, P, 0, 0, 133, 0, 133, 0
INVAR-21, Run: 055, P, 0, 0, 133, 0, 133, 0
INVAR-21, Run: 056, P, 0, 0, 133, 0, 133, 0
INVAR-21, Run: 057, P, 0, 0, 133, 0, 133, 0
INVAR-21, Run: 058, P, 0, 0, 133, 0, 133, 0
INVAR-21, Run: 059, P, 0, 0, 133, 0, 133, 0
INVAR-21, Run: 060, P, 0, 0, 133, 0, 133, 0
INVAR-21, Run: 061, P, 0, 0, 133, 0, 133, 0
INVAR-21, Run: 062, P, 0, 0, 133, 0, 133, 0
INVAR-21, Run: 063, P, 0, 0, 133, 0, 133, 0
INVAR-21, Run: 064, P, 0, 0, 133, 0, 133, 0
INVAR-21, Run: 065, P, 0, 0, 133, 0, 133, 0
INVAR-21, Run: 066, P, 0, 0, 133, 0, 133, 0
INVAR-21, Run: 067, P, 0, 0, 133, 0, 133, 0
INVAR-21, Run: 068, P, 0, 0, 133, 0, 133, 0
INVAR-21, Run: 069, P, 0, 0, 133, 0, 133, 0
INVAR-21, Run: 070, P, 0, 0, 133, 0, 133, 0
INVAR-21, Run: 071, P, 0, 0, 133, 0, 133, 0
INVAR-21, Run: 072, P, 0, 0, 133, 0, 133, 0
INVAR-21, Run: 073, P, 0, 0, 133, 0, 133, 0
INVAR-21, Run: 074, P, 0, 0, 133, 0, 133, 0
INVAR-21, Run: 075, P, 0, 0, 133, 0, 133, 0
INVAR-21, Run: 076, P, 0, 0, 133, 0, 133, 0
INVAR-21, Run: 077, P, 0, 0, 133, 0, 133, 0
INVAR-21, Run: 078, P, 0, 0, 133, 0, 133, 0
INVAR-21, Run: 079, P, 0, 0, 133, 0, 133, 0
INVAR-21, Run: 080, P, 0, 0, 133, 0, 133, 0
INVAR-21, Run: 081, P, 0, 0, 133, 0, 133, 0
INVAR-21, Run: 082, P, 0, 0, 133, 0, 133, 0
INVAR-21, Run: 083, P, 0, 0, 133, 0, 133, 0
INVAR-21, Run: 084, P, 0, 0, 133, 0, 133, 0
INVAR-21, Run: 085, P, 0, 0, 133, 0, 133, 0
INVAR-21, Run: 086, P, 0, 0, 133, 0, 133, 0
INVAR-21, Run: 087, P, 0, 0, 133, 0, 133, 0
INVAR-21, Run: 088, P, 0, 0, 133, 0, 133, 0
INVAR-21, Run: 089, P, 0, 0, 133, 0, 133, 0
INVAR-21, Run: 090, P, 0, 0, 133, 0, 133, 0
INVAR-21, Run: 091, P, 0, 0, 133, 0, 133, 0
INVAR-21, Run: 092, P, 0, 0, 133, 0, 133, 0
INVAR-21, Run: 093, P, 0, 0, 133, 0, 133, 0
INVAR-21, Run: 094, P, 0, 0, 133, 0, 133, 0
INVAR-21, Run: 095, P, 0, 0, 133, 0, 133, 0
INVAR-21, Run: 096, P, 0, 0, 133, 0, 133, 0
INVAR-21, Run: 097, P, 0, 0, 133, 0, 133, 0
INVAR-21, Run: 098, P, 0, 0, 133, 0, 133, 0
INVAR-21, Run: 099, P, 0, 0, 133, 0, 133, 0
INVAR-21, Run: 100, P, 0, 0, 133, 0, 133, 0
INVAR-22, Run: 001, F, 0, 0, 43, 7, 57, 14
INVAR-22, Run: 002, F, 0, 0, 41, 6, 56, 15
INVAR-22, Run: 003, F, 0, 0, 39, 5, 55, 16
INVAR-22, Run: 004, F, 0, 0, 39, 5, 55, 16
INVAR-22, Run: 005, F, 0, 0, 41, 6, 56, 15
INVAR-22, Run: 006, F, 0, 0, 39, 5, 55, 16
INVAR-22, Run: 007, F, 0, 0, 39, 5, 55, 16
INVAR-22, Run: 008, F, 0, 0, 39, 5, 55, 16
INVAR-22, Run: 009, F, 0, 0, 39, 5, 55, 16
INVAR-22, Run: 010, F, 0, 0, 39, 5, 55, 16
INVAR-22, Run: 011, F, 0, 0, 37, 4, 54, 17
INVAR-22, Run: 012, F, 0, 0, 37, 4, 54, 17
INVAR-22, Run: 013, F, 0, 0, 41, 6, 56, 15
INVAR-22, Run: 014, F, 0, 0, 37, 4, 54, 17
INVAR-22, Run: 015, F, 0, 0, 45, 8, 58, 13
INVAR-22, Run: 016, F, 0, 0, 35, 3, 53, 18
INVAR-22, Run: 017, F, 0, 0, 37, 4, 54, 17
INVAR-22, Run: 018, F, 0, 0, 39, 5, 55, 16
INVAR-22, Run: 019, F, 0, 0, 41, 6, 56, 15
INVAR-22, Run: 020, F, 0, 0, 37, 4, 54, 17
INVAR-22, Run: 021, F, 0, 0, 43, 7, 57, 14
INVAR-22, Run: 022, F, 0, 0, 43, 7, 57, 14
INVAR-22, Run: 023, F, 0, 0, 47, 9, 59, 12
INVAR-22, Run: 024, F, 0, 0, 41, 6, 56, 15
INVAR-22, Run: 025, F, 0, 0, 41, 6, 56, 15
INVAR-22, Run: 026, F, 0, 0, 47, 9, 59, 12
INVAR-22, Run: 027, F, 0, 0, 39, 5, 55, 16
INVAR-22, Run: 028, F, 0, 0, 39, 5, 55, 16
INVAR-22, Run: 029, F, 0, 0, 37, 4, 54, 17
INVAR-22, Run: 030, F, 0, 0, 41, 6, 56, 15
INVAR-22, Run: 031, F, 0, 0, 39, 5, 55, 16
INVAR-22, Run: 032, F, 0, 0, 37, 4, 54, 17
INVAR-22, Run: 033, F, 0, 0, 39, 5, 55, 16
INVAR-22, Run: 034, F, 0, 0, 37, 4, 54, 17
INVAR-22, Run: 035, F, 0, 0, 39, 5, 55, 16
INVAR-22, Run: 036, F, 0, 0, 45, 8, 58, 13
INVAR-22, Run: 037, F, 0, 0, 39, 5, 55, 16
INVAR-22, Run: 038, F, 0, 0, 39, 5, 55, 16
INVAR-22, Run: 039, F, 0, 0, 41, 6, 56, 15
INVAR-22, Run: 040, F, 0, 0, 49, 10, 60, 11
INVAR-22, Run: 041, F, 0, 0, 35, 3, 53, 18
INVAR-22, Run: 042, F, 0, 0, 37, 4, 54, 17
INVAR-22, Run: 043, F, 0, 0, 37, 4, 54, 17
INVAR-22, Run: 044, F, 0, 0, 39, 5, 55, 16
INVAR-22, Run: 045, F, 0, 0, 39, 5, 55, 16
INVAR-22, Run: 046, F, 0, 0, 37, 4, 54, 17
INVAR-22, Run: 047, F, 0, 0, 49, 10, 60, 11
INVAR-22, Run: 048, F, 0, 0, 37, 4, 54, 17
INVAR-22, Run: 049, F, 0, 0, 37, 4, 54, 17
INVAR-22, Run: 050, F, 0, 0, 45, 8, 58, 13
INVAR-22, Run: 051, F, 0, 0, 41, 6, 56, 15
INVAR-22, Run: 052, F, 0, 0, 33, 2, 52, 19
INVAR-22, Run: 053, F, 0, 0, 37, 4, 54, 17
INVAR-22, Run: 054, F, 0, 0, 35, 3, 53, 18
INVAR-22, Run: 055, F, 0, 0, 43, 7, 57, 14
INVAR-22, Run: 056, F, 0, 0, 39, 5, 55, 16
INVAR-22, Run: 057, F, 0, 0, 33, 2, 52, 19
INVAR-22, Run: 058, F, 0, 0, 39, 5, 55, 16
INVAR-22, Run: 059, F, 0, 0, 41, 6, 56, 15
INVAR-22, Run: 060, F, 0, 0, 37, 4, 54, 17
INVAR-22, Run: 061, F, 0, 0, 33, 2, 52, 19
INVAR-22, Run: 062, F, 0, 0, 35, 3, 53, 18
INVAR-22, Run: 063, F, 0, 0, 39, 5, 55, 16
INVAR-22, Run: 064, F, 0, 0, 35, 3, 53, 18
INVAR-22, Run: 065, F, 0, 0, 37, 4, 54, 17
INVAR-22, Run: 066, F, 0, 0, 39, 5, 55, 16
INVAR-22, Run: 067, F, 0, 0, 41, 6, 56, 15
INVAR-22, Run: 068, F, 0, 0, 37, 4, 54, 17
INVAR-22, Run: 069, F, 0, 0, 41, 6, 56, 15
INVAR-22, Run: 070, F, 0, 0, 41, 6, 56, 15
INVAR-22, Run: 071, F, 0, 0, 37, 4, 54, 17
INVAR-22, Run: 072, F, 0, 0, 45, 8, 58, 13
INVAR-22, Run: 073, F, 0, 0, 33, 2, 52, 19
INVAR-22, Run: 074, F, 0, 0, 43, 7, 57, 14
INVAR-22, Run: 075, F, 0, 0, 41, 6, 56, 15
INVAR-22, Run: 076, F, 0, 0, 39, 5, 55, 16
INVAR-22, Run: 077, F, 0, 0, 39, 5, 55, 16
INVAR-22, Run: 078, F, 0, 0, 37, 4, 54, 17
INVAR-22, Run: 079, F, 0, 0, 45, 8, 58, 13
INVAR-22, Run: 080, F, 0, 0, 41, 6, 56, 15
INVAR-22, Run: 081, F, 0, 0, 37, 4, 54, 17
INVAR-22, Run: 082, F, 0, 0, 41, 6, 56, 15
INVAR-22, Run: 083, F, 0, 0, 41, 6, 56, 15
INVAR-22, Run: 084, F, 0, 0, 33, 2, 52, 19
INVAR-22, Run: 085, F, 0, 0, 37, 4, 54, 17
INVAR-22, Run: 086, F, 0, 0, 37, 4, 54, 17
INVAR-22, Run: 087, F, 0, 0, 33, 2, 52, 19
INVAR-22, Run: 088, F, 0, 0, 41, 6, 56, 15
INVAR-22, Run: 089, F, 0, 0, 41, 6, 56, 15
INVAR-22, Run: 090, F, 0, 0, 43, 7, 57, 14
INVAR-22, Run: 091, F, 0, 0, 43, 7, 57, 14
INVAR-22, Run: 092, F, 0, 0, 43, 7, 57, 14
INVAR-22, Run: 093, F, 0, 0, 41, 6, 56, 15
INVAR-22, Run: 094, F, 0, 0, 47, 9, 59, 12
INVAR-22, Run: 095, F, 0, 0, 39, 5, 55, 16
INVAR-22, Run: 096, F, 0, 0, 45, 8, 58, 13
INVAR-22, Run: 097, F, 0, 0, 47, 9, 59, 12
INVAR-22, Run: 098, F, 0, 0, 41, 6, 56, 15
INVAR-22, Run: 099, F, 0, 0, 41, 6, 56, 15
INVAR-22, Run: 100, F, 0, 0, 41, 6, 56, 15
INVAR-23, Run: 001, F, 0, 0, 71, 14, 114, 43
INVAR-23, Run: 002, F, 0, 0, 65, 11, 111, 46
INVAR-23, Run: 003, F, 0, 0, 77, 17, 117, 40
INVAR-23, Run: 004, F, 0, 0, 67, 12, 112, 45
INVAR-23, Run: 005, F, 0, 0, 75, 16, 116, 41
INVAR-23, Run: 006, F, 0, 0, 69, 13, 113, 44
INVAR-23, Run: 007, F, 0, 0, 67, 12, 112, 45
INVAR-23, Run: 008, F, 0, 0, 63, 10, 110, 47
INVAR-23, Run: 009, F, 0, 0, 67, 12, 112, 45
INVAR-23, Run: 010, F, 0, 0, 59, 8, 108, 49
INVAR-23, Run: 011, F, 0, 0, 75, 16, 116, 41
INVAR-23, Run: 012, F, 0, 0, 81, 19, 119, 38
INVAR-23, Run: 013, F, 0, 0, 67, 12, 112, 45
INVAR-23, Run: 014, F, 0, 0, 75, 16, 116, 41
INVAR-23, Run: 015, F, 0, 0, 65, 11, 111, 46
INVAR-23, Run: 016, F, 0, 0, 75, 16, 116, 41
INVAR-23, Run: 017, F, 0, 0, 79, 18, 118, 39
INVAR-23, Run: 018, F, 0, 0, 77, 17, 117, 40
INVAR-23, Run: 019, F, 0, 0, 81, 19, 119, 38
INVAR-23, Run: 020, F, 0, 0, 73, 15, 115, 42
INVAR-23, Run: 021, F, 0, 0, 89, 23, 123, 34
INVAR-23, Run: 022, F, 0, 0, 63, 10, 110, 47
INVAR-23, Run: 023, F, 0, 0, 77, 17, 117, 40
INVAR-23, Run: 024, F, 0, 0, 61, 9, 109, 48
INVAR-23, Run: 025, F, 0, 0, 71, 14, 114, 43
INVAR-23, Run: 026, F, 0, 0, 75, 16, 116, 41
INVAR-23, Run: 027, F, 0, 0, 75, 16, 116, 41
INVAR-23, Run: 028, F, 0, 0, 71, 14, 114, 43
INVAR-23, Run: 029, F, 0, 0, 69, 13, 113, 44
INVAR-23, Run: 030, F, 0, 0, 71, 14, 114, 43
INVAR-23, Run: 031, F, 0, 0, 75, 16, 116, 41
INVAR-23, Run: 032, F, 0, 0, 69, 13, 113, 44
INVAR-23, Run: 033, F, 0, 0, 69, 13, 113, 44
INVAR-23, Run: 034, F, 0, 0, 65, 11, 111, 46
INVAR-23, Run: 035, F, 0, 0, 75, 16, 116, 41
INVAR-23, Run: 036, F, 0, 0, 77, 17, 117, 40
INVAR-23, Run: 037, F, 0, 0, 77, 17, 117, 40
INVAR-23, Run: 038, F, 0, 0, 71, 14, 114, 43
INVAR-23, Run: 039, F, 0, 0, 67, 12, 112, 45
INVAR-23, Run: 040, F, 0, 0, 81, 19, 119, 38
INVAR-23, Run: 041, F, 0, 0, 67, 12, 112, 45
INVAR-23, Run: 042, F, 0, 0, 67, 12, 112, 45
INVAR-23, Run: 043, F, 0, 0, 75, 16, 116, 41
INVAR-23, Run: 044, F, 0, 0, 81, 19, 119, 38
INVAR-23, Run: 045, F, 0, 0, 75, 16, 116, 41
INVAR-23, Run: 046, F, 0, 0, 71, 14, 114, 43
INVAR-23, Run: 047, F, 0, 0, 67, 12, 112, 45
INVAR-23, Run: 048, F, 0, 0, 69, 13, 113, 44
INVAR-23, Run: 049, F, 0, 0, 75, 16, 116, 41
INVAR-23, Run: 050, F, 0, 0, 83, 20, 120, 37
INVAR-23, Run: 051, F, 0, 0, 71, 14, 114, 43
INVAR-23, Run: 052, F, 0, 0, 73, 15, 115, 42
INVAR-23, Run: 053, F, 0, 0, 67, 12, 112, 45
INVAR-23, Run: 054, F, 0, 0, 71, 14, 114, 43
INVAR-23, Run: 055, F, 0, 0, 71, 14, 114, 43
INVAR-23, Run: 056, F, 0, 0, 71, 14, 114, 43
INVAR-23, Run: 057, F, 0, 0, 67, 12, 112, 45
INVAR-23, Run: 058, F, 0, 0, 71, 14, 114, 43
INVAR-23, Run: 059, F, 0, 0, 61, 9, 109, 48
INVAR-23, Run: 060, F, 0, 0, 83, 20, 120, 37
INVAR-23, Run: 061, F, 0, 0, 63, 10, 110, 47
INVAR-23, Run: 062, F, 0, 0, 71, 14, 114, 43
INVAR-23, Run: 063, F, 0, 0, 65, 11, 111, 46
INVAR-23, Run: 064, F, 0, 0, 83, 20, 120, 37
INVAR-23, Run: 065, F, 0, 0, 71, 14, 114, 43
INVAR-23, Run: 066, F, 0, 0, 67, 12, 112, 45
INVAR-23, Run: 067, F, 0, 0, 71, 14, 114, 43
INVAR-23, Run: 068, F, 0, 0, 71, 14, 114, 43
INVAR-23, Run: 069, F, 0, 0, 75, 16, 116, 41
INVAR-23, Run: 070, F, 0, 0, 65, 11, 111, 46
INVAR-23, Run: 071, F, 0, 0, 65, 11, 111, 46
INVAR-23, Run: 072, F, 0, 0, 79, 18, 118, 39
INVAR-23, Run: 073, F, 0, 0, 71, 14, 114, 43
INVAR-23, Run: 074, F, 0, 0, 67, 12, 112, 45
INVAR-23, Run: 075, F, 0, 0, 77, 17, 117, 40
INVAR-23, Run: 076, F, 0, 0, 73, 15, 115, 42
INVAR-23, Run: 077, F, 0, 0, 59, 8, 108, 49
INVAR-23, Run: 078, F, 0, 0, 65, 11, 111, 46
INVAR-23, Run: 079, F, 0, 0, 67, 12, 112, 45
INVAR-23, Run: 080, F, 0, 0, 77, 17, 117, 40
INVAR-23, Run: 081, F, 0, 0, 73, 15, 115, 42
INVAR-23, Run: 082, F, 0, 0, 71, 14, 114, 43
INVAR-23, Run: 083, F, 0, 0, 79, 18, 118, 39
INVAR-23, Run: 084, F, 0, 0, 69, 13, 113, 44
INVAR-23, Run: 085, F, 0, 0, 69, 13, 113, 44
INVAR-23, Run: 086, F, 0, 0, 77, 17, 117, 40
INVAR-23, Run: 087, F, 0, 0, 81, 19, 119, 38
INVAR-23, Run: 088, F, 0, 0, 75, 16, 116, 41
INVAR-23, Run: 089, F, 0, 0, 75, 16, 116, 41
INVAR-23, Run: 090, F, 0, 0, 73, 15, 115, 42
INVAR-23, Run: 091, F, 0, 0, 73, 15, 115, 42
INVAR-23, Run: 092, F, 0, 0, 59, 8, 108, 49
INVAR-23, Run: 093, F, 0, 0, 73, 15, 115, 42
INVAR-23, Run: 094, F, 0, 0, 71, 14, 114, 43
INVAR-23, Run: 095, F, 0, 0, 63, 10, 110, 47
INVAR-23, Run: 096, F, 0, 0, 79, 18, 118, 39
INVAR-23, Run: 097, F, 0, 0, 69, 13, 113, 44
INVAR-23, Run: 098, F, 0, 0, 75, 16, 116, 41
INVAR-23, Run: 099, F, 0, 0, 69, 13, 113, 44
INVAR-23, Run: 100, F, 0, 0, 69, 13, 113, 44
INVAR-24, Run: 001, F, 0, 0, 133, 49, 249, 116
INVAR-24, Run: 002, F, 0, 0, 155, 60, 260, 105
INVAR-24, Run: 003, F, 0, 0, 133, 49, 249, 116
INVAR-24, Run: 004, F, 0, 0, 117, 41, 241, 124
INVAR-24, Run: 005, F, 0, 0, 121, 43, 243, 122
INVAR-24, Run: 006, F, 0, 0, 145, 55, 255, 110
INVAR-24, Run: 007, F, 0, 0, 143, 54, 254, 111
INVAR-24, Run: 008, F, 0, 0, 133, 49, 249, 116
INVAR-24, Run: 009, F, 0, 0, 131, 48, 248, 117
INVAR-24, Run: 010, F, 0, 0, 129, 47, 247, 118
INVAR-24, Run: 011, F, 0, 0, 139, 52, 252, 113
INVAR-24, Run: 012, F, 0, 0, 127, 46, 246, 119
INVAR-24, Run: 013, F, 0, 0, 129, 47, 247, 118
INVAR-24, Run: 014, F, 0, 0, 133, 49, 249, 116
INVAR-24, Run: 015, F, 0, 0, 131, 48, 248, 117
INVAR-24, Run: 016, F, 0, 0, 153, 59, 259, 106
INVAR-24, Run: 017, F, 0, 0, 143, 54, 254, 111
INVAR-24, Run: 018, F, 0, 0, 137, 51, 251, 114
INVAR-24, Run: 019, F, 0, 0, 135, 50, 250, 115
INVAR-24, Run: 020, F, 0, 0, 149, 57, 257, 108
INVAR-24, Run: 021, F, 0, 0, 145, 55, 255, 110
INVAR-24, Run: 022, F, 0, 0, 129, 47, 247, 118
INVAR-24, Run: 023, F, 0, 0, 129, 47, 247, 118
INVAR-24, Run: 024, F, 0, 0, 113, 39, 239, 126
INVAR-24, Run: 025, F, 0, 0, 141, 53, 253, 112
INVAR-24, Run: 026, F, 0, 0, 133, 49, 249, 116
INVAR-24, Run: 027, F, 0, 0, 147, 56, 256, 109
INVAR-24, Run: 028, F, 0, 0, 113, 39, 239, 126
INVAR-24, Run: 029, F, 0, 0, 131, 48, 248, 117
INVAR-24, Run: 030, F, 0, 0, 125, 45, 245, 120
INVAR-24, Run: 031, F, 0, 0, 141, 53, 253, 112
INVAR-24, Run: 032, F, 0, 0, 123, 44, 244, 121
INVAR-24, Run: 033, F, 0, 0, 145, 55, 255, 110
INVAR-24, Run: 034, F, 0, 0, 147, 56, 256, 109
INVAR-24, Run: 035, F, 0, 0, 143, 54, 254, 111
INVAR-24, Run: 036, F, 0, 0, 137, 51, 251, 114
INVAR-24, Run: 037, F, 0, 0, 155, 60, 260, 105
INVAR-24, Run: 038, F, 0, 0, 133, 49, 249, 116
INVAR-24, Run: 039, F, 0, 0, 131, 48, 248, 117
INVAR-24, Run: 040, F, 0, 0, 119, 42, 242, 123
INVAR-24, Run: 041, F, 0, 0, 133, 49, 249, 116
INVAR-24, Run: 042, F, 0, 0, 131, 48, 248, 117
INVAR-24, Run: 043, F, 0, 0, 135, 50, 250, 115
INVAR-24, Run: 044, F, 0, 0, 127, 46, 246, 119
INVAR-24, Run: 045, F, 0, 0, 131, 48, 248, 117
INVAR-24, Run: 046, F, 0, 0, 127, 46, 246, 119
INVAR-24, Run: 047, F, 0, 0, 147, 56, 256, 109
INVAR-24, Run: 048, F, 0, 0, 143, 54, 254, 111
INVAR-24, Run: 049, F, 0, 0, 129, 47, 247, 118
INVAR-24, Run: 050, F, 0, 0, 137, 51, 251, 114
INVAR-24, Run: 051, F, 0, 0, 123, 44, 244, 121
INVAR-24, Run: 052, F, 0, 0, 131, 48, 248, 117
INVAR-24, Run: 053, F, 0, 0, 137, 51, 251, 114
INVAR-24, Run: 054, F, 0, 0, 139, 52, 252, 113
INVAR-24, Run: 055, F, 0, 0, 139, 52, 252, 113
INVAR-24, Run: 056, F, 0, 0, 131, 48, 248, 117
INVAR-24, Run: 057, F, 0, 0, 137, 51, 251, 114
INVAR-24, Run: 058, F, 0, 0, 131, 48, 248, 117
INVAR-24, Run: 059, F, 0, 0, 131, 48, 248, 117
INVAR-24, Run: 060, F, 0, 0, 145, 55, 255, 110
INVAR-24, Run: 061, F, 0, 0, 141, 53, 253, 112
INVAR-24, Run: 062, F, 0, 0, 137, 51, 251, 114
INVAR-24, Run: 063, F, 0, 0, 145, 55, 255, 110
INVAR-24, Run: 064, F, 0, 0, 125, 45, 245, 120
INVAR-24, Run: 065, F, 0, 0, 139, 52, 252, 113
INVAR-24, Run: 066, F, 0, 0, 143, 54, 254, 111
INVAR-24, Run: 067, F, 0, 0, 133, 49, 249, 116
INVAR-24, Run: 068, F, 0, 0, 129, 47, 247, 118
INVAR-24, Run: 069, F, 0, 0, 141, 53, 253, 112
INVAR-24, Run: 070, F, 0, 0, 123, 44, 244, 121
INVAR-24, Run: 071, F, 0, 0, 137, 51, 251, 114
INVAR-24, Run: 072, F, 0, 0, 145, 55, 255, 110
INVAR-24, Run: 073, F, 0, 0, 143, 54, 254, 111
INVAR-24, Run: 074, F, 0, 0, 135, 50, 250, 115
INVAR-24, Run: 075, F, 0, 0, 147, 56, 256, 109
INVAR-24, Run: 076, F, 0, 0, 145, 55, 255, 110
INVAR-24, Run: 077, F, 0, 0, 143, 54, 254, 111
INVAR-24, Run: 078, F, 0, 0, 125, 45, 245, 120
INVAR-24, Run: 079, F, 0, 0, 133, 49, 249, 116
INVAR-24, Run: 080, F, 0, 0, 145, 55, 255, 110
INVAR-24, Run: 081, F, 0, 0, 127, 46, 246, 119
INVAR-24, Run: 082, F, 0, 0, 129, 47, 247, 118
INVAR-24, Run: 083, F, 0, 0, 141, 53, 253, 112
INVAR-24, Run: 084, F, 0, 0, 125, 45, 245, 120
INVAR-24, Run: 085, F, 0, 0, 127, 46, 246, 119
INVAR-24, Run: 086, F, 0, 0, 129, 47, 247, 118
INVAR-24, Run: 087, F, 0, 0, 135, 50, 250, 115
INVAR-24, Run: 088, F, 0, 0, 139, 52, 252, 113
INVAR-24, Run: 089, F, 0, 0, 147, 56, 256, 109
INVAR-24, Run: 090, F, 0, 0, 135, 50, 250, 115
INVAR-24, Run: 091, F, 0, 0, 123, 44, 244, 121
INVAR-24, Run: 092, F, 0, 0, 141, 53, 253, 112
INVAR-24, Run: 093, F, 0, 0, 135, 50, 250, 115
INVAR-24, Run: 094, F, 0, 0, 151, 58, 258, 107
INVAR-24, Run: 095, F, 0, 0, 147, 56, 256, 109
INVAR-24, Run: 096, F, 0, 0, 137, 51, 251, 114
INVAR-24, Run: 097, F, 0, 0, 113, 39, 239, 126
INVAR-24, Run: 098, F, 0, 0, 133, 49, 249, 116
INVAR-24, Run: 099, F, 0, 0, 159, 62, 262, 103
INVAR-24, Run: 100, F, 0, 0, 123, 44, 244, 121
INVAR-25, Run: 001, P, 0, 0, 18, 0, 18, 0
INVAR-25, Run: 002, P, 0, 0, 18, 0, 18, 0
INVAR-25, Run: 003, P, 0, 0, 18, 0, 18, 0
INVAR-25, Run: 004, P, 0, 0, 18, 0, 18, 0
INVAR-25, Run: 005, P, 0, 0, 18, 0, 18, 0
INVAR-25, Run: 006, P, 0, 0, 18, 0, 18, 0
INVAR-25, Run: 007, P, 0, 0, 18, 0, 18, 0
INVAR-25, Run: 008, P, 0, 0, 18, 0, 18, 0
INVAR-25, Run: 009, P, 0, 0, 18, 0, 18, 0
INVAR-25, Run: 010, P, 0, 0, 18, 0, 18, 0
INVAR-25, Run: 011, P, 0, 0, 18, 0, 18, 0
INVAR-25, Run: 012, P, 0, 0, 18, 0, 18, 0
INVAR-25, Run: 013, P, 0, 0, 18, 0, 18, 0
INVAR-25, Run: 014, P, 0, 0, 18, 0, 18, 0
INVAR-25, Run: 015, P, 0, 0, 18, 0, 18, 0
INVAR-25, Run: 016, P, 0, 0, 18, 0, 18, 0
INVAR-25, Run: 017, P, 0, 0, 18, 0, 18, 0
INVAR-25, Run: 018, P, 0, 0, 18, 0, 18, 0
INVAR-25, Run: 019, P, 0, 0, 18, 0, 18, 0
INVAR-25, Run: 020, P, 0, 0, 18, 0, 18, 0
INVAR-25, Run: 021, P, 0, 0, 18, 0, 18, 0
INVAR-25, Run: 022, P, 0, 0, 18, 0, 18, 0
INVAR-25, Run: 023, P, 0, 0, 18, 0, 18, 0
INVAR-25, Run: 024, P, 0, 0, 18, 0, 18, 0
INVAR-25, Run: 025, P, 0, 0, 18, 0, 18, 0
INVAR-25, Run: 026, P, 0, 0, 18, 0, 18, 0
INVAR-25, Run: 027, P, 0, 0, 18, 0, 18, 0
INVAR-25, Run: 028, P, 0, 0, 18, 0, 18, 0
INVAR-25, Run: 029, P, 0, 0, 18, 0, 18, 0
INVAR-25, Run: 030, P, 0, 0, 18, 0, 18, 0
INVAR-25, Run: 031, P, 0, 0, 18, 0, 18, 0
INVAR-25, Run: 032, P, 0, 0, 18, 0, 18, 0
INVAR-25, Run: 033, P, 0, 0, 18, 0, 18, 0
INVAR-25, Run: 034, P, 0, 0, 18, 0, 18, 0
INVAR-25, Run: 035, P, 0, 0, 18, 0, 18, 0
INVAR-25, Run: 036, P, 0, 0, 18, 0, 18, 0
INVAR-25, Run: 037, P, 0, 0, 18, 0, 18, 0
INVAR-25, Run: 038, P, 0, 0, 18, 0, 18, 0
INVAR-25, Run: 039, P, 0, 0, 18, 0, 18, 0
INVAR-25, Run: 040, P, 0, 0, 18, 0, 18, 0
INVAR-25, Run: 041, P, 0, 0, 18, 0, 18, 0
INVAR-25, Run: 042, P, 0, 0, 18, 0, 18, 0
INVAR-25, Run: 043, P, 0, 0, 18, 0, 18, 0
INVAR-25, Run: 044, P, 0, 0, 18, 0, 18, 0
INVAR-25, Run: 045, P, 0, 0, 18, 0, 18, 0
INVAR-25, Run: 046, P, 0, 0, 18, 0, 18, 0
INVAR-25, Run: 047, P, 0, 0, 18, 0, 18, 0
INVAR-25, Run: 048, P, 0, 0, 18, 0, 18, 0
INVAR-25, Run: 049, P, 0, 0, 18, 0, 18, 0
INVAR-25, Run: 050, P, 0, 0, 18, 0, 18, 0
INVAR-25, Run: 051, P, 0, 0, 18, 0, 18, 0
INVAR-25, Run: 052, P, 0, 0, 18, 0, 18, 0
INVAR-25, Run: 053, P, 0, 0, 18, 0, 18, 0
INVAR-25, Run: 054, P, 0, 0, 18, 0, 18, 0
INVAR-25, Run: 055, P, 0, 0, 18, 0, 18, 0
INVAR-25, Run: 056, P, 0, 0, 18, 0, 18, 0
INVAR-25, Run: 057, P, 0, 0, 18, 0, 18, 0
INVAR-25, Run: 058, P, 0, 0, 18, 0, 18, 0
INVAR-25, Run: 059, P, 0, 0, 18, 0, 18, 0
INVAR-25, Run: 060, P, 0, 0, 18, 0, 18, 0
INVAR-25, Run: 061, P, 0, 0, 18, 0, 18, 0
INVAR-25, Run: 062, P, 0, 0, 18, 0, 18, 0
INVAR-25, Run: 063, P, 0, 0, 18, 0, 18, 0
INVAR-25, Run: 064, P, 0, 0, 18, 0, 18, 0
INVAR-25, Run: 065, P, 0, 0, 18, 0, 18, 0
INVAR-25, Run: 066, P, 0, 0, 18, 0, 18, 0
INVAR-25, Run: 067, P, 0, 0, 18, 0, 18, 0
INVAR-25, Run: 068, P, 0, 0, 18, 0, 18, 0
INVAR-25, Run: 069, P, 0, 0, 18, 0, 18, 0
INVAR-25, Run: 070, P, 0, 0, 18, 0, 18, 0
INVAR-25, Run: 071, P, 0, 0, 18, 0, 18, 0
INVAR-25, Run: 072, P, 0, 0, 18, 0, 18, 0
INVAR-25, Run: 073, P, 0, 0, 18, 0, 18, 0
INVAR-25, Run: 074, P, 0, 0, 18, 0, 18, 0
INVAR-25, Run: 075, P, 0, 0, 18, 0, 18, 0
INVAR-25, Run: 076, P, 0, 0, 18, 0, 18, 0
INVAR-25, Run: 077, P, 0, 0, 18, 0, 18, 0
INVAR-25, Run: 078, P, 0, 0, 18, 0, 18, 0
INVAR-25, Run: 079, P, 0, 0, 18, 0, 18, 0
INVAR-25, Run: 080, P, 0, 0, 18, 0, 18, 0
INVAR-25, Run: 081, P, 0, 0, 18, 0, 18, 0
INVAR-25, Run: 082, P, 0, 0, 18, 0, 18, 0
INVAR-25, Run: 083, P, 0, 0, 18, 0, 18, 0
INVAR-25, Run: 084, P, 0, 0, 18, 0, 18, 0
INVAR-25, Run: 085, P, 0, 0, 18, 0, 18, 0
INVAR-25, Run: 086, P, 0, 0, 18, 0, 18, 0
INVAR-25, Run: 087, P, 0, 0, 18, 0, 18, 0
INVAR-25, Run: 088, P, 0, 0, 18, 0, 18, 0
INVAR-25, Run: 089, P, 0, 0, 18, 0, 18, 0
INVAR-25, Run: 090, P, 0, 0, 18, 0, 18, 0
INVAR-25, Run: 091, P, 0, 0, 18, 0, 18, 0
INVAR-25, Run: 092, P, 0, 0, 18, 0, 18, 0
INVAR-25, Run: 093, P, 0, 0, 18, 0, 18, 0
INVAR-25, Run: 094, P, 0, 0, 18, 0, 18, 0
INVAR-25, Run: 095, P, 0, 0, 18, 0, 18, 0
INVAR-25, Run: 096, P, 0, 0, 18, 0, 18, 0
INVAR-25, Run: 097, P, 0, 0, 18, 0, 18, 0
INVAR-25, Run: 098, P, 0, 0, 18, 0, 18, 0
INVAR-25, Run: 099, P, 0, 0, 18, 0, 18, 0
INVAR-25, Run: 100, P, 0, 0, 18, 0, 18, 0
INVAR-26, Run: 001, P, 0, 0, 88, 0, 88, 0
INVAR-26, Run: 002, P, 0, 0, 88, 0, 88, 0
INVAR-26, Run: 003, P, 0, 0, 88, 0, 88, 0
INVAR-26, Run: 004, P, 0, 0, 88, 0, 88, 0
INVAR-26, Run: 005, P, 0, 0, 88, 0, 88, 0
INVAR-26, Run: 006, P, 0, 0, 88, 0, 88, 0
INVAR-26, Run: 007, P, 0, 0, 88, 0, 88, 0
INVAR-26, Run: 008, P, 0, 0, 88, 0, 88, 0
INVAR-26, Run: 009, P, 0, 0, 88, 0, 88, 0
INVAR-26, Run: 010, P, 0, 0, 88, 0, 88, 0
INVAR-26, Run: 011, P, 0, 0, 88, 0, 88, 0
INVAR-26, Run: 012, P, 0, 0, 88, 0, 88, 0
INVAR-26, Run: 013, P, 0, 0, 88, 0, 88, 0
INVAR-26, Run: 014, P, 0, 0, 88, 0, 88, 0
INVAR-26, Run: 015, P, 0, 0, 88, 0, 88, 0
INVAR-26, Run: 016, P, 0, 0, 88, 0, 88, 0
INVAR-26, Run: 017, P, 0, 0, 88, 0, 88, 0
INVAR-26, Run: 018, P, 0, 0, 88, 0, 88, 0
INVAR-26, Run: 019, P, 0, 0, 88, 0, 88, 0
INVAR-26, Run: 020, P, 0, 0, 88, 0, 88, 0
INVAR-26, Run: 021, P, 0, 0, 88, 0, 88, 0
INVAR-26, Run: 022, P, 0, 0, 88, 0, 88, 0
INVAR-26, Run: 023, P, 0, 0, 88, 0, 88, 0
INVAR-26, Run: 024, P, 0, 0, 88, 0, 88, 0
INVAR-26, Run: 025, P, 0, 0, 88, 0, 88, 0
INVAR-26, Run: 026, P, 0, 0, 88, 0, 88, 0
INVAR-26, Run: 027, P, 0, 0, 88, 0, 88, 0
INVAR-26, Run: 028, P, 0, 0, 88, 0, 88, 0
INVAR-26, Run: 029, P, 0, 0, 88, 0, 88, 0
INVAR-26, Run: 030, P, 0, 0, 88, 0, 88, 0
INVAR-26, Run: 031, P, 0, 0, 88, 0, 88, 0
INVAR-26, Run: 032, P, 0, 0, 88, 0, 88, 0
INVAR-26, Run: 033, P, 0, 0, 88, 0, 88, 0
INVAR-26, Run: 034, P, 0, 0, 88, 0, 88, 0
INVAR-26, Run: 035, P, 0, 0, 88, 0, 88, 0
INVAR-26, Run: 036, P, 0, 0, 88, 0, 88, 0
INVAR-26, Run: 037, P, 0, 0, 88, 0, 88, 0
INVAR-26, Run: 038, P, 0, 0, 88, 0, 88, 0
INVAR-26, Run: 039, P, 0, 0, 88, 0, 88, 0
INVAR-26, Run: 040, P, 0, 0, 88, 0, 88, 0
INVAR-26, Run: 041, P, 0, 0, 88, 0, 88, 0
INVAR-26, Run: 042, P, 0, 0, 88, 0, 88, 0
INVAR-26, Run: 043, P, 0, 0, 88, 0, 88, 0
INVAR-26, Run: 044, P, 0, 0, 88, 0, 88, 0
INVAR-26, Run: 045, P, 0, 0, 88, 0, 88, 0
INVAR-26, Run: 046, P, 0, 0, 88, 0, 88, 0
INVAR-26, Run: 047, P, 0, 0, 88, 0, 88, 0
INVAR-26, Run: 048, P, 0, 0, 88, 0, 88, 0
INVAR-26, Run: 049, P, 0, 0, 88, 0, 88, 0
INVAR-26, Run: 050, P, 0, 0, 88, 0, 88, 0
INVAR-26, Run: 051, P, 0, 0, 88, 0, 88, 0
INVAR-26, Run: 052, P, 0, 0, 88, 0, 88, 0
INVAR-26, Run: 053, P, 0, 0, 88, 0, 88, 0
INVAR-26, Run: 054, P, 0, 0, 88, 0, 88, 0
INVAR-26, Run: 055, P, 0, 0, 88, 0, 88, 0
INVAR-26, Run: 056, P, 0, 0, 88, 0, 88, 0
INVAR-26, Run: 057, P, 0, 0, 88, 0, 88, 0
INVAR-26, Run: 058, P, 0, 0, 88, 0, 88, 0
INVAR-26, Run: 059, P, 0, 0, 88, 0, 88, 0
INVAR-26, Run: 060, P, 0, 0, 88, 0, 88, 0
INVAR-26, Run: 061, P, 0, 0, 88, 0, 88, 0
INVAR-26, Run: 062, P, 0, 0, 88, 0, 88, 0
INVAR-26, Run: 063, P, 0, 0, 88, 0, 88, 0
INVAR-26, Run: 064, P, 0, 0, 88, 0, 88, 0
INVAR-26, Run: 065, P, 0, 0, 88, 0, 88, 0
INVAR-26, Run: 066, P, 0, 0, 88, 0, 88, 0
INVAR-26, Run: 067, P, 0, 0, 88, 0, 88, 0
INVAR-26, Run: 068, P, 0, 0, 88, 0, 88, 0
INVAR-26, Run: 069, P, 0, 0, 88, 0, 88, 0
INVAR-26, Run: 070, P, 0, 0, 88, 0, 88, 0
INVAR-26, Run: 071, P, 0, 0, 88, 0, 88, 0
INVAR-26, Run: 072, P, 0, 0, 88, 0, 88, 0
INVAR-26, Run: 073, P, 0, 0, 88, 0, 88, 0
INVAR-26, Run: 074, P, 0, 0, 88, 0, 88, 0
INVAR-26, Run: 075, P, 0, 0, 88, 0, 88, 0
INVAR-26, Run: 076, P, 0, 0, 88, 0, 88, 0
INVAR-26, Run: 077, P, 0, 0, 88, 0, 88, 0
INVAR-26, Run: 078, P, 0, 0, 88, 0, 88, 0
INVAR-26, Run: 079, P, 0, 0, 88, 0, 88, 0
INVAR-26, Run: 080, P, 0, 0, 88, 0, 88, 0
INVAR-26, Run: 081, P, 0, 0, 88, 0, 88, 0
INVAR-26, Run: 082, P, 0, 0, 88, 0, 88, 0
INVAR-26, Run: 083, P, 0, 0, 88, 0, 88, 0
INVAR-26, Run: 084, P, 0, 0, 88, 0, 88, 0
INVAR-26, Run: 085, P, 0, 0, 88, 0, 88, 0
INVAR-26, Run: 086, P, 0, 0, 88, 0, 88, 0
INVAR-26, Run: 087, P, 0, 0, 88, 0, 88, 0
INVAR-26, Run: 088, P, 0, 0, 88, 0, 88, 0
INVAR-26, Run: 089, P, 0, 0, 88, 0, 88, 0
INVAR-26, Run: 090, P, 0, 0, 88, 0, 88, 0
INVAR-26, Run: 091, P, 0, 0, 88, 0, 88, 0
INVAR-26, Run: 092, P, 0, 0, 88, 0, 88, 0
INVAR-26, Run: 093, P, 0, 0, 88, 0, 88, 0
INVAR-26, Run: 094, P, 0, 0, 88, 0, 88, 0
INVAR-26, Run: 095, P, 0, 0, 88, 0, 88, 0
INVAR-26, Run: 096, P, 0, 0, 88, 0, 88, 0
INVAR-26, Run: 097, P, 0, 0, 88, 0, 88, 0
INVAR-26, Run: 098, P, 0, 0, 88, 0, 88, 0
INVAR-26, Run: 099, P, 0, 0, 88, 0, 88, 0
INVAR-26, Run: 100, P, 0, 0, 88, 0, 88, 0
INVAR-27, Run: 001, P, 0, 0, 164, 0, 164, 0
INVAR-27, Run: 002, P, 0, 0, 164, 0, 164, 0
INVAR-27, Run: 003, P, 0, 0, 164, 0, 164, 0
INVAR-27, Run: 004, P, 0, 0, 164, 0, 164, 0
INVAR-27, Run: 005, P, 0, 0, 164, 0, 164, 0
INVAR-27, Run: 006, P, 0, 0, 164, 0, 164, 0
INVAR-27, Run: 007, P, 0, 0, 164, 0, 164, 0
INVAR-27, Run: 008, P, 0, 0, 164, 0, 164, 0
INVAR-27, Run: 009, P, 0, 0, 164, 0, 164, 0
INVAR-27, Run: 010, P, 0, 0, 164, 0, 164, 0
INVAR-27, Run: 011, P, 0, 0, 164, 0, 164, 0
INVAR-27, Run: 012, P, 0, 0, 164, 0, 164, 0
INVAR-27, Run: 013, P, 0, 0, 164, 0, 164, 0
INVAR-27, Run: 014, P, 0, 0, 164, 0, 164, 0
INVAR-27, Run: 015, P, 0, 0, 164, 0, 164, 0
INVAR-27, Run: 016, P, 0, 0, 164, 0, 164, 0
INVAR-27, Run: 017, P, 0, 0, 164, 0, 164, 0
INVAR-27, Run: 018, P, 0, 0, 164, 0, 164, 0
INVAR-27, Run: 019, P, 0, 0, 164, 0, 164, 0
INVAR-27, Run: 020, P, 0, 0, 164, 0, 164, 0
INVAR-27, Run: 021, P, 0, 0, 164, 0, 164, 0
INVAR-27, Run: 022, P, 0, 0, 164, 0, 164, 0
INVAR-27, Run: 023, P, 0, 0, 164, 0, 164, 0
INVAR-27, Run: 024, P, 0, 0, 164, 0, 164, 0
INVAR-27, Run: 025, P, 0, 0, 164, 0, 164, 0
INVAR-27, Run: 026, P, 0, 0, 164, 0, 164, 0
INVAR-27, Run: 027, P, 0, 0, 164, 0, 164, 0
INVAR-27, Run: 028, P, 0, 0, 164, 0, 164, 0
INVAR-27, Run: 029, P, 0, 0, 164, 0, 164, 0
INVAR-27, Run: 030, P, 0, 0, 164, 0, 164, 0
INVAR-27, Run: 031, P, 0, 0, 164, 0, 164, 0
INVAR-27, Run: 032, P, 0, 0, 164, 0, 164, 0
INVAR-27, Run: 033, P, 0, 0, 164, 0, 164, 0
INVAR-27, Run: 034, P, 0, 0, 164, 0, 164, 0
INVAR-27, Run: 035, P, 0, 0, 164, 0, 164, 0
INVAR-27, Run: 036, P, 0, 0, 164, 0, 164, 0
INVAR-27, Run: 037, P, 0, 0, 164, 0, 164, 0
INVAR-27, Run: 038, P, 0, 0, 164, 0, 164, 0
INVAR-27, Run: 039, P, 0, 0, 164, 0, 164, 0
INVAR-27, Run: 040, P, 0, 0, 164, 0, 164, 0
INVAR-27, Run: 041, P, 0, 0, 164, 0, 164, 0
INVAR-27, Run: 042, P, 0, 0, 164, 0, 164, 0
INVAR-27, Run: 043, P, 0, 0, 164, 0, 164, 0
INVAR-27, Run: 044, P, 0, 0, 164, 0, 164, 0
INVAR-27, Run: 045, P, 0, 0, 164, 0, 164, 0
INVAR-27, Run: 046, P, 0, 0, 164, 0, 164, 0
INVAR-27, Run: 047, P, 0, 0, 164, 0, 164, 0
INVAR-27, Run: 048, P, 0, 0, 164, 0, 164, 0
INVAR-27, Run: 049, P, 0, 0, 164, 0, 164, 0
INVAR-27, Run: 050, P, 0, 0, 164, 0, 164, 0
INVAR-27, Run: 051, P, 0, 0, 164, 0, 164, 0
INVAR-27, Run: 052, P, 0, 0, 164, 0, 164, 0
INVAR-27, Run: 053, P, 0, 0, 164, 0, 164, 0
INVAR-27, Run: 054, P, 0, 0, 164, 0, 164, 0
INVAR-27, Run: 055, P, 0, 0, 164, 0, 164, 0
INVAR-27, Run: 056, P, 0, 0, 164, 0, 164, 0
INVAR-27, Run: 057, P, 0, 0, 164, 0, 164, 0
INVAR-27, Run: 058, P, 0, 0, 164, 0, 164, 0
INVAR-27, Run: 059, P, 0, 0, 164, 0, 164, 0
INVAR-27, Run: 060, P, 0, 0, 164, 0, 164, 0
INVAR-27, Run: 061, P, 0, 0, 164, 0, 164, 0
INVAR-27, Run: 062, P, 0, 0, 164, 0, 164, 0
INVAR-27, Run: 063, P, 0, 0, 164, 0, 164, 0
INVAR-27, Run: 064, P, 0, 0, 164, 0, 164, 0
INVAR-27, Run: 065, P, 0, 0, 164, 0, 164, 0
INVAR-27, Run: 066, P, 0, 0, 164, 0, 164, 0
INVAR-27, Run: 067, P, 0, 0, 164, 0, 164, 0
INVAR-27, Run: 068, P, 0, 0, 164, 0, 164, 0
INVAR-27, Run: 069, P, 0, 0, 164, 0, 164, 0
INVAR-27, Run: 070, P, 0, 0, 164, 0, 164, 0
INVAR-27, Run: 071, P, 0, 0, 164, 0, 164, 0
INVAR-27, Run: 072, P, 0, 0, 164, 0, 164, 0
INVAR-27, Run: 073, P, 0, 0, 164, 0, 164, 0
INVAR-27, Run: 074, P, 0, 0, 164, 0, 164, 0
INVAR-27, Run: 075, P, 0, 0, 164, 0, 164, 0
INVAR-27, Run: 076, P, 0, 0, 164, 0, 164, 0
INVAR-27, Run: 077, P, 0, 0, 164, 0, 164, 0
INVAR-27, Run: 078, P, 0, 0, 164, 0, 164, 0
INVAR-27, Run: 079, P, 0, 0, 164, 0, 164, 0
INVAR-27, Run: 080, P, 0, 0, 164, 0, 164, 0
INVAR-27, Run: 081, P, 0, 0, 164, 0, 164, 0
INVAR-27, Run: 082, P, 0, 0, 164, 0, 164, 0
INVAR-27, Run: 083, P, 0, 0, 164, 0, 164, 0
INVAR-27, Run: 084, P, 0, 0, 164, 0, 164, 0
INVAR-27, Run: 085, P, 0, 0, 164, 0, 164, 0
INVAR-27, Run: 086, P, 0, 0, 164, 0, 164, 0
INVAR-27, Run: 087, P, 0, 0, 164, 0, 164, 0
INVAR-27, Run: 088, P, 0, 0, 164, 0, 164, 0
INVAR-27, Run: 089, P, 0, 0, 164, 0, 164, 0
INVAR-27, Run: 090, P, 0, 0, 164, 0, 164, 0
INVAR-27, Run: 091, P, 0, 0, 164, 0, 164, 0
INVAR-27, Run: 092, P, 0, 0, 164, 0, 164, 0
INVAR-27, Run: 093, P, 0, 0, 164, 0, 164, 0
INVAR-27, Run: 094, P, 0, 0, 164, 0, 164, 0
INVAR-27, Run: 095, P, 0, 0, 164, 0, 164, 0
INVAR-27, Run: 096, P, 0, 0, 164, 0, 164, 0
INVAR-27, Run: 097, P, 0, 0, 164, 0, 164, 0
INVAR-27, Run: 098, P, 0, 0, 164, 0, 164, 0
INVAR-27, Run: 099, P, 0, 0, 164, 0, 164, 0
INVAR-27, Run: 100, P, 0, 0, 164, 0, 164, 0
INVAR-28, Run: 001, P, 0, 0, 9, 0, 9, 0
INVAR-28, Run: 002, P, 0, 0, 9, 0, 9, 0
INVAR-28, Run: 003, P, 0, 0, 9, 0, 9, 0
INVAR-28, Run: 004, P, 0, 0, 9, 0, 9, 0
INVAR-28, Run: 005, P, 0, 0, 9, 0, 9, 0
INVAR-28, Run: 006, P, 0, 0, 9, 0, 9, 0
INVAR-28, Run: 007, P, 0, 0, 9, 0, 9, 0
INVAR-28, Run: 008, P, 0, 0, 9, 0, 9, 0
INVAR-28, Run: 009, P, 0, 0, 9, 0, 9, 0
INVAR-28, Run: 010, P, 0, 0, 9, 0, 9, 0
INVAR-28, Run: 011, P, 0, 0, 9, 0, 9, 0
INVAR-28, Run: 012, P, 0, 0, 9, 0, 9, 0
INVAR-28, Run: 013, P, 0, 0, 9, 0, 9, 0
INVAR-28, Run: 014, P, 0, 0, 9, 0, 9, 0
INVAR-28, Run: 015, P, 0, 0, 9, 0, 9, 0
INVAR-28, Run: 016, P, 0, 0, 9, 0, 9, 0
INVAR-28, Run: 017, P, 0, 0, 9, 0, 9, 0
INVAR-28, Run: 018, P, 0, 0, 9, 0, 9, 0
INVAR-28, Run: 019, P, 0, 0, 9, 0, 9, 0
INVAR-28, Run: 020, P, 0, 0, 9, 0, 9, 0
INVAR-28, Run: 021, P, 0, 0, 9, 0, 9, 0
INVAR-28, Run: 022, P, 0, 0, 9, 0, 9, 0
INVAR-28, Run: 023, P, 0, 0, 9, 0, 9, 0
INVAR-28, Run: 024, P, 0, 0, 9, 0, 9, 0
INVAR-28, Run: 025, P, 0, 0, 9, 0, 9, 0
INVAR-28, Run: 026, P, 0, 0, 9, 0, 9, 0
INVAR-28, Run: 027, P, 0, 0, 9, 0, 9, 0
INVAR-28, Run: 028, P, 0, 0, 9, 0, 9, 0
INVAR-28, Run: 029, P, 0, 0, 9, 0, 9, 0
INVAR-28, Run: 030, P, 0, 0, 9, 0, 9, 0
INVAR-28, Run: 031, P, 0, 0, 9, 0, 9, 0
INVAR-28, Run: 032, P, 0, 0, 9, 0, 9, 0
INVAR-28, Run: 033, P, 0, 0, 9, 0, 9, 0
INVAR-28, Run: 034, P, 0, 0, 9, 0, 9, 0
INVAR-28, Run: 035, P, 0, 0, 9, 0, 9, 0
INVAR-28, Run: 036, P, 0, 0, 9, 0, 9, 0
INVAR-28, Run: 037, P, 0, 0, 9, 0, 9, 0
INVAR-28, Run: 038, P, 0, 0, 9, 0, 9, 0
INVAR-28, Run: 039, P, 0, 0, 9, 0, 9, 0
INVAR-28, Run: 040, P, 0, 0, 9, 0, 9, 0
INVAR-28, Run: 041, P, 0, 0, 9, 0, 9, 0
INVAR-28, Run: 042, P, 0, 0, 9, 0, 9, 0
INVAR-28, Run: 043, P, 0, 0, 9, 0, 9, 0
INVAR-28, Run: 044, P, 0, 0, 9, 0, 9, 0
INVAR-28, Run: 045, P, 0, 0, 9, 0, 9, 0
INVAR-28, Run: 046, P, 0, 0, 9, 0, 9, 0
INVAR-28, Run: 047, P, 0, 0, 9, 0, 9, 0
INVAR-28, Run: 048, P, 0, 0, 9, 0, 9, 0
INVAR-28, Run: 049, P, 0, 0, 9, 0, 9, 0
INVAR-28, Run: 050, P, 0, 0, 9, 0, 9, 0
INVAR-28, Run: 051, P, 0, 0, 9, 0, 9, 0
INVAR-28, Run: 052, P, 0, 0, 9, 0, 9, 0
INVAR-28, Run: 053, P, 0, 0, 9, 0, 9, 0
INVAR-28, Run: 054, P, 0, 0, 9, 0, 9, 0
INVAR-28, Run: 055, P, 0, 0, 9, 0, 9, 0
INVAR-28, Run: 056, P, 0, 0, 9, 0, 9, 0
INVAR-28, Run: 057, P, 0, 0, 9, 0, 9, 0
INVAR-28, Run: 058, P, 0, 0, 9, 0, 9, 0
INVAR-28, Run: 059, P, 0, 0, 9, 0, 9, 0
INVAR-28, Run: 060, P, 0, 0, 9, 0, 9, 0
INVAR-28, Run: 061, P, 0, 0, 9, 0, 9, 0
INVAR-28, Run: 062, P, 0, 0, 9, 0, 9, 0
INVAR-28, Run: 063, P, 0, 0, 9, 0, 9, 0
INVAR-28, Run: 064, P, 0, 0, 9, 0, 9, 0
INVAR-28, Run: 065, P, 0, 0, 9, 0, 9, 0
INVAR-28, Run: 066, P, 0, 0, 9, 0, 9, 0
INVAR-28, Run: 067, P, 0, 0, 9, 0, 9, 0
INVAR-28, Run: 068, P, 0, 0, 9, 0, 9, 0
INVAR-28, Run: 069, P, 0, 0, 9, 0, 9, 0
INVAR-28, Run: 070, P, 0, 0, 9, 0, 9, 0
INVAR-28, Run: 071, P, 0, 0, 9, 0, 9, 0
INVAR-28, Run: 072, P, 0, 0, 9, 0, 9, 0
INVAR-28, Run: 073, P, 0, 0, 9, 0, 9, 0
INVAR-28, Run: 074, P, 0, 0, 9, 0, 9, 0
INVAR-28, Run: 075, P, 0, 0, 9, 0, 9, 0
INVAR-28, Run: 076, P, 0, 0, 9, 0, 9, 0
INVAR-28, Run: 077, P, 0, 0, 9, 0, 9, 0
INVAR-28, Run: 078, P, 0, 0, 9, 0, 9, 0
INVAR-28, Run: 079, P, 0, 0, 9, 0, 9, 0
INVAR-28, Run: 080, P, 0, 0, 9, 0, 9, 0
INVAR-28, Run: 081, P, 0, 0, 9, 0, 9, 0
INVAR-28, Run: 082, P, 0, 0, 9, 0, 9, 0
INVAR-28, Run: 083, P, 0, 0, 9, 0, 9, 0
INVAR-28, Run: 084, P, 0, 0, 9, 0, 9, 0
INVAR-28, Run: 085, P, 0, 0, 9, 0, 9, 0
INVAR-28, Run: 086, P, 0, 0, 9, 0, 9, 0
INVAR-28, Run: 087, P, 0, 0, 9, 0, 9, 0
INVAR-28, Run: 088, P, 0, 0, 9, 0, 9, 0
INVAR-28, Run: 089, P, 0, 0, 9, 0, 9, 0
INVAR-28, Run: 090, P, 0, 0, 9, 0, 9, 0
INVAR-28, Run: 091, P, 0, 0, 9, 0, 9, 0
INVAR-28, Run: 092, P, 0, 0, 9, 0, 9, 0
INVAR-28, Run: 093, P, 0, 0, 9, 0, 9, 0
INVAR-28, Run: 094, P, 0, 0, 9, 0, 9, 0
INVAR-28, Run: 095, P, 0, 0, 9, 0, 9, 0
INVAR-28, Run: 096, P, 0, 0, 9, 0, 9, 0
INVAR-28, Run: 097, P, 0, 0, 9, 0, 9, 0
INVAR-28, Run: 098, P, 0, 0, 9, 0, 9, 0
INVAR-28, Run: 099, P, 0, 0, 9, 0, 9, 0
INVAR-28, Run: 100, P, 0, 0, 9, 0, 9, 0
INVAR-29, Run: 001, P, 0, 0, 73, 0, 73, 0
INVAR-29, Run: 002, P, 0, 0, 73, 0, 73, 0
INVAR-29, Run: 003, P, 0, 0, 73, 0, 73, 0
INVAR-29, Run: 004, P, 0, 0, 73, 0, 73, 0
INVAR-29, Run: 005, P, 0, 0, 73, 0, 73, 0
INVAR-29, Run: 006, P, 0, 0, 73, 0, 73, 0
INVAR-29, Run: 007, P, 0, 0, 73, 0, 73, 0
INVAR-29, Run: 008, P, 0, 0, 73, 0, 73, 0
INVAR-29, Run: 009, P, 0, 0, 73, 0, 73, 0
INVAR-29, Run: 010, P, 0, 0, 73, 0, 73, 0
INVAR-29, Run: 011, P, 0, 0, 73, 0, 73, 0
INVAR-29, Run: 012, P, 0, 0, 73, 0, 73, 0
INVAR-29, Run: 013, P, 0, 0, 73, 0, 73, 0
INVAR-29, Run: 014, P, 0, 0, 73, 0, 73, 0
INVAR-29, Run: 015, P, 0, 0, 73, 0, 73, 0
INVAR-29, Run: 016, P, 0, 0, 73, 0, 73, 0
INVAR-29, Run: 017, P, 0, 0, 73, 0, 73, 0
INVAR-29, Run: 018, P, 0, 0, 73, 0, 73, 0
INVAR-29, Run: 019, P, 0, 0, 73, 0, 73, 0
INVAR-29, Run: 020, P, 0, 0, 73, 0, 73, 0
INVAR-29, Run: 021, P, 0, 0, 73, 0, 73, 0
INVAR-29, Run: 022, P, 0, 0, 73, 0, 73, 0
INVAR-29, Run: 023, P, 0, 0, 73, 0, 73, 0
INVAR-29, Run: 024, P, 0, 0, 73, 0, 73, 0
INVAR-29, Run: 025, P, 0, 0, 73, 0, 73, 0
INVAR-29, Run: 026, P, 0, 0, 73, 0, 73, 0
INVAR-29, Run: 027, P, 0, 0, 73, 0, 73, 0
INVAR-29, Run: 028, P, 0, 0, 73, 0, 73, 0
INVAR-29, Run: 029, P, 0, 0, 73, 0, 73, 0
INVAR-29, Run: 030, P, 0, 0, 73, 0, 73, 0
INVAR-29, Run: 031, P, 0, 0, 73, 0, 73, 0
INVAR-29, Run: 032, P, 0, 0, 73, 0, 73, 0
INVAR-29, Run: 033, P, 0, 0, 73, 0, 73, 0
INVAR-29, Run: 034, P, 0, 0, 73, 0, 73, 0
INVAR-29, Run: 035, P, 0, 0, 73, 0, 73, 0
INVAR-29, Run: 036, P, 0, 0, 73, 0, 73, 0
INVAR-29, Run: 037, P, 0, 0, 73, 0, 73, 0
INVAR-29, Run: 038, P, 0, 0, 73, 0, 73, 0
INVAR-29, Run: 039, P, 0, 0, 73, 0, 73, 0
INVAR-29, Run: 040, P, 0, 0, 73, 0, 73, 0
INVAR-29, Run: 041, P, 0, 0, 73, 0, 73, 0
INVAR-29, Run: 042, P, 0, 0, 73, 0, 73, 0
INVAR-29, Run: 043, P, 0, 0, 73, 0, 73, 0
INVAR-29, Run: 044, P, 0, 0, 73, 0, 73, 0
INVAR-29, Run: 045, P, 0, 0, 73, 0, 73, 0
INVAR-29, Run: 046, P, 0, 0, 73, 0, 73, 0
INVAR-29, Run: 047, P, 0, 0, 73, 0, 73, 0
INVAR-29, Run: 048, P, 0, 0, 73, 0, 73, 0
INVAR-29, Run: 049, P, 0, 0, 73, 0, 73, 0
INVAR-29, Run: 050, P, 0, 0, 73, 0, 73, 0
INVAR-29, Run: 051, P, 0, 0, 73, 0, 73, 0
INVAR-29, Run: 052, P, 0, 0, 73, 0, 73, 0
INVAR-29, Run: 053, P, 0, 0, 73, 0, 73, 0
INVAR-29, Run: 054, P, 0, 0, 73, 0, 73, 0
INVAR-29, Run: 055, P, 0, 0, 73, 0, 73, 0
INVAR-29, Run: 056, P, 0, 0, 73, 0, 73, 0
INVAR-29, Run: 057, P, 0, 0, 73, 0, 73, 0
INVAR-29, Run: 058, P, 0, 0, 73, 0, 73, 0
INVAR-29, Run: 059, P, 0, 0, 73, 0, 73, 0
INVAR-29, Run: 060, P, 0, 0, 73, 0, 73, 0
INVAR-29, Run: 061, P, 0, 0, 73, 0, 73, 0
INVAR-29, Run: 062, P, 0, 0, 73, 0, 73, 0
INVAR-29, Run: 063, P, 0, 0, 73, 0, 73, 0
INVAR-29, Run: 064, P, 0, 0, 73, 0, 73, 0
INVAR-29, Run: 065, P, 0, 0, 73, 0, 73, 0
INVAR-29, Run: 066, P, 0, 0, 73, 0, 73, 0
INVAR-29, Run: 067, P, 0, 0, 73, 0, 73, 0
INVAR-29, Run: 068, P, 0, 0, 73, 0, 73, 0
INVAR-29, Run: 069, P, 0, 0, 73, 0, 73, 0
INVAR-29, Run: 070, P, 0, 0, 73, 0, 73, 0
INVAR-29, Run: 071, P, 0, 0, 73, 0, 73, 0
INVAR-29, Run: 072, P, 0, 0, 73, 0, 73, 0
INVAR-29, Run: 073, P, 0, 0, 73, 0, 73, 0
INVAR-29, Run: 074, P, 0, 0, 73, 0, 73, 0
INVAR-29, Run: 075, P, 0, 0, 73, 0, 73, 0
INVAR-29, Run: 076, P, 0, 0, 73, 0, 73, 0
INVAR-29, Run: 077, P, 0, 0, 73, 0, 73, 0
INVAR-29, Run: 078, P, 0, 0, 73, 0, 73, 0
INVAR-29, Run: 079, P, 0, 0, 73, 0, 73, 0
INVAR-29, Run: 080, P, 0, 0, 73, 0, 73, 0
INVAR-29, Run: 081, P, 0, 0, 73, 0, 73, 0
INVAR-29, Run: 082, P, 0, 0, 73, 0, 73, 0
INVAR-29, Run: 083, P, 0, 0, 73, 0, 73, 0
INVAR-29, Run: 084, P, 0, 0, 73, 0, 73, 0
INVAR-29, Run: 085, P, 0, 0, 73, 0, 73, 0
INVAR-29, Run: 086, P, 0, 0, 73, 0, 73, 0
INVAR-29, Run: 087, P, 0, 0, 73, 0, 73, 0
INVAR-29, Run: 088, P, 0, 0, 73, 0, 73, 0
INVAR-29, Run: 089, P, 0, 0, 73, 0, 73, 0
INVAR-29, Run: 090, P, 0, 0, 73, 0, 73, 0
INVAR-29, Run: 091, P, 0, 0, 73, 0, 73, 0
INVAR-29, Run: 092, P, 0, 0, 73, 0, 73, 0
INVAR-29, Run: 093, P, 0, 0, 73, 0, 73, 0
INVAR-29, Run: 094, P, 0, 0, 73, 0, 73, 0
INVAR-29, Run: 095, P, 0, 0, 73, 0, 73, 0
INVAR-29, Run: 096, P, 0, 0, 73, 0, 73, 0
INVAR-29, Run: 097, P, 0, 0, 73, 0, 73, 0
INVAR-29, Run: 098, P, 0, 0, 73, 0, 73, 0
INVAR-29, Run: 099, P, 0, 0, 73, 0, 73, 0
INVAR-29, Run: 100, P, 0, 0, 73, 0, 73, 0
INVAR-3, Run: 001, F, 0, 0, 78, 37, 157, 79
INVAR-3, Run: 002, F, 0, 0, 88, 42, 162, 74
INVAR-3, Run: 003, F, 0, 0, 74, 35, 155, 81
INVAR-3, Run: 004, F, 0, 0, 66, 31, 151, 85
INVAR-3, Run: 005, F, 0, 0, 78, 37, 157, 79
INVAR-3, Run: 006, F, 0, 0, 78, 37, 157, 79
INVAR-3, Run: 007, F, 0, 0, 76, 36, 156, 80
INVAR-3, Run: 008, F, 0, 0, 76, 36, 156, 80
INVAR-3, Run: 009, F, 0, 0, 78, 37, 157, 79
INVAR-3, Run: 010, F, 0, 0, 88, 42, 162, 74
INVAR-3, Run: 011, F, 0, 0, 92, 44, 164, 72
INVAR-3, Run: 012, F, 0, 0, 84, 40, 160, 76
INVAR-3, Run: 013, F, 0, 0, 80, 38, 158, 78
INVAR-3, Run: 014, F, 0, 0, 70, 33, 153, 83
INVAR-3, Run: 015, F, 0, 0, 90, 43, 163, 73
INVAR-3, Run: 016, F, 0, 0, 76, 36, 156, 80
INVAR-3, Run: 017, F, 0, 0, 76, 36, 156, 80
INVAR-3, Run: 018, F, 0, 0, 78, 37, 157, 79
INVAR-3, Run: 019, F, 0, 0, 98, 47, 167, 69
INVAR-3, Run: 020, F, 0, 0, 90, 43, 163, 73
INVAR-3, Run: 021, F, 0, 0, 86, 41, 161, 75
INVAR-3, Run: 022, F, 0, 0, 80, 38, 158, 78
INVAR-3, Run: 023, F, 0, 0, 82, 39, 159, 77
INVAR-3, Run: 024, F, 0, 0, 80, 38, 158, 78
INVAR-3, Run: 025, F, 0, 0, 74, 35, 155, 81
INVAR-3, Run: 026, F, 0, 0, 78, 37, 157, 79
INVAR-3, Run: 027, F, 0, 0, 70, 33, 153, 83
INVAR-3, Run: 028, F, 0, 0, 78, 37, 157, 79
INVAR-3, Run: 029, F, 0, 0, 76, 36, 156, 80
INVAR-3, Run: 030, F, 0, 0, 80, 38, 158, 78
INVAR-3, Run: 031, F, 0, 0, 80, 38, 158, 78
INVAR-3, Run: 032, F, 0, 0, 88, 42, 162, 74
INVAR-3, Run: 033, F, 0, 0, 80, 38, 158, 78
INVAR-3, Run: 034, F, 0, 0, 86, 41, 161, 75
INVAR-3, Run: 035, F, 0, 0, 80, 38, 158, 78
INVAR-3, Run: 036, F, 0, 0, 78, 37, 157, 79
INVAR-3, Run: 037, F, 0, 0, 86, 41, 161, 75
INVAR-3, Run: 038, F, 0, 0, 84, 40, 160, 76
INVAR-3, Run: 039, F, 0, 0, 72, 34, 154, 82
INVAR-3, Run: 040, F, 0, 0, 78, 37, 157, 79
INVAR-3, Run: 041, F, 0, 0, 64, 30, 150, 86
INVAR-3, Run: 042, F, 0, 0, 68, 32, 152, 84
INVAR-3, Run: 043, F, 0, 0, 78, 37, 157, 79
INVAR-3, Run: 044, F, 0, 0, 94, 45, 165, 71
INVAR-3, Run: 045, F, 0, 0, 90, 43, 163, 73
INVAR-3, Run: 046, F, 0, 0, 94, 45, 165, 71
INVAR-3, Run: 047, F, 0, 0, 84, 40, 160, 76
INVAR-3, Run: 048, F, 0, 0, 86, 41, 161, 75
INVAR-3, Run: 049, F, 0, 0, 90, 43, 163, 73
INVAR-3, Run: 050, F, 0, 0, 80, 38, 158, 78
INVAR-3, Run: 051, F, 0, 0, 64, 30, 150, 86
INVAR-3, Run: 052, F, 0, 0, 88, 42, 162, 74
INVAR-3, Run: 053, F, 0, 0, 76, 36, 156, 80
INVAR-3, Run: 054, F, 0, 0, 82, 39, 159, 77
INVAR-3, Run: 055, F, 0, 0, 90, 43, 163, 73
INVAR-3, Run: 056, F, 0, 0, 76, 36, 156, 80
INVAR-3, Run: 057, F, 0, 0, 86, 41, 161, 75
INVAR-3, Run: 058, F, 0, 0, 82, 39, 159, 77
INVAR-3, Run: 059, F, 0, 0, 86, 41, 161, 75
INVAR-3, Run: 060, F, 0, 0, 84, 40, 160, 76
INVAR-3, Run: 061, F, 0, 0, 80, 38, 158, 78
INVAR-3, Run: 062, F, 0, 0, 76, 36, 156, 80
INVAR-3, Run: 063, F, 0, 0, 90, 43, 163, 73
INVAR-3, Run: 064, F, 0, 0, 90, 43, 163, 73
INVAR-3, Run: 065, F, 0, 0, 82, 39, 159, 77
INVAR-3, Run: 066, F, 0, 0, 82, 39, 159, 77
INVAR-3, Run: 067, F, 0, 0, 80, 38, 158, 78
INVAR-3, Run: 068, F, 0, 0, 80, 38, 158, 78
INVAR-3, Run: 069, F, 0, 0, 96, 46, 166, 70
INVAR-3, Run: 070, F, 0, 0, 86, 41, 161, 75
INVAR-3, Run: 071, F, 0, 0, 82, 39, 159, 77
INVAR-3, Run: 072, F, 0, 0, 94, 45, 165, 71
INVAR-3, Run: 073, F, 0, 0, 68, 32, 152, 84
INVAR-3, Run: 074, F, 0, 0, 72, 34, 154, 82
INVAR-3, Run: 075, F, 0, 0, 86, 41, 161, 75
INVAR-3, Run: 076, F, 0, 0, 78, 37, 157, 79
INVAR-3, Run: 077, F, 0, 0, 80, 38, 158, 78
INVAR-3, Run: 078, F, 0, 0, 86, 41, 161, 75
INVAR-3, Run: 079, F, 0, 0, 86, 41, 161, 75
INVAR-3, Run: 080, F, 0, 0, 84, 40, 160, 76
INVAR-3, Run: 081, F, 0, 0, 84, 40, 160, 76
INVAR-3, Run: 082, F, 0, 0, 80, 38, 158, 78
INVAR-3, Run: 083, F, 0, 0, 82, 39, 159, 77
INVAR-3, Run: 084, F, 0, 0, 90, 43, 163, 73
INVAR-3, Run: 085, F, 0, 0, 90, 43, 163, 73
INVAR-3, Run: 086, F, 0, 0, 96, 46, 166, 70
INVAR-3, Run: 087, F, 0, 0, 90, 43, 163, 73
INVAR-3, Run: 088, F, 0, 0, 82, 39, 159, 77
INVAR-3, Run: 089, F, 0, 0, 82, 39, 159, 77
INVAR-3, Run: 090, F, 0, 0, 66, 31, 151, 85
INVAR-3, Run: 091, F, 0, 0, 82, 39, 159, 77
INVAR-3, Run: 092, F, 0, 0, 92, 44, 164, 72
INVAR-3, Run: 093, F, 0, 0, 88, 42, 162, 74
INVAR-3, Run: 094, F, 0, 0, 80, 38, 158, 78
INVAR-3, Run: 095, F, 0, 0, 88, 42, 162, 74
INVAR-3, Run: 096, F, 0, 0, 78, 37, 157, 79
INVAR-3, Run: 097, F, 0, 0, 92, 44, 164, 72
INVAR-3, Run: 098, F, 0, 0, 78, 37, 157, 79
INVAR-3, Run: 099, F, 0, 0, 84, 40, 160, 76
INVAR-3, Run: 100, F, 0, 0, 76, 36, 156, 80
INVAR-30, Run: 001, P, 0, 0, 101, 0, 101, 0
INVAR-30, Run: 002, P, 0, 0, 101, 0, 101, 0
INVAR-30, Run: 003, P, 0, 0, 101, 0, 101, 0
INVAR-30, Run: 004, P, 0, 0, 101, 0, 101, 0
INVAR-30, Run: 005, P, 0, 0, 101, 0, 101, 0
INVAR-30, Run: 006, P, 0, 0, 101, 0, 101, 0
INVAR-30, Run: 007, P, 0, 0, 101, 0, 101, 0
INVAR-30, Run: 008, P, 0, 0, 101, 0, 101, 0
INVAR-30, Run: 009, P, 0, 0, 101, 0, 101, 0
INVAR-30, Run: 010, P, 0, 0, 101, 0, 101, 0
INVAR-30, Run: 011, P, 0, 0, 101, 0, 101, 0
INVAR-30, Run: 012, P, 0, 0, 101, 0, 101, 0
INVAR-30, Run: 013, P, 0, 0, 101, 0, 101, 0
INVAR-30, Run: 014, P, 0, 0, 101, 0, 101, 0
INVAR-30, Run: 015, P, 0, 0, 101, 0, 101, 0
INVAR-30, Run: 016, P, 0, 0, 101, 0, 101, 0
INVAR-30, Run: 017, P, 0, 0, 101, 0, 101, 0
INVAR-30, Run: 018, P, 0, 0, 101, 0, 101, 0
INVAR-30, Run: 019, P, 0, 0, 101, 0, 101, 0
INVAR-30, Run: 020, P, 0, 0, 101, 0, 101, 0
INVAR-30, Run: 021, P, 0, 0, 101, 0, 101, 0
INVAR-30, Run: 022, P, 0, 0, 101, 0, 101, 0
INVAR-30, Run: 023, P, 0, 0, 101, 0, 101, 0
INVAR-30, Run: 024, P, 0, 0, 101, 0, 101, 0
INVAR-30, Run: 025, P, 0, 0, 101, 0, 101, 0
INVAR-30, Run: 026, P, 0, 0, 101, 0, 101, 0
INVAR-30, Run: 027, P, 0, 0, 101, 0, 101, 0
INVAR-30, Run: 028, P, 0, 0, 101, 0, 101, 0
INVAR-30, Run: 029, P, 0, 0, 101, 0, 101, 0
INVAR-30, Run: 030, P, 0, 0, 101, 0, 101, 0
INVAR-30, Run: 031, P, 0, 0, 101, 0, 101, 0
INVAR-30, Run: 032, P, 0, 0, 101, 0, 101, 0
INVAR-30, Run: 033, P, 0, 0, 101, 0, 101, 0
INVAR-30, Run: 034, P, 0, 0, 101, 0, 101, 0
INVAR-30, Run: 035, P, 0, 0, 101, 0, 101, 0
INVAR-30, Run: 036, P, 0, 0, 101, 0, 101, 0
INVAR-30, Run: 037, P, 0, 0, 101, 0, 101, 0
INVAR-30, Run: 038, P, 0, 0, 101, 0, 101, 0
INVAR-30, Run: 039, P, 0, 0, 101, 0, 101, 0
INVAR-30, Run: 040, P, 0, 0, 101, 0, 101, 0
INVAR-30, Run: 041, P, 0, 0, 101, 0, 101, 0
INVAR-30, Run: 042, P, 0, 0, 101, 0, 101, 0
INVAR-30, Run: 043, P, 0, 0, 101, 0, 101, 0
INVAR-30, Run: 044, P, 0, 0, 101, 0, 101, 0
INVAR-30, Run: 045, P, 0, 0, 101, 0, 101, 0
INVAR-30, Run: 046, P, 0, 0, 101, 0, 101, 0
INVAR-30, Run: 047, P, 0, 0, 101, 0, 101, 0
INVAR-30, Run: 048, P, 0, 0, 101, 0, 101, 0
INVAR-30, Run: 049, P, 0, 0, 101, 0, 101, 0
INVAR-30, Run: 050, P, 0, 0, 101, 0, 101, 0
INVAR-30, Run: 051, P, 0, 0, 101, 0, 101, 0
INVAR-30, Run: 052, P, 0, 0, 101, 0, 101, 0
INVAR-30, Run: 053, P, 0, 0, 101, 0, 101, 0
INVAR-30, Run: 054, P, 0, 0, 101, 0, 101, 0
INVAR-30, Run: 055, P, 0, 0, 101, 0, 101, 0
INVAR-30, Run: 056, P, 0, 0, 101, 0, 101, 0
INVAR-30, Run: 057, P, 0, 0, 101, 0, 101, 0
INVAR-30, Run: 058, P, 0, 0, 101, 0, 101, 0
INVAR-30, Run: 059, P, 0, 0, 101, 0, 101, 0
INVAR-30, Run: 060, P, 0, 0, 101, 0, 101, 0
INVAR-30, Run: 061, P, 0, 0, 101, 0, 101, 0
INVAR-30, Run: 062, P, 0, 0, 101, 0, 101, 0
INVAR-30, Run: 063, P, 0, 0, 101, 0, 101, 0
INVAR-30, Run: 064, P, 0, 0, 101, 0, 101, 0
INVAR-30, Run: 065, P, 0, 0, 101, 0, 101, 0
INVAR-30, Run: 066, P, 0, 0, 101, 0, 101, 0
INVAR-30, Run: 067, P, 0, 0, 101, 0, 101, 0
INVAR-30, Run: 068, P, 0, 0, 101, 0, 101, 0
INVAR-30, Run: 069, P, 0, 0, 101, 0, 101, 0
INVAR-30, Run: 070, P, 0, 0, 101, 0, 101, 0
INVAR-30, Run: 071, P, 0, 0, 101, 0, 101, 0
INVAR-30, Run: 072, P, 0, 0, 101, 0, 101, 0
INVAR-30, Run: 073, P, 0, 0, 101, 0, 101, 0
INVAR-30, Run: 074, P, 0, 0, 101, 0, 101, 0
INVAR-30, Run: 075, P, 0, 0, 101, 0, 101, 0
INVAR-30, Run: 076, P, 0, 0, 101, 0, 101, 0
INVAR-30, Run: 077, P, 0, 0, 101, 0, 101, 0
INVAR-30, Run: 078, P, 0, 0, 101, 0, 101, 0
INVAR-30, Run: 079, P, 0, 0, 101, 0, 101, 0
INVAR-30, Run: 080, P, 0, 0, 101, 0, 101, 0
INVAR-30, Run: 081, P, 0, 0, 101, 0, 101, 0
INVAR-30, Run: 082, P, 0, 0, 101, 0, 101, 0
INVAR-30, Run: 083, P, 0, 0, 101, 0, 101, 0
INVAR-30, Run: 084, P, 0, 0, 101, 0, 101, 0
INVAR-30, Run: 085, P, 0, 0, 101, 0, 101, 0
INVAR-30, Run: 086, P, 0, 0, 101, 0, 101, 0
INVAR-30, Run: 087, P, 0, 0, 101, 0, 101, 0
INVAR-30, Run: 088, P, 0, 0, 101, 0, 101, 0
INVAR-30, Run: 089, P, 0, 0, 101, 0, 101, 0
INVAR-30, Run: 090, P, 0, 0, 101, 0, 101, 0
INVAR-30, Run: 091, P, 0, 0, 101, 0, 101, 0
INVAR-30, Run: 092, P, 0, 0, 101, 0, 101, 0
INVAR-30, Run: 093, P, 0, 0, 101, 0, 101, 0
INVAR-30, Run: 094, P, 0, 0, 101, 0, 101, 0
INVAR-30, Run: 095, P, 0, 0, 101, 0, 101, 0
INVAR-30, Run: 096, P, 0, 0, 101, 0, 101, 0
INVAR-30, Run: 097, P, 0, 0, 101, 0, 101, 0
INVAR-30, Run: 098, P, 0, 0, 101, 0, 101, 0
INVAR-30, Run: 099, P, 0, 0, 101, 0, 101, 0
INVAR-30, Run: 100, P, 0, 0, 101, 0, 101, 0
INVAR-31, Run: 001, P, 0, 0, 0, 0, 0, 0
INVAR-31, Run: 002, P, 0, 0, 0, 0, 0, 0
INVAR-31, Run: 003, P, 0, 0, 0, 0, 0, 0
INVAR-31, Run: 004, P, 0, 0, 0, 0, 0, 0
INVAR-31, Run: 005, P, 0, 0, 0, 0, 0, 0
INVAR-31, Run: 006, P, 0, 0, 0, 0, 0, 0
INVAR-31, Run: 007, P, 0, 0, 0, 0, 0, 0
INVAR-31, Run: 008, P, 0, 0, 0, 0, 0, 0
INVAR-31, Run: 009, P, 0, 0, 0, 0, 0, 0
INVAR-31, Run: 010, P, 0, 0, 0, 0, 0, 0
INVAR-31, Run: 011, P, 0, 0, 0, 0, 0, 0
INVAR-31, Run: 012, P, 0, 0, 0, 0, 0, 0
INVAR-31, Run: 013, P, 0, 0, 0, 0, 0, 0
INVAR-31, Run: 014, P, 0, 0, 0, 0, 0, 0
INVAR-31, Run: 015, P, 0, 0, 0, 0, 0, 0
INVAR-31, Run: 016, P, 0, 0, 0, 0, 0, 0
INVAR-31, Run: 017, P, 0, 0, 0, 0, 0, 0
INVAR-31, Run: 018, P, 0, 0, 0, 0, 0, 0
INVAR-31, Run: 019, P, 0, 0, 0, 0, 0, 0
INVAR-31, Run: 020, P, 0, 0, 0, 0, 0, 0
INVAR-31, Run: 021, P, 0, 0, 0, 0, 0, 0
INVAR-31, Run: 022, P, 0, 0, 0, 0, 0, 0
INVAR-31, Run: 023, P, 0, 0, 0, 0, 0, 0
INVAR-31, Run: 024, P, 0, 0, 0, 0, 0, 0
INVAR-31, Run: 025, P, 0, 0, 0, 0, 0, 0
INVAR-31, Run: 026, P, 0, 0, 0, 0, 0, 0
INVAR-31, Run: 027, P, 0, 0, 0, 0, 0, 0
INVAR-31, Run: 028, P, 0, 0, 0, 0, 0, 0
INVAR-31, Run: 029, P, 0, 0, 0, 0, 0, 0
INVAR-31, Run: 030, P, 0, 0, 0, 0, 0, 0
INVAR-31, Run: 031, P, 0, 0, 0, 0, 0, 0
INVAR-31, Run: 032, P, 0, 0, 0, 0, 0, 0
INVAR-31, Run: 033, P, 0, 0, 0, 0, 0, 0
INVAR-31, Run: 034, P, 0, 0, 0, 0, 0, 0
INVAR-31, Run: 035, P, 0, 0, 0, 0, 0, 0
INVAR-31, Run: 036, P, 0, 0, 0, 0, 0, 0
INVAR-31, Run: 037, P, 0, 0, 0, 0, 0, 0
INVAR-31, Run: 038, P, 0, 0, 0, 0, 0, 0
INVAR-31, Run: 039, P, 0, 0, 0, 0, 0, 0
INVAR-31, Run: 040, P, 0, 0, 0, 0, 0, 0
INVAR-31, Run: 041, P, 0, 0, 0, 0, 0, 0
INVAR-31, Run: 042, P, 0, 0, 0, 0, 0, 0
INVAR-31, Run: 043, P, 0, 0, 0, 0, 0, 0
INVAR-31, Run: 044, P, 0, 0, 0, 0, 0, 0
INVAR-31, Run: 045, P, 0, 0, 0, 0, 0, 0
INVAR-31, Run: 046, P, 0, 0, 0, 0, 0, 0
INVAR-31, Run: 047, P, 0, 0, 0, 0, 0, 0
INVAR-31, Run: 048, P, 0, 0, 0, 0, 0, 0
INVAR-31, Run: 049, P, 0, 0, 0, 0, 0, 0
INVAR-31, Run: 050, P, 0, 0, 0, 0, 0, 0
INVAR-31, Run: 051, P, 0, 0, 0, 0, 0, 0
INVAR-31, Run: 052, P, 0, 0, 0, 0, 0, 0
INVAR-31, Run: 053, P, 0, 0, 0, 0, 0, 0
INVAR-31, Run: 054, P, 0, 0, 0, 0, 0, 0
INVAR-31, Run: 055, P, 0, 0, 0, 0, 0, 0
INVAR-31, Run: 056, P, 0, 0, 0, 0, 0, 0
INVAR-31, Run: 057, P, 0, 0, 0, 0, 0, 0
INVAR-31, Run: 058, P, 0, 0, 0, 0, 0, 0
INVAR-31, Run: 059, P, 0, 0, 0, 0, 0, 0
INVAR-31, Run: 060, P, 0, 0, 0, 0, 0, 0
INVAR-31, Run: 061, P, 0, 0, 0, 0, 0, 0
INVAR-31, Run: 062, P, 0, 0, 0, 0, 0, 0
INVAR-31, Run: 063, P, 0, 0, 0, 0, 0, 0
INVAR-31, Run: 064, P, 0, 0, 0, 0, 0, 0
INVAR-31, Run: 065, P, 0, 0, 0, 0, 0, 0
INVAR-31, Run: 066, P, 0, 0, 0, 0, 0, 0
INVAR-31, Run: 067, P, 0, 0, 0, 0, 0, 0
INVAR-31, Run: 068, P, 0, 0, 0, 0, 0, 0
INVAR-31, Run: 069, P, 0, 0, 0, 0, 0, 0
INVAR-31, Run: 070, P, 0, 0, 0, 0, 0, 0
INVAR-31, Run: 071, P, 0, 0, 0, 0, 0, 0
INVAR-31, Run: 072, P, 0, 0, 0, 0, 0, 0
INVAR-31, Run: 073, P, 0, 0, 0, 0, 0, 0
INVAR-31, Run: 074, P, 0, 0, 0, 0, 0, 0
INVAR-31, Run: 075, P, 0, 0, 0, 0, 0, 0
INVAR-31, Run: 076, P, 0, 0, 0, 0, 0, 0
INVAR-31, Run: 077, P, 0, 0, 0, 0, 0, 0
INVAR-31, Run: 078, P, 0, 0, 0, 0, 0, 0
INVAR-31, Run: 079, P, 0, 0, 0, 0, 0, 0
INVAR-31, Run: 080, P, 0, 0, 0, 0, 0, 0
INVAR-31, Run: 081, P, 0, 0, 0, 0, 0, 0
INVAR-31, Run: 082, P, 0, 0, 0, 0, 0, 0
INVAR-31, Run: 083, P, 0, 0, 0, 0, 0, 0
INVAR-31, Run: 084, P, 0, 0, 0, 0, 0, 0
INVAR-31, Run: 085, P, 0, 0, 0, 0, 0, 0
INVAR-31, Run: 086, P, 0, 0, 0, 0, 0, 0
INVAR-31, Run: 087, P, 0, 0, 0, 0, 0, 0
INVAR-31, Run: 088, P, 0, 0, 0, 0, 0, 0
INVAR-31, Run: 089, P, 0, 0, 0, 0, 0, 0
INVAR-31, Run: 090, P, 0, 0, 0, 0, 0, 0
INVAR-31, Run: 091, P, 0, 0, 0, 0, 0, 0
INVAR-31, Run: 092, P, 0, 0, 0, 0, 0, 0
INVAR-31, Run: 093, P, 0, 0, 0, 0, 0, 0
INVAR-31, Run: 094, P, 0, 0, 0, 0, 0, 0
INVAR-31, Run: 095, P, 0, 0, 0, 0, 0, 0
INVAR-31, Run: 096, P, 0, 0, 0, 0, 0, 0
INVAR-31, Run: 097, P, 0, 0, 0, 0, 0, 0
INVAR-31, Run: 098, P, 0, 0, 0, 0, 0, 0
INVAR-31, Run: 099, P, 0, 0, 0, 0, 0, 0
INVAR-31, Run: 100, P, 0, 0, 0, 0, 0, 0
INVAR-32, Run: 001, P, 0, 0, 50, 0, 50, 0
INVAR-32, Run: 002, P, 0, 0, 50, 0, 50, 0
INVAR-32, Run: 003, P, 0, 0, 50, 0, 50, 0
INVAR-32, Run: 004, P, 0, 0, 50, 0, 50, 0
INVAR-32, Run: 005, P, 0, 0, 50, 0, 50, 0
INVAR-32, Run: 006, P, 0, 0, 50, 0, 50, 0
INVAR-32, Run: 007, P, 0, 0, 50, 0, 50, 0
INVAR-32, Run: 008, P, 0, 0, 50, 0, 50, 0
INVAR-32, Run: 009, P, 0, 0, 50, 0, 50, 0
INVAR-32, Run: 010, P, 0, 0, 50, 0, 50, 0
INVAR-32, Run: 011, P, 0, 0, 50, 0, 50, 0
INVAR-32, Run: 012, P, 0, 0, 50, 0, 50, 0
INVAR-32, Run: 013, P, 0, 0, 50, 0, 50, 0
INVAR-32, Run: 014, P, 0, 0, 50, 0, 50, 0
INVAR-32, Run: 015, P, 0, 0, 50, 0, 50, 0
INVAR-32, Run: 016, P, 0, 0, 50, 0, 50, 0
INVAR-32, Run: 017, P, 0, 0, 50, 0, 50, 0
INVAR-32, Run: 018, P, 0, 0, 50, 0, 50, 0
INVAR-32, Run: 019, P, 0, 0, 50, 0, 50, 0
INVAR-32, Run: 020, P, 0, 0, 50, 0, 50, 0
INVAR-32, Run: 021, P, 0, 0, 50, 0, 50, 0
INVAR-32, Run: 022, P, 0, 0, 50, 0, 50, 0
INVAR-32, Run: 023, P, 0, 0, 50, 0, 50, 0
INVAR-32, Run: 024, P, 0, 0, 50, 0, 50, 0
INVAR-32, Run: 025, P, 0, 0, 50, 0, 50, 0
INVAR-32, Run: 026, P, 0, 0, 50, 0, 50, 0
INVAR-32, Run: 027, P, 0, 0, 50, 0, 50, 0
INVAR-32, Run: 028, P, 0, 0, 50, 0, 50, 0
INVAR-32, Run: 029, P, 0, 0, 50, 0, 50, 0
INVAR-32, Run: 030, P, 0, 0, 50, 0, 50, 0
INVAR-32, Run: 031, P, 0, 0, 50, 0, 50, 0
INVAR-32, Run: 032, P, 0, 0, 50, 0, 50, 0
INVAR-32, Run: 033, P, 0, 0, 50, 0, 50, 0
INVAR-32, Run: 034, P, 0, 0, 50, 0, 50, 0
INVAR-32, Run: 035, P, 0, 0, 50, 0, 50, 0
INVAR-32, Run: 036, P, 0, 0, 50, 0, 50, 0
INVAR-32, Run: 037, P, 0, 0, 50, 0, 50, 0
INVAR-32, Run: 038, P, 0, 0, 50, 0, 50, 0
INVAR-32, Run: 039, P, 0, 0, 50, 0, 50, 0
INVAR-32, Run: 040, P, 0, 0, 50, 0, 50, 0
INVAR-32, Run: 041, P, 0, 0, 50, 0, 50, 0
INVAR-32, Run: 042, P, 0, 0, 50, 0, 50, 0
INVAR-32, Run: 043, P, 0, 0, 50, 0, 50, 0
INVAR-32, Run: 044, P, 0, 0, 50, 0, 50, 0
INVAR-32, Run: 045, P, 0, 0, 50, 0, 50, 0
INVAR-32, Run: 046, P, 0, 0, 50, 0, 50, 0
INVAR-32, Run: 047, P, 0, 0, 50, 0, 50, 0
INVAR-32, Run: 048, P, 0, 0, 50, 0, 50, 0
INVAR-32, Run: 049, P, 0, 0, 50, 0, 50, 0
INVAR-32, Run: 050, P, 0, 0, 50, 0, 50, 0
INVAR-32, Run: 051, P, 0, 0, 50, 0, 50, 0
INVAR-32, Run: 052, P, 0, 0, 50, 0, 50, 0
INVAR-32, Run: 053, P, 0, 0, 50, 0, 50, 0
INVAR-32, Run: 054, P, 0, 0, 50, 0, 50, 0
INVAR-32, Run: 055, P, 0, 0, 50, 0, 50, 0
INVAR-32, Run: 056, P, 0, 0, 50, 0, 50, 0
INVAR-32, Run: 057, P, 0, 0, 50, 0, 50, 0
INVAR-32, Run: 058, P, 0, 0, 50, 0, 50, 0
INVAR-32, Run: 059, P, 0, 0, 50, 0, 50, 0
INVAR-32, Run: 060, P, 0, 0, 50, 0, 50, 0
INVAR-32, Run: 061, P, 0, 0, 50, 0, 50, 0
INVAR-32, Run: 062, P, 0, 0, 50, 0, 50, 0
INVAR-32, Run: 063, P, 0, 0, 50, 0, 50, 0
INVAR-32, Run: 064, P, 0, 0, 50, 0, 50, 0
INVAR-32, Run: 065, P, 0, 0, 50, 0, 50, 0
INVAR-32, Run: 066, P, 0, 0, 50, 0, 50, 0
INVAR-32, Run: 067, P, 0, 0, 50, 0, 50, 0
INVAR-32, Run: 068, P, 0, 0, 50, 0, 50, 0
INVAR-32, Run: 069, P, 0, 0, 50, 0, 50, 0
INVAR-32, Run: 070, P, 0, 0, 50, 0, 50, 0
INVAR-32, Run: 071, P, 0, 0, 50, 0, 50, 0
INVAR-32, Run: 072, P, 0, 0, 50, 0, 50, 0
INVAR-32, Run: 073, P, 0, 0, 50, 0, 50, 0
INVAR-32, Run: 074, P, 0, 0, 50, 0, 50, 0
INVAR-32, Run: 075, P, 0, 0, 50, 0, 50, 0
INVAR-32, Run: 076, P, 0, 0, 50, 0, 50, 0
INVAR-32, Run: 077, P, 0, 0, 50, 0, 50, 0
INVAR-32, Run: 078, P, 0, 0, 50, 0, 50, 0
INVAR-32, Run: 079, P, 0, 0, 50, 0, 50, 0
INVAR-32, Run: 080, P, 0, 0, 50, 0, 50, 0
INVAR-32, Run: 081, P, 0, 0, 50, 0, 50, 0
INVAR-32, Run: 082, P, 0, 0, 50, 0, 50, 0
INVAR-32, Run: 083, P, 0, 0, 50, 0, 50, 0
INVAR-32, Run: 084, P, 0, 0, 50, 0, 50, 0
INVAR-32, Run: 085, P, 0, 0, 50, 0, 50, 0
INVAR-32, Run: 086, P, 0, 0, 50, 0, 50, 0
INVAR-32, Run: 087, P, 0, 0, 50, 0, 50, 0
INVAR-32, Run: 088, P, 0, 0, 50, 0, 50, 0
INVAR-32, Run: 089, P, 0, 0, 50, 0, 50, 0
INVAR-32, Run: 090, P, 0, 0, 50, 0, 50, 0
INVAR-32, Run: 091, P, 0, 0, 50, 0, 50, 0
INVAR-32, Run: 092, P, 0, 0, 50, 0, 50, 0
INVAR-32, Run: 093, P, 0, 0, 50, 0, 50, 0
INVAR-32, Run: 094, P, 0, 0, 50, 0, 50, 0
INVAR-32, Run: 095, P, 0, 0, 50, 0, 50, 0
INVAR-32, Run: 096, P, 0, 0, 50, 0, 50, 0
INVAR-32, Run: 097, P, 0, 0, 50, 0, 50, 0
INVAR-32, Run: 098, P, 0, 0, 50, 0, 50, 0
INVAR-32, Run: 099, P, 0, 0, 50, 0, 50, 0
INVAR-32, Run: 100, P, 0, 0, 50, 0, 50, 0
INVAR-33, Run: 001, P, 0, 0, 100, 0, 100, 0
INVAR-33, Run: 002, P, 0, 0, 100, 0, 100, 0
INVAR-33, Run: 003, P, 0, 0, 100, 0, 100, 0
INVAR-33, Run: 004, P, 0, 0, 100, 0, 100, 0
INVAR-33, Run: 005, P, 0, 0, 100, 0, 100, 0
INVAR-33, Run: 006, P, 0, 0, 100, 0, 100, 0
INVAR-33, Run: 007, P, 0, 0, 100, 0, 100, 0
INVAR-33, Run: 008, P, 0, 0, 100, 0, 100, 0
INVAR-33, Run: 009, P, 0, 0, 100, 0, 100, 0
INVAR-33, Run: 010, P, 0, 0, 100, 0, 100, 0
INVAR-33, Run: 011, P, 0, 0, 100, 0, 100, 0
INVAR-33, Run: 012, P, 0, 0, 100, 0, 100, 0
INVAR-33, Run: 013, P, 0, 0, 100, 0, 100, 0
INVAR-33, Run: 014, P, 0, 0, 100, 0, 100, 0
INVAR-33, Run: 015, P, 0, 0, 100, 0, 100, 0
INVAR-33, Run: 016, P, 0, 0, 100, 0, 100, 0
INVAR-33, Run: 017, P, 0, 0, 100, 0, 100, 0
INVAR-33, Run: 018, P, 0, 0, 100, 0, 100, 0
INVAR-33, Run: 019, P, 0, 0, 100, 0, 100, 0
INVAR-33, Run: 020, P, 0, 0, 100, 0, 100, 0
INVAR-33, Run: 021, P, 0, 0, 100, 0, 100, 0
INVAR-33, Run: 022, P, 0, 0, 100, 0, 100, 0
INVAR-33, Run: 023, P, 0, 0, 100, 0, 100, 0
INVAR-33, Run: 024, P, 0, 0, 100, 0, 100, 0
INVAR-33, Run: 025, P, 0, 0, 100, 0, 100, 0
INVAR-33, Run: 026, P, 0, 0, 100, 0, 100, 0
INVAR-33, Run: 027, P, 0, 0, 100, 0, 100, 0
INVAR-33, Run: 028, P, 0, 0, 100, 0, 100, 0
INVAR-33, Run: 029, P, 0, 0, 100, 0, 100, 0
INVAR-33, Run: 030, P, 0, 0, 100, 0, 100, 0
INVAR-33, Run: 031, P, 0, 0, 100, 0, 100, 0
INVAR-33, Run: 032, P, 0, 0, 100, 0, 100, 0
INVAR-33, Run: 033, P, 0, 0, 100, 0, 100, 0
INVAR-33, Run: 034, P, 0, 0, 100, 0, 100, 0
INVAR-33, Run: 035, P, 0, 0, 100, 0, 100, 0
INVAR-33, Run: 036, P, 0, 0, 100, 0, 100, 0
INVAR-33, Run: 037, P, 0, 0, 100, 0, 100, 0
INVAR-33, Run: 038, P, 0, 0, 100, 0, 100, 0
INVAR-33, Run: 039, P, 0, 0, 100, 0, 100, 0
INVAR-33, Run: 040, P, 0, 0, 100, 0, 100, 0
INVAR-33, Run: 041, P, 0, 0, 100, 0, 100, 0
INVAR-33, Run: 042, P, 0, 0, 100, 0, 100, 0
INVAR-33, Run: 043, P, 0, 0, 100, 0, 100, 0
INVAR-33, Run: 044, P, 0, 0, 100, 0, 100, 0
INVAR-33, Run: 045, P, 0, 0, 100, 0, 100, 0
INVAR-33, Run: 046, P, 0, 0, 100, 0, 100, 0
INVAR-33, Run: 047, P, 0, 0, 100, 0, 100, 0
INVAR-33, Run: 048, P, 0, 0, 100, 0, 100, 0
INVAR-33, Run: 049, P, 0, 0, 100, 0, 100, 0
INVAR-33, Run: 050, P, 0, 0, 100, 0, 100, 0
INVAR-33, Run: 051, P, 0, 0, 100, 0, 100, 0
INVAR-33, Run: 052, P, 0, 0, 100, 0, 100, 0
INVAR-33, Run: 053, P, 0, 0, 100, 0, 100, 0
INVAR-33, Run: 054, P, 0, 0, 100, 0, 100, 0
INVAR-33, Run: 055, P, 0, 0, 100, 0, 100, 0
INVAR-33, Run: 056, P, 0, 0, 100, 0, 100, 0
INVAR-33, Run: 057, P, 0, 0, 100, 0, 100, 0
INVAR-33, Run: 058, P, 0, 0, 100, 0, 100, 0
INVAR-33, Run: 059, P, 0, 0, 100, 0, 100, 0
INVAR-33, Run: 060, P, 0, 0, 100, 0, 100, 0
INVAR-33, Run: 061, P, 0, 0, 100, 0, 100, 0
INVAR-33, Run: 062, P, 0, 0, 100, 0, 100, 0
INVAR-33, Run: 063, P, 0, 0, 100, 0, 100, 0
INVAR-33, Run: 064, P, 0, 0, 100, 0, 100, 0
INVAR-33, Run: 065, P, 0, 0, 100, 0, 100, 0
INVAR-33, Run: 066, P, 0, 0, 100, 0, 100, 0
INVAR-33, Run: 067, P, 0, 0, 100, 0, 100, 0
INVAR-33, Run: 068, P, 0, 0, 100, 0, 100, 0
INVAR-33, Run: 069, P, 0, 0, 100, 0, 100, 0
INVAR-33, Run: 070, P, 0, 0, 100, 0, 100, 0
INVAR-33, Run: 071, P, 0, 0, 100, 0, 100, 0
INVAR-33, Run: 072, P, 0, 0, 100, 0, 100, 0
INVAR-33, Run: 073, P, 0, 0, 100, 0, 100, 0
INVAR-33, Run: 074, P, 0, 0, 100, 0, 100, 0
INVAR-33, Run: 075, P, 0, 0, 100, 0, 100, 0
INVAR-33, Run: 076, P, 0, 0, 100, 0, 100, 0
INVAR-33, Run: 077, P, 0, 0, 100, 0, 100, 0
INVAR-33, Run: 078, P, 0, 0, 100, 0, 100, 0
INVAR-33, Run: 079, P, 0, 0, 100, 0, 100, 0
INVAR-33, Run: 080, P, 0, 0, 100, 0, 100, 0
INVAR-33, Run: 081, P, 0, 0, 100, 0, 100, 0
INVAR-33, Run: 082, P, 0, 0, 100, 0, 100, 0
INVAR-33, Run: 083, P, 0, 0, 100, 0, 100, 0
INVAR-33, Run: 084, P, 0, 0, 100, 0, 100, 0
INVAR-33, Run: 085, P, 0, 0, 100, 0, 100, 0
INVAR-33, Run: 086, P, 0, 0, 100, 0, 100, 0
INVAR-33, Run: 087, P, 0, 0, 100, 0, 100, 0
INVAR-33, Run: 088, P, 0, 0, 100, 0, 100, 0
INVAR-33, Run: 089, P, 0, 0, 100, 0, 100, 0
INVAR-33, Run: 090, P, 0, 0, 100, 0, 100, 0
INVAR-33, Run: 091, P, 0, 0, 100, 0, 100, 0
INVAR-33, Run: 092, P, 0, 0, 100, 0, 100, 0
INVAR-33, Run: 093, P, 0, 0, 100, 0, 100, 0
INVAR-33, Run: 094, P, 0, 0, 100, 0, 100, 0
INVAR-33, Run: 095, P, 0, 0, 100, 0, 100, 0
INVAR-33, Run: 096, P, 0, 0, 100, 0, 100, 0
INVAR-33, Run: 097, P, 0, 0, 100, 0, 100, 0
INVAR-33, Run: 098, P, 0, 0, 100, 0, 100, 0
INVAR-33, Run: 099, P, 0, 0, 100, 0, 100, 0
INVAR-33, Run: 100, P, 0, 0, 100, 0, 100, 0
INVAR-34, Run: 001, P, 0, 0, 200, 0, 200, 0
INVAR-34, Run: 002, P, 0, 0, 200, 0, 200, 0
INVAR-34, Run: 003, P, 0, 0, 200, 0, 200, 0
INVAR-34, Run: 004, P, 0, 0, 200, 0, 200, 0
INVAR-34, Run: 005, P, 0, 0, 200, 0, 200, 0
INVAR-34, Run: 006, P, 0, 0, 200, 0, 200, 0
INVAR-34, Run: 007, P, 0, 0, 200, 0, 200, 0
INVAR-34, Run: 008, P, 0, 0, 200, 0, 200, 0
INVAR-34, Run: 009, P, 0, 0, 200, 0, 200, 0
INVAR-34, Run: 010, P, 0, 0, 200, 0, 200, 0
INVAR-34, Run: 011, P, 0, 0, 200, 0, 200, 0
INVAR-34, Run: 012, P, 0, 0, 200, 0, 200, 0
INVAR-34, Run: 013, P, 0, 0, 200, 0, 200, 0
INVAR-34, Run: 014, P, 0, 0, 200, 0, 200, 0
INVAR-34, Run: 015, P, 0, 0, 200, 0, 200, 0
INVAR-34, Run: 016, P, 0, 0, 200, 0, 200, 0
INVAR-34, Run: 017, P, 0, 0, 200, 0, 200, 0
INVAR-34, Run: 018, P, 0, 0, 200, 0, 200, 0
INVAR-34, Run: 019, P, 0, 0, 200, 0, 200, 0
INVAR-34, Run: 020, P, 0, 0, 200, 0, 200, 0
INVAR-34, Run: 021, P, 0, 0, 200, 0, 200, 0
INVAR-34, Run: 022, P, 0, 0, 200, 0, 200, 0
INVAR-34, Run: 023, P, 0, 0, 200, 0, 200, 0
INVAR-34, Run: 024, P, 0, 0, 200, 0, 200, 0
INVAR-34, Run: 025, P, 0, 0, 200, 0, 200, 0
INVAR-34, Run: 026, P, 0, 0, 200, 0, 200, 0
INVAR-34, Run: 027, P, 0, 0, 200, 0, 200, 0
INVAR-34, Run: 028, P, 0, 0, 200, 0, 200, 0
INVAR-34, Run: 029, P, 0, 0, 200, 0, 200, 0
INVAR-34, Run: 030, P, 0, 0, 200, 0, 200, 0
INVAR-34, Run: 031, P, 0, 0, 200, 0, 200, 0
INVAR-34, Run: 032, P, 0, 0, 200, 0, 200, 0
INVAR-34, Run: 033, P, 0, 0, 200, 0, 200, 0
INVAR-34, Run: 034, P, 0, 0, 200, 0, 200, 0
INVAR-34, Run: 035, P, 0, 0, 200, 0, 200, 0
INVAR-34, Run: 036, P, 0, 0, 200, 0, 200, 0
INVAR-34, Run: 037, P, 0, 0, 200, 0, 200, 0
INVAR-34, Run: 038, P, 0, 0, 200, 0, 200, 0
INVAR-34, Run: 039, P, 0, 0, 200, 0, 200, 0
INVAR-34, Run: 040, P, 0, 0, 200, 0, 200, 0
INVAR-34, Run: 041, P, 0, 0, 200, 0, 200, 0
INVAR-34, Run: 042, P, 0, 0, 200, 0, 200, 0
INVAR-34, Run: 043, P, 0, 0, 200, 0, 200, 0
INVAR-34, Run: 044, P, 0, 0, 200, 0, 200, 0
INVAR-34, Run: 045, P, 0, 0, 200, 0, 200, 0
INVAR-34, Run: 046, P, 0, 0, 200, 0, 200, 0
INVAR-34, Run: 047, P, 0, 0, 200, 0, 200, 0
INVAR-34, Run: 048, P, 0, 0, 200, 0, 200, 0
INVAR-34, Run: 049, P, 0, 0, 200, 0, 200, 0
INVAR-34, Run: 050, P, 0, 0, 200, 0, 200, 0
INVAR-34, Run: 051, P, 0, 0, 200, 0, 200, 0
INVAR-34, Run: 052, P, 0, 0, 200, 0, 200, 0
INVAR-34, Run: 053, P, 0, 0, 200, 0, 200, 0
INVAR-34, Run: 054, P, 0, 0, 200, 0, 200, 0
INVAR-34, Run: 055, P, 0, 0, 200, 0, 200, 0
INVAR-34, Run: 056, P, 0, 0, 200, 0, 200, 0
INVAR-34, Run: 057, P, 0, 0, 200, 0, 200, 0
INVAR-34, Run: 058, P, 0, 0, 200, 0, 200, 0
INVAR-34, Run: 059, P, 0, 0, 200, 0, 200, 0
INVAR-34, Run: 060, P, 0, 0, 200, 0, 200, 0
INVAR-34, Run: 061, P, 0, 0, 200, 0, 200, 0
INVAR-34, Run: 062, P, 0, 0, 200, 0, 200, 0
INVAR-34, Run: 063, P, 0, 0, 200, 0, 200, 0
INVAR-34, Run: 064, P, 0, 0, 200, 0, 200, 0
INVAR-34, Run: 065, P, 0, 0, 200, 0, 200, 0
INVAR-34, Run: 066, P, 0, 0, 200, 0, 200, 0
INVAR-34, Run: 067, P, 0, 0, 200, 0, 200, 0
INVAR-34, Run: 068, P, 0, 0, 200, 0, 200, 0
INVAR-34, Run: 069, P, 0, 0, 200, 0, 200, 0
INVAR-34, Run: 070, P, 0, 0, 200, 0, 200, 0
INVAR-34, Run: 071, P, 0, 0, 200, 0, 200, 0
INVAR-34, Run: 072, P, 0, 0, 200, 0, 200, 0
INVAR-34, Run: 073, P, 0, 0, 200, 0, 200, 0
INVAR-34, Run: 074, P, 0, 0, 200, 0, 200, 0
INVAR-34, Run: 075, P, 0, 0, 200, 0, 200, 0
INVAR-34, Run: 076, P, 0, 0, 200, 0, 200, 0
INVAR-34, Run: 077, P, 0, 0, 200, 0, 200, 0
INVAR-34, Run: 078, P, 0, 0, 200, 0, 200, 0
INVAR-34, Run: 079, P, 0, 0, 200, 0, 200, 0
INVAR-34, Run: 080, P, 0, 0, 200, 0, 200, 0
INVAR-34, Run: 081, P, 0, 0, 200, 0, 200, 0
INVAR-34, Run: 082, P, 0, 0, 200, 0, 200, 0
INVAR-34, Run: 083, P, 0, 0, 200, 0, 200, 0
INVAR-34, Run: 084, P, 0, 0, 200, 0, 200, 0
INVAR-34, Run: 085, P, 0, 0, 200, 0, 200, 0
INVAR-34, Run: 086, P, 0, 0, 200, 0, 200, 0
INVAR-34, Run: 087, P, 0, 0, 200, 0, 200, 0
INVAR-34, Run: 088, P, 0, 0, 200, 0, 200, 0
INVAR-34, Run: 089, P, 0, 0, 200, 0, 200, 0
INVAR-34, Run: 090, P, 0, 0, 200, 0, 200, 0
INVAR-34, Run: 091, P, 0, 0, 200, 0, 200, 0
INVAR-34, Run: 092, P, 0, 0, 200, 0, 200, 0
INVAR-34, Run: 093, P, 0, 0, 200, 0, 200, 0
INVAR-34, Run: 094, P, 0, 0, 200, 0, 200, 0
INVAR-34, Run: 095, P, 0, 0, 200, 0, 200, 0
INVAR-34, Run: 096, P, 0, 0, 200, 0, 200, 0
INVAR-34, Run: 097, P, 0, 0, 200, 0, 200, 0
INVAR-34, Run: 098, P, 0, 0, 200, 0, 200, 0
INVAR-34, Run: 099, P, 0, 0, 200, 0, 200, 0
INVAR-34, Run: 100, P, 0, 0, 200, 0, 200, 0
INVAR-35, Run: 001, F, 0, 0, 40, 19, 69, 29
INVAR-35, Run: 002, F, 0, 0, 42, 20, 70, 28
INVAR-35, Run: 003, F, 0, 0, 36, 17, 67, 31
INVAR-35, Run: 004, F, 0, 0, 30, 14, 64, 34
INVAR-35, Run: 005, F, 0, 0, 32, 15, 65, 33
INVAR-35, Run: 006, F, 0, 0, 38, 18, 68, 30
INVAR-35, Run: 007, F, 0, 0, 30, 14, 64, 34
INVAR-35, Run: 008, F, 0, 0, 42, 20, 70, 28
INVAR-35, Run: 009, F, 0, 0, 38, 18, 68, 30
INVAR-35, Run: 010, F, 0, 0, 36, 17, 67, 31
INVAR-35, Run: 011, F, 0, 0, 38, 18, 68, 30
INVAR-35, Run: 012, F, 0, 0, 36, 17, 67, 31
INVAR-35, Run: 013, F, 0, 0, 34, 16, 66, 32
INVAR-35, Run: 014, F, 0, 0, 30, 14, 64, 34
INVAR-35, Run: 015, F, 0, 0, 38, 18, 68, 30
INVAR-35, Run: 016, F, 0, 0, 44, 21, 71, 27
INVAR-35, Run: 017, F, 0, 0, 36, 17, 67, 31
INVAR-35, Run: 018, F, 0, 0, 40, 19, 69, 29
INVAR-35, Run: 019, F, 0, 0, 38, 18, 68, 30
INVAR-35, Run: 020, F, 0, 0, 34, 16, 66, 32
INVAR-35, Run: 021, F, 0, 0, 36, 17, 67, 31
INVAR-35, Run: 022, F, 0, 0, 34, 16, 66, 32
INVAR-35, Run: 023, F, 0, 0, 42, 20, 70, 28
INVAR-35, Run: 024, F, 0, 0, 28, 13, 63, 35
INVAR-35, Run: 025, F, 0, 0, 42, 20, 70, 28
INVAR-35, Run: 026, F, 0, 0, 38, 18, 68, 30
INVAR-35, Run: 027, F, 0, 0, 34, 16, 66, 32
INVAR-35, Run: 028, F, 0, 0, 36, 17, 67, 31
INVAR-35, Run: 029, F, 0, 0, 36, 17, 67, 31
INVAR-35, Run: 030, F, 0, 0, 42, 20, 70, 28
INVAR-35, Run: 031, F, 0, 0, 42, 20, 70, 28
INVAR-35, Run: 032, F, 0, 0, 48, 23, 73, 25
INVAR-35, Run: 033, F, 0, 0, 34, 16, 66, 32
INVAR-35, Run: 034, F, 0, 0, 40, 19, 69, 29
INVAR-35, Run: 035, F, 0, 0, 36, 17, 67, 31
INVAR-35, Run: 036, F, 0, 0, 38, 18, 68, 30
INVAR-35, Run: 037, F, 0, 0, 32, 15, 65, 33
INVAR-35, Run: 038, F, 0, 0, 44, 21, 71, 27
INVAR-35, Run: 039, F, 0, 0, 38, 18, 68, 30
INVAR-35, Run: 040, F, 0, 0, 34, 16, 66, 32
INVAR-35, Run: 041, F, 0, 0, 36, 17, 67, 31
INVAR-35, Run: 042, F, 0, 0, 34, 16, 66, 32
INVAR-35, Run: 043, F, 0, 0, 38, 18, 68, 30
INVAR-35, Run: 044, F, 0, 0, 34, 16, 66, 32
INVAR-35, Run: 045, F, 0, 0, 40, 19, 69, 29
INVAR-35, Run: 046, F, 0, 0, 44, 21, 71, 27
INVAR-35, Run: 047, F, 0, 0, 26, 12, 62, 36
INVAR-35, Run: 048, F, 0, 0, 30, 14, 64, 34
INVAR-35, Run: 049, F, 0, 0, 44, 21, 71, 27
INVAR-35, Run: 050, F, 0, 0, 30, 14, 64, 34
INVAR-35, Run: 051, F, 0, 0, 42, 20, 70, 28
INVAR-35, Run: 052, F, 0, 0, 30, 14, 64, 34
INVAR-35, Run: 053, F, 0, 0, 38, 18, 68, 30
INVAR-35, Run: 054, F, 0, 0, 36, 17, 67, 31
INVAR-35, Run: 055, F, 0, 0, 42, 20, 70, 28
INVAR-35, Run: 056, F, 0, 0, 40, 19, 69, 29
INVAR-35, Run: 057, F, 0, 0, 32, 15, 65, 33
INVAR-35, Run: 058, F, 0, 0, 40, 19, 69, 29
INVAR-35, Run: 059, F, 0, 0, 34, 16, 66, 32
INVAR-35, Run: 060, F, 0, 0, 26, 12, 62, 36
INVAR-35, Run: 061, F, 0, 0, 40, 19, 69, 29
INVAR-35, Run: 062, F, 0, 0, 26, 12, 62, 36
INVAR-35, Run: 063, F, 0, 0, 38, 18, 68, 30
INVAR-35, Run: 064, F, 0, 0, 26, 12, 62, 36
INVAR-35, Run: 065, F, 0, 0, 42, 20, 70, 28
INVAR-35, Run: 066, F, 0, 0, 36, 17, 67, 31
INVAR-35, Run: 067, F, 0, 0, 42, 20, 70, 28
INVAR-35, Run: 068, F, 0, 0, 44, 21, 71, 27
INVAR-35, Run: 069, F, 0, 0, 40, 19, 69, 29
INVAR-35, Run: 070, F, 0, 0, 36, 17, 67, 31
INVAR-35, Run: 071, F, 0, 0, 38, 18, 68, 30
INVAR-35, Run: 072, F, 0, 0, 42, 20, 70, 28
INVAR-35, Run: 073, F, 0, 0, 42, 20, 70, 28
INVAR-35, Run: 074, F, 0, 0, 38, 18, 68, 30
INVAR-35, Run: 075, F, 0, 0, 32, 15, 65, 33
INVAR-35, Run: 076, F, 0, 0, 42, 20, 70, 28
INVAR-35, Run: 077, F, 0, 0, 32, 15, 65, 33
INVAR-35, Run: 078, F, 0, 0, 32, 15, 65, 33
INVAR-35, Run: 079, F, 0, 0, 34, 16, 66, 32
INVAR-35, Run: 080, F, 0, 0, 36, 17, 67, 31
INVAR-35, Run: 081, F, 0, 0, 36, 17, 67, 31
INVAR-35, Run: 082, F, 0, 0, 38, 18, 68, 30
INVAR-35, Run: 083, F, 0, 0, 38, 18, 68, 30
INVAR-35, Run: 084, F, 0, 0, 34, 16, 66, 32
INVAR-35, Run: 085, F, 0, 0, 32, 15, 65, 33
INVAR-35, Run: 086, F, 0, 0, 26, 12, 62, 36
INVAR-35, Run: 087, F, 0, 0, 32, 15, 65, 33
INVAR-35, Run: 088, F, 0, 0, 50, 24, 74, 24
INVAR-35, Run: 089, F, 0, 0, 40, 19, 69, 29
INVAR-35, Run: 090, F, 0, 0, 38, 18, 68, 30
INVAR-35, Run: 091, F, 0, 0, 38, 18, 68, 30
INVAR-35, Run: 092, F, 0, 0, 34, 16, 66, 32
INVAR-35, Run: 093, F, 0, 0, 44, 21, 71, 27
INVAR-35, Run: 094, F, 0, 0, 36, 17, 67, 31
INVAR-35, Run: 095, F, 0, 0, 48, 23, 73, 25
INVAR-35, Run: 096, F, 0, 0, 32, 15, 65, 33
INVAR-35, Run: 097, F, 0, 0, 34, 16, 66, 32
INVAR-35, Run: 098, F, 0, 0, 40, 19, 69, 29
INVAR-35, Run: 099, F, 0, 0, 42, 20, 70, 28
INVAR-35, Run: 100, F, 0, 0, 38, 18, 68, 30
INVAR-36, Run: 001, F, 0, 0, 66, 9, 109, 43
INVAR-36, Run: 002, F, 0, 0, 78, 15, 115, 37
INVAR-36, Run: 003, F, 0, 0, 68, 10, 110, 42
INVAR-36, Run: 004, F, 0, 0, 78, 15, 115, 37
INVAR-36, Run: 005, F, 0, 0, 70, 11, 111, 41
INVAR-36, Run: 006, F, 0, 0, 80, 16, 116, 36
INVAR-36, Run: 007, F, 0, 0, 62, 7, 107, 45
INVAR-36, Run: 008, F, 0, 0, 70, 11, 111, 41
INVAR-36, Run: 009, F, 0, 0, 70, 11, 111, 41
INVAR-36, Run: 010, F, 0, 0, 78, 15, 115, 37
INVAR-36, Run: 011, F, 0, 0, 78, 15, 115, 37
INVAR-36, Run: 012, F, 0, 0, 80, 16, 116, 36
INVAR-36, Run: 013, F, 0, 0, 84, 18, 118, 34
INVAR-36, Run: 014, F, 0, 0, 76, 14, 114, 38
INVAR-36, Run: 015, F, 0, 0, 82, 17, 117, 35
INVAR-36, Run: 016, F, 0, 0, 76, 14, 114, 38
INVAR-36, Run: 017, F, 0, 0, 72, 12, 112, 40
INVAR-36, Run: 018, F, 0, 0, 88, 20, 120, 32
INVAR-36, Run: 019, F, 0, 0, 74, 13, 113, 39
INVAR-36, Run: 020, F, 0, 0, 78, 15, 115, 37
INVAR-36, Run: 021, F, 0, 0, 76, 14, 114, 38
INVAR-36, Run: 022, F, 0, 0, 72, 12, 112, 40
INVAR-36, Run: 023, F, 0, 0, 78, 15, 115, 37
INVAR-36, Run: 024, F, 0, 0, 82, 17, 117, 35
INVAR-36, Run: 025, F, 0, 0, 78, 15, 115, 37
INVAR-36, Run: 026, F, 0, 0, 86, 19, 119, 33
INVAR-36, Run: 027, F, 0, 0, 80, 16, 116, 36
INVAR-36, Run: 028, F, 0, 0, 70, 11, 111, 41
INVAR-36, Run: 029, F, 0, 0, 72, 12, 112, 40
INVAR-36, Run: 030, F, 0, 0, 70, 11, 111, 41
INVAR-36, Run: 031, F, 0, 0, 68, 10, 110, 42
INVAR-36, Run: 032, F, 0, 0, 82, 17, 117, 35
INVAR-36, Run: 033, F, 0, 0, 70, 11, 111, 41
INVAR-36, Run: 034, F, 0, 0, 72, 12, 112, 40
INVAR-36, Run: 035, F, 0, 0, 72, 12, 112, 40
INVAR-36, Run: 036, F, 0, 0, 64, 8, 108, 44
INVAR-36, Run: 037, F, 0, 0, 72, 12, 112, 40
INVAR-36, Run: 038, F, 0, 0, 72, 12, 112, 40
INVAR-36, Run: 039, F, 0, 0, 76, 14, 114, 38
INVAR-36, Run: 040, F, 0, 0, 78, 15, 115, 37
INVAR-36, Run: 041, F, 0, 0, 70, 11, 111, 41
INVAR-36, Run: 042, F, 0, 0, 70, 11, 111, 41
INVAR-36, Run: 043, F, 0, 0, 74, 13, 113, 39
INVAR-36, Run: 044, F, 0, 0, 78, 15, 115, 37
INVAR-36, Run: 045, F, 0, 0, 78, 15, 115, 37
INVAR-36, Run: 046, F, 0, 0, 70, 11, 111, 41
INVAR-36, Run: 047, F, 0, 0, 78, 15, 115, 37
INVAR-36, Run: 048, F, 0, 0, 78, 15, 115, 37
INVAR-36, Run: 049, F, 0, 0, 84, 18, 118, 34
INVAR-36, Run: 050, F, 0, 0, 78, 15, 115, 37
INVAR-36, Run: 051, F, 0, 0, 66, 9, 109, 43
INVAR-36, Run: 052, F, 0, 0, 70, 11, 111, 41
INVAR-36, Run: 053, F, 0, 0, 80, 16, 116, 36
INVAR-36, Run: 054, F, 0, 0, 74, 13, 113, 39
INVAR-36, Run: 055, F, 0, 0, 78, 15, 115, 37
INVAR-36, Run: 056, F, 0, 0, 70, 11, 111, 41
INVAR-36, Run: 057, F, 0, 0, 64, 8, 108, 44
INVAR-36, Run: 058, F, 0, 0, 72, 12, 112, 40
INVAR-36, Run: 059, F, 0, 0, 82, 17, 117, 35
INVAR-36, Run: 060, F, 0, 0, 64, 8, 108, 44
INVAR-36, Run: 061, F, 0, 0, 70, 11, 111, 41
INVAR-36, Run: 062, F, 0, 0, 64, 8, 108, 44
INVAR-36, Run: 063, F, 0, 0, 68, 10, 110, 42
INVAR-36, Run: 064, F, 0, 0, 68, 10, 110, 42
INVAR-36, Run: 065, F, 0, 0, 74, 13, 113, 39
INVAR-36, Run: 066, F, 0, 0, 70, 11, 111, 41
INVAR-36, Run: 067, F, 0, 0, 74, 13, 113, 39
INVAR-36, Run: 068, F, 0, 0, 62, 7, 107, 45
INVAR-36, Run: 069, F, 0, 0, 78, 15, 115, 37
INVAR-36, Run: 070, F, 0, 0, 82, 17, 117, 35
INVAR-36, Run: 071, F, 0, 0, 72, 12, 112, 40
INVAR-36, Run: 072, F, 0, 0, 72, 12, 112, 40
INVAR-36, Run: 073, F, 0, 0, 74, 13, 113, 39
INVAR-36, Run: 074, F, 0, 0, 76, 14, 114, 38
INVAR-36, Run: 075, F, 0, 0, 80, 16, 116, 36
INVAR-36, Run: 076, F, 0, 0, 70, 11, 111, 41
INVAR-36, Run: 077, F, 0, 0, 68, 10, 110, 42
INVAR-36, Run: 078, F, 0, 0, 72, 12, 112, 40
INVAR-36, Run: 079, F, 0, 0, 92, 22, 122, 30
INVAR-36, Run: 080, F, 0, 0, 76, 14, 114, 38
INVAR-36, Run: 081, F, 0, 0, 84, 18, 118, 34
INVAR-36, Run: 082, F, 0, 0, 72, 12, 112, 40
INVAR-36, Run: 083, F, 0, 0, 76, 14, 114, 38
INVAR-36, Run: 084, F, 0, 0, 84, 18, 118, 34
INVAR-36, Run: 085, F, 0, 0, 74, 13, 113, 39
INVAR-36, Run: 086, F, 0, 0, 76, 14, 114, 38
INVAR-36, Run: 087, F, 0, 0, 80, 16, 116, 36
INVAR-36, Run: 088, F, 0, 0, 70, 11, 111, 41
INVAR-36, Run: 089, F, 0, 0, 70, 11, 111, 41
INVAR-36, Run: 090, F, 0, 0, 68, 10, 110, 42
INVAR-36, Run: 091, F, 0, 0, 70, 11, 111, 41
INVAR-36, Run: 092, F, 0, 0, 74, 13, 113, 39
INVAR-36, Run: 093, F, 0, 0, 68, 10, 110, 42
INVAR-36, Run: 094, F, 0, 0, 82, 17, 117, 35
INVAR-36, Run: 095, F, 0, 0, 68, 10, 110, 42
INVAR-36, Run: 096, F, 0, 0, 66, 9, 109, 43
INVAR-36, Run: 097, F, 0, 0, 76, 14, 114, 38
INVAR-36, Run: 098, F, 0, 0, 74, 13, 113, 39
INVAR-36, Run: 099, F, 0, 0, 76, 14, 114, 38
INVAR-36, Run: 100, F, 0, 0, 64, 8, 108, 44
INVAR-37, Run: 001, F, 0, 0, 128, 41, 241, 113
INVAR-37, Run: 002, F, 0, 0, 138, 46, 246, 108
INVAR-37, Run: 003, F, 0, 0, 134, 44, 244, 110
INVAR-37, Run: 004, F, 0, 0, 146, 50, 250, 104
INVAR-37, Run: 005, F, 0, 0, 144, 49, 249, 105
INVAR-37, Run: 006, F, 0, 0, 128, 41, 241, 113
INVAR-37, Run: 007, F, 0, 0, 142, 48, 248, 106
INVAR-37, Run: 008, F, 0, 0, 124, 39, 239, 115
INVAR-37, Run: 009, F, 0, 0, 144, 49, 249, 105
INVAR-37, Run: 010, F, 0, 0, 136, 45, 245, 109
INVAR-37, Run: 011, F, 0, 0, 134, 44, 244, 110
INVAR-37, Run: 012, F, 0, 0, 138, 46, 246, 108
INVAR-37, Run: 013, F, 0, 0, 136, 45, 245, 109
INVAR-37, Run: 014, F, 0, 0, 136, 45, 245, 109
INVAR-37, Run: 015, F, 0, 0, 120, 37, 237, 117
INVAR-37, Run: 016, F, 0, 0, 136, 45, 245, 109
INVAR-37, Run: 017, F, 0, 0, 140, 47, 247, 107
INVAR-37, Run: 018, F, 0, 0, 142, 48, 248, 106
INVAR-37, Run: 019, F, 0, 0, 134, 44, 244, 110
INVAR-37, Run: 020, F, 0, 0, 136, 45, 245, 109
INVAR-37, Run: 021, F, 0, 0, 144, 49, 249, 105
INVAR-37, Run: 022, F, 0, 0, 132, 43, 243, 111
INVAR-37, Run: 023, F, 0, 0, 134, 44, 244, 110
INVAR-37, Run: 024, F, 0, 0, 128, 41, 241, 113
INVAR-37, Run: 025, F, 0, 0, 128, 41, 241, 113
INVAR-37, Run: 026, F, 0, 0, 128, 41, 241, 113
INVAR-37, Run: 027, F, 0, 0, 132, 43, 243, 111
INVAR-37, Run: 028, F, 0, 0, 126, 40, 240, 114
INVAR-37, Run: 029, F, 0, 0, 150, 52, 252, 102
INVAR-37, Run: 030, F, 0, 0, 130, 42, 242, 112
INVAR-37, Run: 031, F, 0, 0, 130, 42, 242, 112
INVAR-37, Run: 032, F, 0, 0, 142, 48, 248, 106
INVAR-37, Run: 033, F, 0, 0, 138, 46, 246, 108
INVAR-37, Run: 034, F, 0, 0, 120, 37, 237, 117
INVAR-37, Run: 035, F, 0, 0, 130, 42, 242, 112
INVAR-37, Run: 036, F, 0, 0, 138, 46, 246, 108
INVAR-37, Run: 037, F, 0, 0, 132, 43, 243, 111
INVAR-37, Run: 038, F, 0, 0, 136, 45, 245, 109
INVAR-37, Run: 039, F, 0, 0, 152, 53, 253, 101
INVAR-37, Run: 040, F, 0, 0, 122, 38, 238, 116
INVAR-37, Run: 041, F, 0, 0, 154, 54, 254, 100
INVAR-37, Run: 042, F, 0, 0, 130, 42, 242, 112
INVAR-37, Run: 043, F, 0, 0, 126, 40, 240, 114
INVAR-37, Run: 044, F, 0, 0, 132, 43, 243, 111
INVAR-37, Run: 045, F, 0, 0, 138, 46, 246, 108
INVAR-37, Run: 046, F, 0, 0, 134, 44, 244, 110
INVAR-37, Run: 047, F, 0, 0, 162, 58, 258, 96
INVAR-37, Run: 048, F, 0, 0, 130, 42, 242, 112
INVAR-37, Run: 049, F, 0, 0, 128, 41, 241, 113
INVAR-37, Run: 050, F, 0, 0, 136, 45, 245, 109
INVAR-37, Run: 051, F, 0, 0, 124, 39, 239, 115
INVAR-37, Run: 052, F, 0, 0, 144, 49, 249, 105
INVAR-37, Run: 053, F, 0, 0, 148, 51, 251, 103
INVAR-37, Run: 054, F, 0, 0, 134, 44, 244, 110
INVAR-37, Run: 055, F, 0, 0, 144, 49, 249, 105
INVAR-37, Run: 056, F, 0, 0, 160, 57, 257, 97
INVAR-37, Run: 057, F, 0, 0, 142, 48, 248, 106
INVAR-37, Run: 058, F, 0, 0, 138, 46, 246, 108
INVAR-37, Run: 059, F, 0, 0, 142, 48, 248, 106
INVAR-37, Run: 060, F, 0, 0, 156, 55, 255, 99
INVAR-37, Run: 061, F, 0, 0, 144, 49, 249, 105
INVAR-37, Run: 062, F, 0, 0, 136, 45, 245, 109
INVAR-37, Run: 063, F, 0, 0, 140, 47, 247, 107
INVAR-37, Run: 064, F, 0, 0, 126, 40, 240, 114
INVAR-37, Run: 065, F, 0, 0, 132, 43, 243, 111
INVAR-37, Run: 066, F, 0, 0, 132, 43, 243, 111
INVAR-37, Run: 067, F, 0, 0, 140, 47, 247, 107
INVAR-37, Run: 068, F, 0, 0, 146, 50, 250, 104
INVAR-37, Run: 069, F, 0, 0, 138, 46, 246, 108
INVAR-37, Run: 070, F, 0, 0, 128, 41, 241, 113
INVAR-37, Run: 071, F, 0, 0, 130, 42, 242, 112
INVAR-37, Run: 072, F, 0, 0, 142, 48, 248, 106
INVAR-37, Run: 073, F, 0, 0, 116, 35, 235, 119
INVAR-37, Run: 074, F, 0, 0, 130, 42, 242, 112
INVAR-37, Run: 075, F, 0, 0, 148, 51, 251, 103
INVAR-37, Run: 076, F, 0, 0, 134, 44, 244, 110
INVAR-37, Run: 077, F, 0, 0, 148, 51, 251, 103
INVAR-37, Run: 078, F, 0, 0, 124, 39, 239, 115
INVAR-37, Run: 079, F, 0, 0, 136, 45, 245, 109
INVAR-37, Run: 080, F, 0, 0, 124, 39, 239, 115
INVAR-37, Run: 081, F, 0, 0, 144, 49, 249, 105
INVAR-37, Run: 082, F, 0, 0, 140, 47, 247, 107
INVAR-37, Run: 083, F, 0, 0, 120, 37, 237, 117
INVAR-37, Run: 084, F, 0, 0, 138, 46, 246, 108
INVAR-37, Run: 085, F, 0, 0, 148, 51, 251, 103
INVAR-37, Run: 086, F, 0, 0, 134, 44, 244, 110
INVAR-37, Run: 087, F, 0, 0, 146, 50, 250, 104
INVAR-37, Run: 088, F, 0, 0, 146, 50, 250, 104
INVAR-37, Run: 089, F, 0, 0, 116, 35, 235, 119
INVAR-37, Run: 090, F, 0, 0, 136, 45, 245, 109
INVAR-37, Run: 091, F, 0, 0, 122, 38, 238, 116
INVAR-37, Run: 092, F, 0, 0, 138, 46, 246, 108
INVAR-37, Run: 093, F, 0, 0, 136, 45, 245, 109
INVAR-37, Run: 094, F, 0, 0, 144, 49, 249, 105
INVAR-37, Run: 095, F, 0, 0, 150, 52, 252, 102
INVAR-37, Run: 096, F, 0, 0, 126, 40, 240, 114
INVAR-37, Run: 097, F, 0, 0, 122, 38, 238, 116
INVAR-37, Run: 098, F, 0, 0, 140, 47, 247, 107
INVAR-37, Run: 099, F, 0, 0, 126, 40, 240, 114
INVAR-37, Run: 100, F, 0, 0, 146, 50, 250, 104
INVAR-38, Run: 001, F, 0, 0, 39, 10, 60, 21
INVAR-38, Run: 002, F, 0, 0, 33, 7, 57, 24
INVAR-38, Run: 003, F, 0, 0, 33, 7, 57, 24
INVAR-38, Run: 004, F, 0, 0, 31, 6, 56, 25
INVAR-38, Run: 005, F, 0, 0, 39, 10, 60, 21
INVAR-38, Run: 006, F, 0, 0, 41, 11, 61, 20
INVAR-38, Run: 007, F, 0, 0, 43, 12, 62, 19
INVAR-38, Run: 008, F, 0, 0, 33, 7, 57, 24
INVAR-38, Run: 009, F, 0, 0, 31, 6, 56, 25
INVAR-38, Run: 010, F, 0, 0, 39, 10, 60, 21
INVAR-38, Run: 011, F, 0, 0, 35, 8, 58, 23
INVAR-38, Run: 012, F, 0, 0, 45, 13, 63, 18
INVAR-38, Run: 013, F, 0, 0, 35, 8, 58, 23
INVAR-38, Run: 014, F, 0, 0, 35, 8, 58, 23
INVAR-38, Run: 015, F, 0, 0, 29, 5, 55, 26
INVAR-38, Run: 016, F, 0, 0, 31, 6, 56, 25
INVAR-38, Run: 017, F, 0, 0, 31, 6, 56, 25
INVAR-38, Run: 018, F, 0, 0, 41, 11, 61, 20
INVAR-38, Run: 019, F, 0, 0, 41, 11, 61, 20
INVAR-38, Run: 020, F, 0, 0, 33, 7, 57, 24
INVAR-38, Run: 021, F, 0, 0, 41, 11, 61, 20
INVAR-38, Run: 022, F, 0, 0, 33, 7, 57, 24
INVAR-38, Run: 023, F, 0, 0, 37, 9, 59, 22
INVAR-38, Run: 024, F, 0, 0, 37, 9, 59, 22
INVAR-38, Run: 025, F, 0, 0, 33, 7, 57, 24
INVAR-38, Run: 026, F, 0, 0, 39, 10, 60, 21
INVAR-38, Run: 027, F, 0, 0, 37, 9, 59, 22
INVAR-38, Run: 028, F, 0, 0, 37, 9, 59, 22
INVAR-38, Run: 029, F, 0, 0, 39, 10, 60, 21
INVAR-38, Run: 030, F, 0, 0, 45, 13, 63, 18
INVAR-38, Run: 031, F, 0, 0, 47, 14, 64, 17
INVAR-38, Run: 032, F, 0, 0, 45, 13, 63, 18
INVAR-38, Run: 033, F, 0, 0, 43, 12, 62, 19
INVAR-38, Run: 034, F, 0, 0, 45, 13, 63, 18
INVAR-38, Run: 035, F, 0, 0, 39, 10, 60, 21
INVAR-38, Run: 036, F, 0, 0, 39, 10, 60, 21
INVAR-38, Run: 037, F, 0, 0, 41, 11, 61, 20
INVAR-38, Run: 038, F, 0, 0, 37, 9, 59, 22
INVAR-38, Run: 039, F, 0, 0, 33, 7, 57, 24
INVAR-38, Run: 040, F, 0, 0, 37, 9, 59, 22
INVAR-38, Run: 041, F, 0, 0, 37, 9, 59, 22
INVAR-38, Run: 042, F, 0, 0, 41, 11, 61, 20
INVAR-38, Run: 043, F, 0, 0, 45, 13, 63, 18
INVAR-38, Run: 044, F, 0, 0, 43, 12, 62, 19
INVAR-38, Run: 045, F, 0, 0, 33, 7, 57, 24
INVAR-38, Run: 046, F, 0, 0, 37, 9, 59, 22
INVAR-38, Run: 047, F, 0, 0, 37, 9, 59, 22
INVAR-38, Run: 048, F, 0, 0, 35, 8, 58, 23
INVAR-38, Run: 049, F, 0, 0, 39, 10, 60, 21
INVAR-38, Run: 050, F, 0, 0, 29, 5, 55, 26
INVAR-38, Run: 051, F, 0, 0, 43, 12, 62, 19
INVAR-38, Run: 052, F, 0, 0, 43, 12, 62, 19
INVAR-38, Run: 053, F, 0, 0, 39, 10, 60, 21
INVAR-38, Run: 054, F, 0, 0, 31, 6, 56, 25
INVAR-38, Run: 055, F, 0, 0, 35, 8, 58, 23
INVAR-38, Run: 056, F, 0, 0, 43, 12, 62, 19
INVAR-38, Run: 057, F, 0, 0, 37, 9, 59, 22
INVAR-38, Run: 058, F, 0, 0, 31, 6, 56, 25
INVAR-38, Run: 059, F, 0, 0, 35, 8, 58, 23
INVAR-38, Run: 060, F, 0, 0, 41, 11, 61, 20
INVAR-38, Run: 061, F, 0, 0, 31, 6, 56, 25
INVAR-38, Run: 062, F, 0, 0, 47, 14, 64, 17
INVAR-38, Run: 063, F, 0, 0, 37, 9, 59, 22
INVAR-38, Run: 064, F, 0, 0, 43, 12, 62, 19
INVAR-38, Run: 065, F, 0, 0, 43, 12, 62, 19
INVAR-38, Run: 066, F, 0, 0, 35, 8, 58, 23
INVAR-38, Run: 067, F, 0, 0, 45, 13, 63, 18
INVAR-38, Run: 068, F, 0, 0, 39, 10, 60, 21
INVAR-38, Run: 069, F, 0, 0, 39, 10, 60, 21
INVAR-38, Run: 070, F, 0, 0, 41, 11, 61, 20
INVAR-38, Run: 071, F, 0, 0, 37, 9, 59, 22
INVAR-38, Run: 072, F, 0, 0, 43, 12, 62, 19
INVAR-38, Run: 073, F, 0, 0, 39, 10, 60, 21
INVAR-38, Run: 074, F, 0, 0, 45, 13, 63, 18
INVAR-38, Run: 075, F, 0, 0, 37, 9, 59, 22
INVAR-38, Run: 076, F, 0, 0, 33, 7, 57, 24
INVAR-38, Run: 077, F, 0, 0, 35, 8, 58, 23
INVAR-38, Run: 078, F, 0, 0, 37, 9, 59, 22
INVAR-38, Run: 079, F, 0, 0, 33, 7, 57, 24
INVAR-38, Run: 080, F, 0, 0, 35, 8, 58, 23
INVAR-38, Run: 081, F, 0, 0, 35, 8, 58, 23
INVAR-38, Run: 082, F, 0, 0, 37, 9, 59, 22
INVAR-38, Run: 083, F, 0, 0, 33, 7, 57, 24
INVAR-38, Run: 084, F, 0, 0, 39, 10, 60, 21
INVAR-38, Run: 085, F, 0, 0, 41, 11, 61, 20
INVAR-38, Run: 086, F, 0, 0, 39, 10, 60, 21
INVAR-38, Run: 087, F, 0, 0, 39, 10, 60, 21
INVAR-38, Run: 088, F, 0, 0, 29, 5, 55, 26
INVAR-38, Run: 089, F, 0, 0, 35, 8, 58, 23
INVAR-38, Run: 090, F, 0, 0, 35, 8, 58, 23
INVAR-38, Run: 091, F, 0, 0, 41, 11, 61, 20
INVAR-38, Run: 092, F, 0, 0, 39, 10, 60, 21
INVAR-38, Run: 093, F, 0, 0, 43, 12, 62, 19
INVAR-38, Run: 094, F, 0, 0, 39, 10, 60, 21
INVAR-38, Run: 095, F, 0, 0, 45, 13, 63, 18
INVAR-38, Run: 096, F, 0, 0, 45, 13, 63, 18
INVAR-38, Run: 097, F, 0, 0, 35, 8, 58, 23
INVAR-38, Run: 098, F, 0, 0, 37, 9, 59, 22
INVAR-38, Run: 099, F, 0, 0, 39, 10, 60, 21
INVAR-38, Run: 100, F, 0, 0, 35, 8, 58, 23
INVAR-39, Run: 001, F, 0, 0, 79, 22, 122, 43
INVAR-39, Run: 002, F, 0, 0, 77, 21, 121, 44
INVAR-39, Run: 003, F, 0, 0, 81, 23, 123, 42
INVAR-39, Run: 004, F, 0, 0, 67, 16, 116, 49
INVAR-39, Run: 005, F, 0, 0, 71, 18, 118, 47
INVAR-39, Run: 006, F, 0, 0, 71, 18, 118, 47
INVAR-39, Run: 007, F, 0, 0, 73, 19, 119, 46
INVAR-39, Run: 008, F, 0, 0, 73, 19, 119, 46
INVAR-39, Run: 009, F, 0, 0, 71, 18, 118, 47
INVAR-39, Run: 010, F, 0, 0, 63, 14, 114, 51
INVAR-39, Run: 011, F, 0, 0, 83, 24, 124, 41
INVAR-39, Run: 012, F, 0, 0, 69, 17, 117, 48
INVAR-39, Run: 013, F, 0, 0, 69, 17, 117, 48
INVAR-39, Run: 014, F, 0, 0, 65, 15, 115, 50
INVAR-39, Run: 015, F, 0, 0, 63, 14, 114, 51
INVAR-39, Run: 016, F, 0, 0, 77, 21, 121, 44
INVAR-39, Run: 017, F, 0, 0, 71, 18, 118, 47
INVAR-39, Run: 018, F, 0, 0, 77, 21, 121, 44
INVAR-39, Run: 019, F, 0, 0, 71, 18, 118, 47
INVAR-39, Run: 020, F, 0, 0, 73, 19, 119, 46
INVAR-39, Run: 021, F, 0, 0, 65, 15, 115, 50
INVAR-39, Run: 022, F, 0, 0, 59, 12, 112, 53
INVAR-39, Run: 023, F, 0, 0, 71, 18, 118, 47
INVAR-39, Run: 024, F, 0, 0, 75, 20, 120, 45
INVAR-39, Run: 025, F, 0, 0, 79, 22, 122, 43
INVAR-39, Run: 026, F, 0, 0, 63, 14, 114, 51
INVAR-39, Run: 027, F, 0, 0, 67, 16, 116, 49
INVAR-39, Run: 028, F, 0, 0, 67, 16, 116, 49
INVAR-39, Run: 029, F, 0, 0, 77, 21, 121, 44
INVAR-39, Run: 030, F, 0, 0, 65, 15, 115, 50
INVAR-39, Run: 031, F, 0, 0, 73, 19, 119, 46
INVAR-39, Run: 032, F, 0, 0, 59, 12, 112, 53
INVAR-39, Run: 033, F, 0, 0, 81, 23, 123, 42
INVAR-39, Run: 034, F, 0, 0, 73, 19, 119, 46
INVAR-39, Run: 035, F, 0, 0, 69, 17, 117, 48
INVAR-39, Run: 036, F, 0, 0, 63, 14, 114, 51
INVAR-39, Run: 037, F, 0, 0, 73, 19, 119, 46
INVAR-39, Run: 038, F, 0, 0, 69, 17, 117, 48
INVAR-39, Run: 039, F, 0, 0, 79, 22, 122, 43
INVAR-39, Run: 040, F, 0, 0, 73, 19, 119, 46
INVAR-39, Run: 041, F, 0, 0, 65, 15, 115, 50
INVAR-39, Run: 042, F, 0, 0, 65, 15, 115, 50
INVAR-39, Run: 043, F, 0, 0, 83, 24, 124, 41
INVAR-39, Run: 044, F, 0, 0, 63, 14, 114, 51
INVAR-39, Run: 045, F, 0, 0, 69, 17, 117, 48
INVAR-39, Run: 046, F, 0, 0, 67, 16, 116, 49
INVAR-39, Run: 047, F, 0, 0, 75, 20, 120, 45
INVAR-39, Run: 048, F, 0, 0, 71, 18, 118, 47
INVAR-39, Run: 049, F, 0, 0, 67, 16, 116, 49
INVAR-39, Run: 050, F, 0, 0, 67, 16, 116, 49
INVAR-39, Run: 051, F, 0, 0, 71, 18, 118, 47
INVAR-39, Run: 052, F, 0, 0, 75, 20, 120, 45
INVAR-39, Run: 053, F, 0, 0, 63, 14, 114, 51
INVAR-39, Run: 054, F, 0, 0, 63, 14, 114, 51
INVAR-39, Run: 055, F, 0, 0, 77, 21, 121, 44
INVAR-39, Run: 056, F, 0, 0, 67, 16, 116, 49
INVAR-39, Run: 057, F, 0, 0, 71, 18, 118, 47
INVAR-39, Run: 058, F, 0, 0, 65, 15, 115, 50
INVAR-39, Run: 059, F, 0, 0, 69, 17, 117, 48
INVAR-39, Run: 060, F, 0, 0, 79, 22, 122, 43
INVAR-39, Run: 061, F, 0, 0, 73, 19, 119, 46
INVAR-39, Run: 062, F, 0, 0, 79, 22, 122, 43
INVAR-39, Run: 063, F, 0, 0, 73, 19, 119, 46
INVAR-39, Run: 064, F, 0, 0, 81, 23, 123, 42
INVAR-39, Run: 065, F, 0, 0, 65, 15, 115, 50
INVAR-39, Run: 066, F, 0, 0, 63, 14, 114, 51
INVAR-39, Run: 067, F, 0, 0, 79, 22, 122, 43
INVAR-39, Run: 068, F, 0, 0, 79, 22, 122, 43
INVAR-39, Run: 069, F, 0, 0, 73, 19, 119, 46
INVAR-39, Run: 070, F, 0, 0, 77, 21, 121, 44
INVAR-39, Run: 071, F, 0, 0, 65, 15, 115, 50
INVAR-39, Run: 072, F, 0, 0, 71, 18, 118, 47
INVAR-39, Run: 073, F, 0, 0, 55, 10, 110, 55
INVAR-39, Run: 074, F, 0, 0, 75, 20, 120, 45
INVAR-39, Run: 075, F, 0, 0, 69, 17, 117, 48
INVAR-39, Run: 076, F, 0, 0, 73, 19, 119, 46
INVAR-39, Run: 077, F, 0, 0, 71, 18, 118, 47
INVAR-39, Run: 078, F, 0, 0, 67, 16, 116, 49
INVAR-39, Run: 079, F, 0, 0, 67, 16, 116, 49
INVAR-39, Run: 080, F, 0, 0, 75, 20, 120, 45
INVAR-39, Run: 081, F, 0, 0, 81, 23, 123, 42
INVAR-39, Run: 082, F, 0, 0, 81, 23, 123, 42
INVAR-39, Run: 083, F, 0, 0, 69, 17, 117, 48
INVAR-39, Run: 084, F, 0, 0, 71, 18, 118, 47
INVAR-39, Run: 085, F, 0, 0, 73, 19, 119, 46
INVAR-39, Run: 086, F, 0, 0, 73, 19, 119, 46
INVAR-39, Run: 087, F, 0, 0, 61, 13, 113, 52
INVAR-39, Run: 088, F, 0, 0, 73, 19, 119, 46
INVAR-39, Run: 089, F, 0, 0, 71, 18, 118, 47
INVAR-39, Run: 090, F, 0, 0, 85, 25, 125, 40
INVAR-39, Run: 091, F, 0, 0, 75, 20, 120, 45
INVAR-39, Run: 092, F, 0, 0, 71, 18, 118, 47
INVAR-39, Run: 093, F, 0, 0, 73, 19, 119, 46
INVAR-39, Run: 094, F, 0, 0, 79, 22, 122, 43
INVAR-39, Run: 095, F, 0, 0, 67, 16, 116, 49
INVAR-39, Run: 096, F, 0, 0, 59, 12, 112, 53
INVAR-39, Run: 097, F, 0, 0, 77, 21, 121, 44
INVAR-39, Run: 098, F, 0, 0, 79, 22, 122, 43
INVAR-39, Run: 099, F, 0, 0, 77, 21, 121, 44
INVAR-39, Run: 100, F, 0, 0, 67, 16, 116, 49
INVAR-4, Run: 001, F, 0, 0, 45, 3, 52, 7
INVAR-4, Run: 002, F, 0, 0, 45, 3, 52, 7
INVAR-4, Run: 003, P, 0, 0, 39, 0, 49, 10
INVAR-4, Run: 004, F, 0, 0, 41, 1, 50, 9
INVAR-4, Run: 005, F, 0, 0, 43, 2, 51, 8
INVAR-4, Run: 006, F, 0, 0, 43, 2, 51, 8
INVAR-4, Run: 007, F, 0, 0, 43, 2, 51, 8
INVAR-4, Run: 008, F, 0, 0, 41, 1, 50, 9
INVAR-4, Run: 009, F, 0, 0, 45, 3, 52, 7
INVAR-4, Run: 010, F, 0, 0, 43, 2, 51, 8
INVAR-4, Run: 011, F, 0, 0, 41, 1, 50, 9
INVAR-4, Run: 012, F, 0, 0, 41, 1, 50, 9
INVAR-4, Run: 013, F, 0, 0, 41, 1, 50, 9
INVAR-4, Run: 014, F, 0, 0, 43, 2, 51, 8
INVAR-4, Run: 015, F, 0, 0, 43, 2, 51, 8
INVAR-4, Run: 016, F, 0, 0, 47, 4, 53, 6
INVAR-4, Run: 017, F, 0, 0, 47, 4, 53, 6
INVAR-4, Run: 018, F, 0, 0, 41, 1, 50, 9
INVAR-4, Run: 019, F, 0, 0, 41, 1, 50, 9
INVAR-4, Run: 020, F, 0, 0, 43, 2, 51, 8
INVAR-4, Run: 021, F, 0, 0, 41, 1, 50, 9
INVAR-4, Run: 022, F, 0, 0, 45, 3, 52, 7
INVAR-4, Run: 023, F, 0, 0, 45, 3, 52, 7
INVAR-4, Run: 024, F, 0, 0, 47, 4, 53, 6
INVAR-4, Run: 025, P, 0, 0, 39, 0, 49, 10
INVAR-4, Run: 026, F, 0, 0, 45, 3, 52, 7
INVAR-4, Run: 027, F, 0, 0, 41, 1, 50, 9
INVAR-4, Run: 028, F, 0, 0, 47, 4, 53, 6
INVAR-4, Run: 029, F, 0, 0, 47, 4, 53, 6
INVAR-4, Run: 030, F, 0, 0, 41, 1, 50, 9
INVAR-4, Run: 031, F, 0, 0, 41, 1, 50, 9
INVAR-4, Run: 032, F, 0, 0, 47, 4, 53, 6
INVAR-4, Run: 033, F, 0, 0, 43, 2, 51, 8
INVAR-4, Run: 034, F, 0, 0, 43, 2, 51, 8
INVAR-4, Run: 035, F, 0, 0, 45, 3, 52, 7
INVAR-4, Run: 036, F, 0, 0, 45, 3, 52, 7
INVAR-4, Run: 037, F, 0, 0, 41, 1, 50, 9
INVAR-4, Run: 038, F, 0, 0, 41, 1, 50, 9
INVAR-4, Run: 039, F, 0, 0, 41, 1, 50, 9
INVAR-4, Run: 040, F, 0, 0, 45, 3, 52, 7
INVAR-4, Run: 041, F, 0, 0, 41, 1, 50, 9
INVAR-4, Run: 042, F, 0, 0, 45, 3, 52, 7
INVAR-4, Run: 043, F, 0, 0, 45, 3, 52, 7
INVAR-4, Run: 044, P, 0, 0, 39, 0, 49, 10
INVAR-4, Run: 045, F, 0, 0, 45, 3, 52, 7
INVAR-4, Run: 046, F, 0, 0, 41, 1, 50, 9
INVAR-4, Run: 047, F, 0, 0, 41, 1, 50, 9
INVAR-4, Run: 048, F, 0, 0, 45, 3, 52, 7
INVAR-4, Run: 049, F, 0, 0, 41, 1, 50, 9
INVAR-4, Run: 050, F, 0, 0, 41, 1, 50, 9
INVAR-4, Run: 051, F, 0, 0, 43, 2, 51, 8
INVAR-4, Run: 052, F, 0, 0, 49, 5, 54, 5
INVAR-4, Run: 053, F, 0, 0, 41, 1, 50, 9
INVAR-4, Run: 054, F, 0, 0, 43, 2, 51, 8
INVAR-4, Run: 055, F, 0, 0, 45, 3, 52, 7
INVAR-4, Run: 056, F, 0, 0, 43, 2, 51, 8
INVAR-4, Run: 057, F, 0, 0, 45, 3, 52, 7
INVAR-4, Run: 058, F, 0, 0, 43, 2, 51, 8
INVAR-4, Run: 059, F, 0, 0, 43, 2, 51, 8
INVAR-4, Run: 060, F, 0, 0, 41, 1, 50, 9
INVAR-4, Run: 061, F, 0, 0, 45, 3, 52, 7
INVAR-4, Run: 062, F, 0, 0, 47, 4, 53, 6
INVAR-4, Run: 063, F, 0, 0, 45, 3, 52, 7
INVAR-4, Run: 064, F, 0, 0, 41, 1, 50, 9
INVAR-4, Run: 065, F, 0, 0, 41, 1, 50, 9
INVAR-4, Run: 066, F, 0, 0, 45, 3, 52, 7
INVAR-4, Run: 067, F, 0, 0, 45, 3, 52, 7
INVAR-4, Run: 068, F, 0, 0, 45, 3, 52, 7
INVAR-4, Run: 069, F, 0, 0, 43, 2, 51, 8
INVAR-4, Run: 070, F, 0, 0, 43, 2, 51, 8
INVAR-4, Run: 071, F, 0, 0, 43, 2, 51, 8
INVAR-4, Run: 072, F, 0, 0, 43, 2, 51, 8
INVAR-4, Run: 073, P, 0, 0, 39, 0, 49, 10
INVAR-4, Run: 074, F, 0, 0, 41, 1, 50, 9
INVAR-4, Run: 075, F, 0, 0, 41, 1, 50, 9
INVAR-4, Run: 076, F, 0, 0, 43, 2, 51, 8
INVAR-4, Run: 077, F, 0, 0, 41, 1, 50, 9
INVAR-4, Run: 078, F, 0, 0, 41, 1, 50, 9
INVAR-4, Run: 079, F, 0, 0, 47, 4, 53, 6
INVAR-4, Run: 080, F, 0, 0, 41, 1, 50, 9
INVAR-4, Run: 081, F, 0, 0, 45, 3, 52, 7
INVAR-4, Run: 082, F, 0, 0, 45, 3, 52, 7
INVAR-4, Run: 083, F, 0, 0, 45, 3, 52, 7
INVAR-4, Run: 084, F, 0, 0, 41, 1, 50, 9
INVAR-4, Run: 085, F, 0, 0, 49, 5, 54, 5
INVAR-4, Run: 086, P, 0, 0, 39, 0, 49, 10
INVAR-4, Run: 087, F, 0, 0, 41, 1, 50, 9
INVAR-4, Run: 088, F, 0, 0, 49, 5, 54, 5
INVAR-4, Run: 089, P, 0, 0, 39, 0, 49, 10
INVAR-4, Run: 090, F, 0, 0, 41, 1, 50, 9
INVAR-4, Run: 091, P, 0, 0, 39, 0, 49, 10
INVAR-4, Run: 092, F, 0, 0, 45, 3, 52, 7
INVAR-4, Run: 093, F, 0, 0, 41, 1, 50, 9
INVAR-4, Run: 094, F, 0, 0, 41, 1, 50, 9
INVAR-4, Run: 095, F, 0, 0, 43, 2, 51, 8
INVAR-4, Run: 096, F, 0, 0, 43, 2, 51, 8
INVAR-4, Run: 097, P, 0, 0, 39, 0, 49, 10
INVAR-4, Run: 098, F, 0, 0, 47, 4, 53, 6
INVAR-4, Run: 099, F, 0, 0, 43, 2, 51, 8
INVAR-4, Run: 100, F, 0, 0, 43, 2, 51, 8
INVAR-40, Run: 001, F, 0, 0, 135, 32, 232, 97
INVAR-40, Run: 002, F, 0, 0, 133, 31, 231, 98
INVAR-40, Run: 003, F, 0, 0, 149, 39, 239, 90
INVAR-40, Run: 004, F, 0, 0, 135, 32, 232, 97
INVAR-40, Run: 005, F, 0, 0, 147, 38, 238, 91
INVAR-40, Run: 006, F, 0, 0, 139, 34, 234, 95
INVAR-40, Run: 007, F, 0, 0, 145, 37, 237, 92
INVAR-40, Run: 008, F, 0, 0, 133, 31, 231, 98
INVAR-40, Run: 009, F, 0, 0, 151, 40, 240, 89
INVAR-40, Run: 010, F, 0, 0, 123, 26, 226, 103
INVAR-40, Run: 011, F, 0, 0, 141, 35, 235, 94
INVAR-40, Run: 012, F, 0, 0, 137, 33, 233, 96
INVAR-40, Run: 013, F, 0, 0, 145, 37, 237, 92
INVAR-40, Run: 014, F, 0, 0, 147, 38, 238, 91
INVAR-40, Run: 015, F, 0, 0, 137, 33, 233, 96
INVAR-40, Run: 016, F, 0, 0, 141, 35, 235, 94
INVAR-40, Run: 017, F, 0, 0, 133, 31, 231, 98
INVAR-40, Run: 018, F, 0, 0, 145, 37, 237, 92
INVAR-40, Run: 019, F, 0, 0, 147, 38, 238, 91
INVAR-40, Run: 020, F, 0, 0, 143, 36, 236, 93
INVAR-40, Run: 021, F, 0, 0, 131, 30, 230, 99
INVAR-40, Run: 022, F, 0, 0, 149, 39, 239, 90
INVAR-40, Run: 023, F, 0, 0, 153, 41, 241, 88
INVAR-40, Run: 024, F, 0, 0, 129, 29, 229, 100
INVAR-40, Run: 025, F, 0, 0, 133, 31, 231, 98
INVAR-40, Run: 026, F, 0, 0, 133, 31, 231, 98
INVAR-40, Run: 027, F, 0, 0, 145, 37, 237, 92
INVAR-40, Run: 028, F, 0, 0, 141, 35, 235, 94
INVAR-40, Run: 029, F, 0, 0, 143, 36, 236, 93
INVAR-40, Run: 030, F, 0, 0, 129, 29, 229, 100
INVAR-40, Run: 031, F, 0, 0, 135, 32, 232, 97
INVAR-40, Run: 032, F, 0, 0, 143, 36, 236, 93
INVAR-40, Run: 033, F, 0, 0, 141, 35, 235, 94
INVAR-40, Run: 034, F, 0, 0, 141, 35, 235, 94
INVAR-40, Run: 035, F, 0, 0, 145, 37, 237, 92
INVAR-40, Run: 036, F, 0, 0, 135, 32, 232, 97
INVAR-40, Run: 037, F, 0, 0, 151, 40, 240, 89
INVAR-40, Run: 038, F, 0, 0, 133, 31, 231, 98
INVAR-40, Run: 039, F, 0, 0, 123, 26, 226, 103
INVAR-40, Run: 040, F, 0, 0, 133, 31, 231, 98
INVAR-40, Run: 041, F, 0, 0, 151, 40, 240, 89
INVAR-40, Run: 042, F, 0, 0, 141, 35, 235, 94
INVAR-40, Run: 043, F, 0, 0, 135, 32, 232, 97
INVAR-40, Run: 044, F, 0, 0, 139, 34, 234, 95
INVAR-40, Run: 045, F, 0, 0, 157, 43, 243, 86
INVAR-40, Run: 046, F, 0, 0, 131, 30, 230, 99
INVAR-40, Run: 047, F, 0, 0, 151, 40, 240, 89
INVAR-40, Run: 048, F, 0, 0, 139, 34, 234, 95
INVAR-40, Run: 049, F, 0, 0, 133, 31, 231, 98
INVAR-40, Run: 050, F, 0, 0, 147, 38, 238, 91
INVAR-40, Run: 051, F, 0, 0, 129, 29, 229, 100
INVAR-40, Run: 052, F, 0, 0, 129, 29, 229, 100
INVAR-40, Run: 053, F, 0, 0, 143, 36, 236, 93
INVAR-40, Run: 054, F, 0, 0, 135, 32, 232, 97
INVAR-40, Run: 055, F, 0, 0, 135, 32, 232, 97
INVAR-40, Run: 056, F, 0, 0, 133, 31, 231, 98
INVAR-40, Run: 057, F, 0, 0, 133, 31, 231, 98
INVAR-40, Run: 058, F, 0, 0, 155, 42, 242, 87
INVAR-40, Run: 059, F, 0, 0, 125, 27, 227, 102
INVAR-40, Run: 060, F, 0, 0, 133, 31, 231, 98
INVAR-40, Run: 061, F, 0, 0, 141, 35, 235, 94
INVAR-40, Run: 062, F, 0, 0, 143, 36, 236, 93
INVAR-40, Run: 063, F, 0, 0, 119, 24, 224, 105
INVAR-40, Run: 064, F, 0, 0, 149, 39, 239, 90
INVAR-40, Run: 065, F, 0, 0, 153, 41, 241, 88
INVAR-40, Run: 066, F, 0, 0, 129, 29, 229, 100
INVAR-40, Run: 067, F, 0, 0, 131, 30, 230, 99
INVAR-40, Run: 068, F, 0, 0, 131, 30, 230, 99
INVAR-40, Run: 069, F, 0, 0, 141, 35, 235, 94
INVAR-40, Run: 070, F, 0, 0, 127, 28, 228, 101
INVAR-40, Run: 071, F, 0, 0, 133, 31, 231, 98
INVAR-40, Run: 072, F, 0, 0, 135, 32, 232, 97
INVAR-40, Run: 073, F, 0, 0, 145, 37, 237, 92
INVAR-40, Run: 074, F, 0, 0, 143, 36, 236, 93
INVAR-40, Run: 075, F, 0, 0, 141, 35, 235, 94
INVAR-40, Run: 076, F, 0, 0, 145, 37, 237, 92
INVAR-40, Run: 077, F, 0, 0, 135, 32, 232, 97
INVAR-40, Run: 078, F, 0, 0, 145, 37, 237, 92
INVAR-40, Run: 079, F, 0, 0, 145, 37, 237, 92
INVAR-40, Run: 080, F, 0, 0, 141, 35, 235, 94
INVAR-40, Run: 081, F, 0, 0, 135, 32, 232, 97
INVAR-40, Run: 082, F, 0, 0, 145, 37, 237, 92
INVAR-40, Run: 083, F, 0, 0, 137, 33, 233, 96
INVAR-40, Run: 084, F, 0, 0, 141, 35, 235, 94
INVAR-40, Run: 085, F, 0, 0, 121, 25, 225, 104
INVAR-40, Run: 086, F, 0, 0, 121, 25, 225, 104
INVAR-40, Run: 087, F, 0, 0, 145, 37, 237, 92
INVAR-40, Run: 088, F, 0, 0, 121, 25, 225, 104
INVAR-40, Run: 089, F, 0, 0, 127, 28, 228, 101
INVAR-40, Run: 090, F, 0, 0, 141, 35, 235, 94
INVAR-40, Run: 091, F, 0, 0, 155, 42, 242, 87
INVAR-40, Run: 092, F, 0, 0, 139, 34, 234, 95
INVAR-40, Run: 093, F, 0, 0, 143, 36, 236, 93
INVAR-40, Run: 094, F, 0, 0, 145, 37, 237, 92
INVAR-40, Run: 095, F, 0, 0, 141, 35, 235, 94
INVAR-40, Run: 096, F, 0, 0, 139, 34, 234, 95
INVAR-40, Run: 097, F, 0, 0, 135, 32, 232, 97
INVAR-40, Run: 098, F, 0, 0, 139, 34, 234, 95
INVAR-40, Run: 099, F, 0, 0, 133, 31, 231, 98
INVAR-40, Run: 100, F, 0, 0, 127, 28, 228, 101
INVAR-41, Run: 001, P, 0, 0, 50, 0, 50, 0
INVAR-41, Run: 002, P, 0, 0, 50, 0, 50, 0
INVAR-41, Run: 003, P, 0, 0, 50, 0, 50, 0
INVAR-41, Run: 004, P, 0, 0, 50, 0, 50, 0
INVAR-41, Run: 005, P, 0, 0, 50, 0, 50, 0
INVAR-41, Run: 006, P, 0, 0, 50, 0, 50, 0
INVAR-41, Run: 007, P, 0, 0, 50, 0, 50, 0
INVAR-41, Run: 008, P, 0, 0, 50, 0, 50, 0
INVAR-41, Run: 009, P, 0, 0, 50, 0, 50, 0
INVAR-41, Run: 010, P, 0, 0, 50, 0, 50, 0
INVAR-41, Run: 011, P, 0, 0, 50, 0, 50, 0
INVAR-41, Run: 012, P, 0, 0, 50, 0, 50, 0
INVAR-41, Run: 013, P, 0, 0, 50, 0, 50, 0
INVAR-41, Run: 014, P, 0, 0, 50, 0, 50, 0
INVAR-41, Run: 015, P, 0, 0, 50, 0, 50, 0
INVAR-41, Run: 016, P, 0, 0, 50, 0, 50, 0
INVAR-41, Run: 017, P, 0, 0, 50, 0, 50, 0
INVAR-41, Run: 018, P, 0, 0, 50, 0, 50, 0
INVAR-41, Run: 019, P, 0, 0, 50, 0, 50, 0
INVAR-41, Run: 020, P, 0, 0, 50, 0, 50, 0
INVAR-41, Run: 021, P, 0, 0, 50, 0, 50, 0
INVAR-41, Run: 022, P, 0, 0, 50, 0, 50, 0
INVAR-41, Run: 023, P, 0, 0, 50, 0, 50, 0
INVAR-41, Run: 024, P, 0, 0, 50, 0, 50, 0
INVAR-41, Run: 025, P, 0, 0, 50, 0, 50, 0
INVAR-41, Run: 026, P, 0, 0, 50, 0, 50, 0
INVAR-41, Run: 027, P, 0, 0, 50, 0, 50, 0
INVAR-41, Run: 028, P, 0, 0, 50, 0, 50, 0
INVAR-41, Run: 029, P, 0, 0, 50, 0, 50, 0
INVAR-41, Run: 030, P, 0, 0, 50, 0, 50, 0
INVAR-41, Run: 031, P, 0, 0, 50, 0, 50, 0
INVAR-41, Run: 032, P, 0, 0, 50, 0, 50, 0
INVAR-41, Run: 033, P, 0, 0, 50, 0, 50, 0
INVAR-41, Run: 034, P, 0, 0, 50, 0, 50, 0
INVAR-41, Run: 035, P, 0, 0, 50, 0, 50, 0
INVAR-41, Run: 036, P, 0, 0, 50, 0, 50, 0
INVAR-41, Run: 037, P, 0, 0, 50, 0, 50, 0
INVAR-41, Run: 038, P, 0, 0, 50, 0, 50, 0
INVAR-41, Run: 039, P, 0, 0, 50, 0, 50, 0
INVAR-41, Run: 040, P, 0, 0, 50, 0, 50, 0
INVAR-41, Run: 041, P, 0, 0, 50, 0, 50, 0
INVAR-41, Run: 042, P, 0, 0, 50, 0, 50, 0
INVAR-41, Run: 043, P, 0, 0, 50, 0, 50, 0
INVAR-41, Run: 044, P, 0, 0, 50, 0, 50, 0
INVAR-41, Run: 045, P, 0, 0, 50, 0, 50, 0
INVAR-41, Run: 046, P, 0, 0, 50, 0, 50, 0
INVAR-41, Run: 047, P, 0, 0, 50, 0, 50, 0
INVAR-41, Run: 048, P, 0, 0, 50, 0, 50, 0
INVAR-41, Run: 049, P, 0, 0, 50, 0, 50, 0
INVAR-41, Run: 050, P, 0, 0, 50, 0, 50, 0
INVAR-41, Run: 051, P, 0, 0, 50, 0, 50, 0
INVAR-41, Run: 052, P, 0, 0, 50, 0, 50, 0
INVAR-41, Run: 053, P, 0, 0, 50, 0, 50, 0
INVAR-41, Run: 054, P, 0, 0, 50, 0, 50, 0
INVAR-41, Run: 055, P, 0, 0, 50, 0, 50, 0
INVAR-41, Run: 056, P, 0, 0, 50, 0, 50, 0
INVAR-41, Run: 057, P, 0, 0, 50, 0, 50, 0
INVAR-41, Run: 058, P, 0, 0, 50, 0, 50, 0
INVAR-41, Run: 059, P, 0, 0, 50, 0, 50, 0
INVAR-41, Run: 060, P, 0, 0, 50, 0, 50, 0
INVAR-41, Run: 061, P, 0, 0, 50, 0, 50, 0
INVAR-41, Run: 062, P, 0, 0, 50, 0, 50, 0
INVAR-41, Run: 063, P, 0, 0, 50, 0, 50, 0
INVAR-41, Run: 064, P, 0, 0, 50, 0, 50, 0
INVAR-41, Run: 065, P, 0, 0, 50, 0, 50, 0
INVAR-41, Run: 066, P, 0, 0, 50, 0, 50, 0
INVAR-41, Run: 067, P, 0, 0, 50, 0, 50, 0
INVAR-41, Run: 068, P, 0, 0, 50, 0, 50, 0
INVAR-41, Run: 069, P, 0, 0, 50, 0, 50, 0
INVAR-41, Run: 070, P, 0, 0, 50, 0, 50, 0
INVAR-41, Run: 071, P, 0, 0, 50, 0, 50, 0
INVAR-41, Run: 072, P, 0, 0, 50, 0, 50, 0
INVAR-41, Run: 073, P, 0, 0, 50, 0, 50, 0
INVAR-41, Run: 074, P, 0, 0, 50, 0, 50, 0
INVAR-41, Run: 075, P, 0, 0, 50, 0, 50, 0
INVAR-41, Run: 076, P, 0, 0, 50, 0, 50, 0
INVAR-41, Run: 077, P, 0, 0, 50, 0, 50, 0
INVAR-41, Run: 078, P, 0, 0, 50, 0, 50, 0
INVAR-41, Run: 079, P, 0, 0, 50, 0, 50, 0
INVAR-41, Run: 080, P, 0, 0, 50, 0, 50, 0
INVAR-41, Run: 081, P, 0, 0, 50, 0, 50, 0
INVAR-41, Run: 082, P, 0, 0, 50, 0, 50, 0
INVAR-41, Run: 083, P, 0, 0, 50, 0, 50, 0
INVAR-41, Run: 084, P, 0, 0, 50, 0, 50, 0
INVAR-41, Run: 085, P, 0, 0, 50, 0, 50, 0
INVAR-41, Run: 086, P, 0, 0, 50, 0, 50, 0
INVAR-41, Run: 087, P, 0, 0, 50, 0, 50, 0
INVAR-41, Run: 088, P, 0, 0, 50, 0, 50, 0
INVAR-41, Run: 089, P, 0, 0, 50, 0, 50, 0
INVAR-41, Run: 090, P, 0, 0, 50, 0, 50, 0
INVAR-41, Run: 091, P, 0, 0, 50, 0, 50, 0
INVAR-41, Run: 092, P, 0, 0, 50, 0, 50, 0
INVAR-41, Run: 093, P, 0, 0, 50, 0, 50, 0
INVAR-41, Run: 094, P, 0, 0, 50, 0, 50, 0
INVAR-41, Run: 095, P, 0, 0, 50, 0, 50, 0
INVAR-41, Run: 096, P, 0, 0, 50, 0, 50, 0
INVAR-41, Run: 097, P, 0, 0, 50, 0, 50, 0
INVAR-41, Run: 098, P, 0, 0, 50, 0, 50, 0
INVAR-41, Run: 099, P, 0, 0, 50, 0, 50, 0
INVAR-41, Run: 100, P, 0, 0, 50, 0, 50, 0
INVAR-42, Run: 001, P, 0, 0, 100, 0, 100, 0
INVAR-42, Run: 002, P, 0, 0, 100, 0, 100, 0
INVAR-42, Run: 003, P, 0, 0, 100, 0, 100, 0
INVAR-42, Run: 004, P, 0, 0, 100, 0, 100, 0
INVAR-42, Run: 005, P, 0, 0, 100, 0, 100, 0
INVAR-42, Run: 006, P, 0, 0, 100, 0, 100, 0
INVAR-42, Run: 007, P, 0, 0, 100, 0, 100, 0
INVAR-42, Run: 008, P, 0, 0, 100, 0, 100, 0
INVAR-42, Run: 009, P, 0, 0, 100, 0, 100, 0
INVAR-42, Run: 010, P, 0, 0, 100, 0, 100, 0
INVAR-42, Run: 011, P, 0, 0, 100, 0, 100, 0
INVAR-42, Run: 012, P, 0, 0, 100, 0, 100, 0
INVAR-42, Run: 013, P, 0, 0, 100, 0, 100, 0
INVAR-42, Run: 014, P, 0, 0, 100, 0, 100, 0
INVAR-42, Run: 015, P, 0, 0, 100, 0, 100, 0
INVAR-42, Run: 016, P, 0, 0, 100, 0, 100, 0
INVAR-42, Run: 017, P, 0, 0, 100, 0, 100, 0
INVAR-42, Run: 018, P, 0, 0, 100, 0, 100, 0
INVAR-42, Run: 019, P, 0, 0, 100, 0, 100, 0
INVAR-42, Run: 020, P, 0, 0, 100, 0, 100, 0
INVAR-42, Run: 021, P, 0, 0, 100, 0, 100, 0
INVAR-42, Run: 022, P, 0, 0, 100, 0, 100, 0
INVAR-42, Run: 023, P, 0, 0, 100, 0, 100, 0
INVAR-42, Run: 024, P, 0, 0, 100, 0, 100, 0
INVAR-42, Run: 025, P, 0, 0, 100, 0, 100, 0
INVAR-42, Run: 026, P, 0, 0, 100, 0, 100, 0
INVAR-42, Run: 027, P, 0, 0, 100, 0, 100, 0
INVAR-42, Run: 028, P, 0, 0, 100, 0, 100, 0
INVAR-42, Run: 029, P, 0, 0, 100, 0, 100, 0
INVAR-42, Run: 030, P, 0, 0, 100, 0, 100, 0
INVAR-42, Run: 031, P, 0, 0, 100, 0, 100, 0
INVAR-42, Run: 032, P, 0, 0, 100, 0, 100, 0
INVAR-42, Run: 033, P, 0, 0, 100, 0, 100, 0
INVAR-42, Run: 034, P, 0, 0, 100, 0, 100, 0
INVAR-42, Run: 035, P, 0, 0, 100, 0, 100, 0
INVAR-42, Run: 036, P, 0, 0, 100, 0, 100, 0
INVAR-42, Run: 037, P, 0, 0, 100, 0, 100, 0
INVAR-42, Run: 038, P, 0, 0, 100, 0, 100, 0
INVAR-42, Run: 039, P, 0, 0, 100, 0, 100, 0
INVAR-42, Run: 040, P, 0, 0, 100, 0, 100, 0
INVAR-42, Run: 041, P, 0, 0, 100, 0, 100, 0
INVAR-42, Run: 042, P, 0, 0, 100, 0, 100, 0
INVAR-42, Run: 043, P, 0, 0, 100, 0, 100, 0
INVAR-42, Run: 044, P, 0, 0, 100, 0, 100, 0
INVAR-42, Run: 045, P, 0, 0, 100, 0, 100, 0
INVAR-42, Run: 046, P, 0, 0, 100, 0, 100, 0
INVAR-42, Run: 047, P, 0, 0, 100, 0, 100, 0
INVAR-42, Run: 048, P, 0, 0, 100, 0, 100, 0
INVAR-42, Run: 049, P, 0, 0, 100, 0, 100, 0
INVAR-42, Run: 050, P, 0, 0, 100, 0, 100, 0
INVAR-42, Run: 051, P, 0, 0, 100, 0, 100, 0
INVAR-42, Run: 052, P, 0, 0, 100, 0, 100, 0
INVAR-42, Run: 053, P, 0, 0, 100, 0, 100, 0
INVAR-42, Run: 054, P, 0, 0, 100, 0, 100, 0
INVAR-42, Run: 055, P, 0, 0, 100, 0, 100, 0
INVAR-42, Run: 056, P, 0, 0, 100, 0, 100, 0
INVAR-42, Run: 057, P, 0, 0, 100, 0, 100, 0
INVAR-42, Run: 058, P, 0, 0, 100, 0, 100, 0
INVAR-42, Run: 059, P, 0, 0, 100, 0, 100, 0
INVAR-42, Run: 060, P, 0, 0, 100, 0, 100, 0
INVAR-42, Run: 061, P, 0, 0, 100, 0, 100, 0
INVAR-42, Run: 062, P, 0, 0, 100, 0, 100, 0
INVAR-42, Run: 063, P, 0, 0, 100, 0, 100, 0
INVAR-42, Run: 064, P, 0, 0, 100, 0, 100, 0
INVAR-42, Run: 065, P, 0, 0, 100, 0, 100, 0
INVAR-42, Run: 066, P, 0, 0, 100, 0, 100, 0
INVAR-42, Run: 067, P, 0, 0, 100, 0, 100, 0
INVAR-42, Run: 068, P, 0, 0, 100, 0, 100, 0
INVAR-42, Run: 069, P, 0, 0, 100, 0, 100, 0
INVAR-42, Run: 070, P, 0, 0, 100, 0, 100, 0
INVAR-42, Run: 071, P, 0, 0, 100, 0, 100, 0
INVAR-42, Run: 072, P, 0, 0, 100, 0, 100, 0
INVAR-42, Run: 073, P, 0, 0, 100, 0, 100, 0
INVAR-42, Run: 074, P, 0, 0, 100, 0, 100, 0
INVAR-42, Run: 075, P, 0, 0, 100, 0, 100, 0
INVAR-42, Run: 076, P, 0, 0, 100, 0, 100, 0
INVAR-42, Run: 077, P, 0, 0, 100, 0, 100, 0
INVAR-42, Run: 078, P, 0, 0, 100, 0, 100, 0
INVAR-42, Run: 079, P, 0, 0, 100, 0, 100, 0
INVAR-42, Run: 080, P, 0, 0, 100, 0, 100, 0
INVAR-42, Run: 081, P, 0, 0, 100, 0, 100, 0
INVAR-42, Run: 082, P, 0, 0, 100, 0, 100, 0
INVAR-42, Run: 083, P, 0, 0, 100, 0, 100, 0
INVAR-42, Run: 084, P, 0, 0, 100, 0, 100, 0
INVAR-42, Run: 085, P, 0, 0, 100, 0, 100, 0
INVAR-42, Run: 086, P, 0, 0, 100, 0, 100, 0
INVAR-42, Run: 087, P, 0, 0, 100, 0, 100, 0
INVAR-42, Run: 088, P, 0, 0, 100, 0, 100, 0
INVAR-42, Run: 089, P, 0, 0, 100, 0, 100, 0
INVAR-42, Run: 090, P, 0, 0, 100, 0, 100, 0
INVAR-42, Run: 091, P, 0, 0, 100, 0, 100, 0
INVAR-42, Run: 092, P, 0, 0, 100, 0, 100, 0
INVAR-42, Run: 093, P, 0, 0, 100, 0, 100, 0
INVAR-42, Run: 094, P, 0, 0, 100, 0, 100, 0
INVAR-42, Run: 095, P, 0, 0, 100, 0, 100, 0
INVAR-42, Run: 096, P, 0, 0, 100, 0, 100, 0
INVAR-42, Run: 097, P, 0, 0, 100, 0, 100, 0
INVAR-42, Run: 098, P, 0, 0, 100, 0, 100, 0
INVAR-42, Run: 099, P, 0, 0, 100, 0, 100, 0
INVAR-42, Run: 100, P, 0, 0, 100, 0, 100, 0
INVAR-43, Run: 001, P, 0, 0, 200, 0, 200, 0
INVAR-43, Run: 002, P, 0, 0, 200, 0, 200, 0
INVAR-43, Run: 003, P, 0, 0, 200, 0, 200, 0
INVAR-43, Run: 004, P, 0, 0, 200, 0, 200, 0
INVAR-43, Run: 005, P, 0, 0, 200, 0, 200, 0
INVAR-43, Run: 006, P, 0, 0, 200, 0, 200, 0
INVAR-43, Run: 007, P, 0, 0, 200, 0, 200, 0
INVAR-43, Run: 008, P, 0, 0, 200, 0, 200, 0
INVAR-43, Run: 009, P, 0, 0, 200, 0, 200, 0
INVAR-43, Run: 010, P, 0, 0, 200, 0, 200, 0
INVAR-43, Run: 011, P, 0, 0, 200, 0, 200, 0
INVAR-43, Run: 012, P, 0, 0, 200, 0, 200, 0
INVAR-43, Run: 013, P, 0, 0, 200, 0, 200, 0
INVAR-43, Run: 014, P, 0, 0, 200, 0, 200, 0
INVAR-43, Run: 015, P, 0, 0, 200, 0, 200, 0
INVAR-43, Run: 016, P, 0, 0, 200, 0, 200, 0
INVAR-43, Run: 017, P, 0, 0, 200, 0, 200, 0
INVAR-43, Run: 018, P, 0, 0, 200, 0, 200, 0
INVAR-43, Run: 019, P, 0, 0, 200, 0, 200, 0
INVAR-43, Run: 020, P, 0, 0, 200, 0, 200, 0
INVAR-43, Run: 021, P, 0, 0, 200, 0, 200, 0
INVAR-43, Run: 022, P, 0, 0, 200, 0, 200, 0
INVAR-43, Run: 023, P, 0, 0, 200, 0, 200, 0
INVAR-43, Run: 024, P, 0, 0, 200, 0, 200, 0
INVAR-43, Run: 025, P, 0, 0, 200, 0, 200, 0
INVAR-43, Run: 026, P, 0, 0, 200, 0, 200, 0
INVAR-43, Run: 027, P, 0, 0, 200, 0, 200, 0
INVAR-43, Run: 028, P, 0, 0, 200, 0, 200, 0
INVAR-43, Run: 029, P, 0, 0, 200, 0, 200, 0
INVAR-43, Run: 030, P, 0, 0, 200, 0, 200, 0
INVAR-43, Run: 031, P, 0, 0, 200, 0, 200, 0
INVAR-43, Run: 032, P, 0, 0, 200, 0, 200, 0
INVAR-43, Run: 033, P, 0, 0, 200, 0, 200, 0
INVAR-43, Run: 034, P, 0, 0, 200, 0, 200, 0
INVAR-43, Run: 035, P, 0, 0, 200, 0, 200, 0
INVAR-43, Run: 036, P, 0, 0, 200, 0, 200, 0
INVAR-43, Run: 037, P, 0, 0, 200, 0, 200, 0
INVAR-43, Run: 038, P, 0, 0, 200, 0, 200, 0
INVAR-43, Run: 039, P, 0, 0, 200, 0, 200, 0
INVAR-43, Run: 040, P, 0, 0, 200, 0, 200, 0
INVAR-43, Run: 041, P, 0, 0, 200, 0, 200, 0
INVAR-43, Run: 042, P, 0, 0, 200, 0, 200, 0
INVAR-43, Run: 043, P, 0, 0, 200, 0, 200, 0
INVAR-43, Run: 044, P, 0, 0, 200, 0, 200, 0
INVAR-43, Run: 045, P, 0, 0, 200, 0, 200, 0
INVAR-43, Run: 046, P, 0, 0, 200, 0, 200, 0
INVAR-43, Run: 047, P, 0, 0, 200, 0, 200, 0
INVAR-43, Run: 048, P, 0, 0, 200, 0, 200, 0
INVAR-43, Run: 049, P, 0, 0, 200, 0, 200, 0
INVAR-43, Run: 050, P, 0, 0, 200, 0, 200, 0
INVAR-43, Run: 051, P, 0, 0, 200, 0, 200, 0
INVAR-43, Run: 052, P, 0, 0, 200, 0, 200, 0
INVAR-43, Run: 053, P, 0, 0, 200, 0, 200, 0
INVAR-43, Run: 054, P, 0, 0, 200, 0, 200, 0
INVAR-43, Run: 055, P, 0, 0, 200, 0, 200, 0
INVAR-43, Run: 056, P, 0, 0, 200, 0, 200, 0
INVAR-43, Run: 057, P, 0, 0, 200, 0, 200, 0
INVAR-43, Run: 058, P, 0, 0, 200, 0, 200, 0
INVAR-43, Run: 059, P, 0, 0, 200, 0, 200, 0
INVAR-43, Run: 060, P, 0, 0, 200, 0, 200, 0
INVAR-43, Run: 061, P, 0, 0, 200, 0, 200, 0
INVAR-43, Run: 062, P, 0, 0, 200, 0, 200, 0
INVAR-43, Run: 063, P, 0, 0, 200, 0, 200, 0
INVAR-43, Run: 064, P, 0, 0, 200, 0, 200, 0
INVAR-43, Run: 065, P, 0, 0, 200, 0, 200, 0
INVAR-43, Run: 066, P, 0, 0, 200, 0, 200, 0
INVAR-43, Run: 067, P, 0, 0, 200, 0, 200, 0
INVAR-43, Run: 068, P, 0, 0, 200, 0, 200, 0
INVAR-43, Run: 069, P, 0, 0, 200, 0, 200, 0
INVAR-43, Run: 070, P, 0, 0, 200, 0, 200, 0
INVAR-43, Run: 071, P, 0, 0, 200, 0, 200, 0
INVAR-43, Run: 072, P, 0, 0, 200, 0, 200, 0
INVAR-43, Run: 073, P, 0, 0, 200, 0, 200, 0
INVAR-43, Run: 074, P, 0, 0, 200, 0, 200, 0
INVAR-43, Run: 075, P, 0, 0, 200, 0, 200, 0
INVAR-43, Run: 076, P, 0, 0, 200, 0, 200, 0
INVAR-43, Run: 077, P, 0, 0, 200, 0, 200, 0
INVAR-43, Run: 078, P, 0, 0, 200, 0, 200, 0
INVAR-43, Run: 079, P, 0, 0, 200, 0, 200, 0
INVAR-43, Run: 080, P, 0, 0, 200, 0, 200, 0
INVAR-43, Run: 081, P, 0, 0, 200, 0, 200, 0
INVAR-43, Run: 082, P, 0, 0, 200, 0, 200, 0
INVAR-43, Run: 083, P, 0, 0, 200, 0, 200, 0
INVAR-43, Run: 084, P, 0, 0, 200, 0, 200, 0
INVAR-43, Run: 085, P, 0, 0, 200, 0, 200, 0
INVAR-43, Run: 086, P, 0, 0, 200, 0, 200, 0
INVAR-43, Run: 087, P, 0, 0, 200, 0, 200, 0
INVAR-43, Run: 088, P, 0, 0, 200, 0, 200, 0
INVAR-43, Run: 089, P, 0, 0, 200, 0, 200, 0
INVAR-43, Run: 090, P, 0, 0, 200, 0, 200, 0
INVAR-43, Run: 091, P, 0, 0, 200, 0, 200, 0
INVAR-43, Run: 092, P, 0, 0, 200, 0, 200, 0
INVAR-43, Run: 093, P, 0, 0, 200, 0, 200, 0
INVAR-43, Run: 094, P, 0, 0, 200, 0, 200, 0
INVAR-43, Run: 095, P, 0, 0, 200, 0, 200, 0
INVAR-43, Run: 096, P, 0, 0, 200, 0, 200, 0
INVAR-43, Run: 097, P, 0, 0, 200, 0, 200, 0
INVAR-43, Run: 098, P, 0, 0, 200, 0, 200, 0
INVAR-43, Run: 099, P, 0, 0, 200, 0, 200, 0
INVAR-43, Run: 100, P, 0, 0, 200, 0, 200, 0
INVAR-44, Run: 001, F, 0, 0, 34, 17, 67, 33
INVAR-44, Run: 002, F, 0, 0, 36, 18, 68, 32
INVAR-44, Run: 003, F, 0, 0, 38, 19, 69, 31
INVAR-44, Run: 004, F, 0, 0, 34, 17, 67, 33
INVAR-44, Run: 005, F, 0, 0, 50, 25, 75, 25
INVAR-44, Run: 006, F, 0, 0, 38, 19, 69, 31
INVAR-44, Run: 007, F, 0, 0, 26, 13, 63, 37
INVAR-44, Run: 008, F, 0, 0, 34, 17, 67, 33
INVAR-44, Run: 009, F, 0, 0, 32, 16, 66, 34
INVAR-44, Run: 010, F, 0, 0, 32, 16, 66, 34
INVAR-44, Run: 011, F, 0, 0, 40, 20, 70, 30
INVAR-44, Run: 012, F, 0, 0, 34, 17, 67, 33
INVAR-44, Run: 013, F, 0, 0, 34, 17, 67, 33
INVAR-44, Run: 014, F, 0, 0, 42, 21, 71, 29
INVAR-44, Run: 015, F, 0, 0, 38, 19, 69, 31
INVAR-44, Run: 016, F, 0, 0, 30, 15, 65, 35
INVAR-44, Run: 017, F, 0, 0, 40, 20, 70, 30
INVAR-44, Run: 018, F, 0, 0, 26, 13, 63, 37
INVAR-44, Run: 019, F, 0, 0, 36, 18, 68, 32
INVAR-44, Run: 020, F, 0, 0, 34, 17, 67, 33
INVAR-44, Run: 021, F, 0, 0, 42, 21, 71, 29
INVAR-44, Run: 022, F, 0, 0, 28, 14, 64, 36
INVAR-44, Run: 023, F, 0, 0, 32, 16, 66, 34
INVAR-44, Run: 024, F, 0, 0, 38, 19, 69, 31
INVAR-44, Run: 025, F, 0, 0, 50, 25, 75, 25
INVAR-44, Run: 026, F, 0, 0, 52, 26, 76, 24
INVAR-44, Run: 027, F, 0, 0, 34, 17, 67, 33
INVAR-44, Run: 028, F, 0, 0, 46, 23, 73, 27
INVAR-44, Run: 029, F, 0, 0, 30, 15, 65, 35
INVAR-44, Run: 030, F, 0, 0, 32, 16, 66, 34
INVAR-44, Run: 031, F, 0, 0, 34, 17, 67, 33
INVAR-44, Run: 032, F, 0, 0, 46, 23, 73, 27
INVAR-44, Run: 033, F, 0, 0, 42, 21, 71, 29
INVAR-44, Run: 034, F, 0, 0, 32, 16, 66, 34
INVAR-44, Run: 035, F, 0, 0, 38, 19, 69, 31
INVAR-44, Run: 036, F, 0, 0, 40, 20, 70, 30
INVAR-44, Run: 037, F, 0, 0, 36, 18, 68, 32
INVAR-44, Run: 038, F, 0, 0, 46, 23, 73, 27
INVAR-44, Run: 039, F, 0, 0, 36, 18, 68, 32
INVAR-44, Run: 040, F, 0, 0, 38, 19, 69, 31
INVAR-44, Run: 041, F, 0, 0, 30, 15, 65, 35
INVAR-44, Run: 042, F, 0, 0, 34, 17, 67, 33
INVAR-44, Run: 043, F, 0, 0, 28, 14, 64, 36
INVAR-44, Run: 044, F, 0, 0, 32, 16, 66, 34
INVAR-44, Run: 045, F, 0, 0, 30, 15, 65, 35
INVAR-44, Run: 046, F, 0, 0, 38, 19, 69, 31
INVAR-44, Run: 047, F, 0, 0, 40, 20, 70, 30
INVAR-44, Run: 048, F, 0, 0, 36, 18, 68, 32
INVAR-44, Run: 049, F, 0, 0, 40, 20, 70, 30
INVAR-44, Run: 050, F, 0, 0, 38, 19, 69, 31
INVAR-44, Run: 051, F, 0, 0, 34, 17, 67, 33
INVAR-44, Run: 052, F, 0, 0, 34, 17, 67, 33
INVAR-44, Run: 053, F, 0, 0, 30, 15, 65, 35
INVAR-44, Run: 054, F, 0, 0, 36, 18, 68, 32
INVAR-44, Run: 055, F, 0, 0, 38, 19, 69, 31
INVAR-44, Run: 056, F, 0, 0, 40, 20, 70, 30
INVAR-44, Run: 057, F, 0, 0, 30, 15, 65, 35
INVAR-44, Run: 058, F, 0, 0, 24, 12, 62, 38
INVAR-44, Run: 059, F, 0, 0, 32, 16, 66, 34
INVAR-44, Run: 060, F, 0, 0, 42, 21, 71, 29
INVAR-44, Run: 061, F, 0, 0, 28, 14, 64, 36
INVAR-44, Run: 062, F, 0, 0, 34, 17, 67, 33
INVAR-44, Run: 063, F, 0, 0, 38, 19, 69, 31
INVAR-44, Run: 064, F, 0, 0, 34, 17, 67, 33
INVAR-44, Run: 065, F, 0, 0, 36, 18, 68, 32
INVAR-44, Run: 066, F, 0, 0, 30, 15, 65, 35
INVAR-44, Run: 067, F, 0, 0, 34, 17, 67, 33
INVAR-44, Run: 068, F, 0, 0, 38, 19, 69, 31
INVAR-44, Run: 069, F, 0, 0, 34, 17, 67, 33
INVAR-44, Run: 070, F, 0, 0, 42, 21, 71, 29
INVAR-44, Run: 071, F, 0, 0, 30, 15, 65, 35
INVAR-44, Run: 072, F, 0, 0, 36, 18, 68, 32
INVAR-44, Run: 073, F, 0, 0, 36, 18, 68, 32
INVAR-44, Run: 074, F, 0, 0, 32, 16, 66, 34
INVAR-44, Run: 075, F, 0, 0, 34, 17, 67, 33
INVAR-44, Run: 076, F, 0, 0, 40, 20, 70, 30
INVAR-44, Run: 077, F, 0, 0, 40, 20, 70, 30
INVAR-44, Run: 078, F, 0, 0, 38, 19, 69, 31
INVAR-44, Run: 079, F, 0, 0, 40, 20, 70, 30
INVAR-44, Run: 080, F, 0, 0, 38, 19, 69, 31
INVAR-44, Run: 081, F, 0, 0, 36, 18, 68, 32
INVAR-44, Run: 082, F, 0, 0, 34, 17, 67, 33
INVAR-44, Run: 083, F, 0, 0, 40, 20, 70, 30
INVAR-44, Run: 084, F, 0, 0, 34, 17, 67, 33
INVAR-44, Run: 085, F, 0, 0, 42, 21, 71, 29
INVAR-44, Run: 086, F, 0, 0, 32, 16, 66, 34
INVAR-44, Run: 087, F, 0, 0, 50, 25, 75, 25
INVAR-44, Run: 088, F, 0, 0, 40, 20, 70, 30
INVAR-44, Run: 089, F, 0, 0, 44, 22, 72, 28
INVAR-44, Run: 090, F, 0, 0, 36, 18, 68, 32
INVAR-44, Run: 091, F, 0, 0, 36, 18, 68, 32
INVAR-44, Run: 092, F, 0, 0, 34, 17, 67, 33
INVAR-44, Run: 093, F, 0, 0, 26, 13, 63, 37
INVAR-44, Run: 094, F, 0, 0, 34, 17, 67, 33
INVAR-44, Run: 095, F, 0, 0, 34, 17, 67, 33
INVAR-44, Run: 096, F, 0, 0, 32, 16, 66, 34
INVAR-44, Run: 097, F, 0, 0, 38, 19, 69, 31
INVAR-44, Run: 098, F, 0, 0, 32, 16, 66, 34
INVAR-44, Run: 099, F, 0, 0, 36, 18, 68, 32
INVAR-44, Run: 100, F, 0, 0, 44, 22, 72, 28
INVAR-45, Run: 001, F, 0, 0, 74, 37, 137, 63
INVAR-45, Run: 002, F, 0, 0, 70, 35, 135, 65
INVAR-45, Run: 003, F, 0, 0, 72, 36, 136, 64
INVAR-45, Run: 004, F, 0, 0, 62, 31, 131, 69
INVAR-45, Run: 005, F, 0, 0, 70, 35, 135, 65
INVAR-45, Run: 006, F, 0, 0, 70, 35, 135, 65
INVAR-45, Run: 007, F, 0, 0, 74, 37, 137, 63
INVAR-45, Run: 008, F, 0, 0, 82, 41, 141, 59
INVAR-45, Run: 009, F, 0, 0, 76, 38, 138, 62
INVAR-45, Run: 010, F, 0, 0, 70, 35, 135, 65
INVAR-45, Run: 011, F, 0, 0, 76, 38, 138, 62
INVAR-45, Run: 012, F, 0, 0, 58, 29, 129, 71
INVAR-45, Run: 013, F, 0, 0, 62, 31, 131, 69
INVAR-45, Run: 014, F, 0, 0, 60, 30, 130, 70
INVAR-45, Run: 015, F, 0, 0, 78, 39, 139, 61
INVAR-45, Run: 016, F, 0, 0, 76, 38, 138, 62
INVAR-45, Run: 017, F, 0, 0, 64, 32, 132, 68
INVAR-45, Run: 018, F, 0, 0, 66, 33, 133, 67
INVAR-45, Run: 019, F, 0, 0, 78, 39, 139, 61
INVAR-45, Run: 020, F, 0, 0, 52, 26, 126, 74
INVAR-45, Run: 021, F, 0, 0, 74, 37, 137, 63
INVAR-45, Run: 022, F, 0, 0, 74, 37, 137, 63
INVAR-45, Run: 023, F, 0, 0, 54, 27, 127, 73
INVAR-45, Run: 024, F, 0, 0, 68, 34, 134, 66
INVAR-45, Run: 025, F, 0, 0, 66, 33, 133, 67
INVAR-45, Run: 026, F, 0, 0, 78, 39, 139, 61
INVAR-45, Run: 027, F, 0, 0, 66, 33, 133, 67
INVAR-45, Run: 028, F, 0, 0, 72, 36, 136, 64
INVAR-45, Run: 029, F, 0, 0, 70, 35, 135, 65
INVAR-45, Run: 030, F, 0, 0, 72, 36, 136, 64
INVAR-45, Run: 031, F, 0, 0, 76, 38, 138, 62
INVAR-45, Run: 032, F, 0, 0, 76, 38, 138, 62
INVAR-45, Run: 033, F, 0, 0, 70, 35, 135, 65
INVAR-45, Run: 034, F, 0, 0, 66, 33, 133, 67
INVAR-45, Run: 035, F, 0, 0, 68, 34, 134, 66
INVAR-45, Run: 036, F, 0, 0, 66, 33, 133, 67
INVAR-45, Run: 037, F, 0, 0, 66, 33, 133, 67
INVAR-45, Run: 038, F, 0, 0, 64, 32, 132, 68
INVAR-45, Run: 039, F, 0, 0, 76, 38, 138, 62
INVAR-45, Run: 040, F, 0, 0, 78, 39, 139, 61
INVAR-45, Run: 041, F, 0, 0, 66, 33, 133, 67
INVAR-45, Run: 042, F, 0, 0, 76, 38, 138, 62
INVAR-45, Run: 043, F, 0, 0, 70, 35, 135, 65
INVAR-45, Run: 044, F, 0, 0, 84, 42, 142, 58
INVAR-45, Run: 045, F, 0, 0, 64, 32, 132, 68
INVAR-45, Run: 046, F, 0, 0, 78, 39, 139, 61
INVAR-45, Run: 047, F, 0, 0, 72, 36, 136, 64
INVAR-45, Run: 048, F, 0, 0, 72, 36, 136, 64
INVAR-45, Run: 049, F, 0, 0, 72, 36, 136, 64
INVAR-45, Run: 050, F, 0, 0, 68, 34, 134, 66
INVAR-45, Run: 051, F, 0, 0, 68, 34, 134, 66
INVAR-45, Run: 052, F, 0, 0, 70, 35, 135, 65
INVAR-45, Run: 053, F, 0, 0, 66, 33, 133, 67
INVAR-45, Run: 054, F, 0, 0, 56, 28, 128, 72
INVAR-45, Run: 055, F, 0, 0, 62, 31, 131, 69
INVAR-45, Run: 056, F, 0, 0, 62, 31, 131, 69
INVAR-45, Run: 057, F, 0, 0, 68, 34, 134, 66
INVAR-45, Run: 058, F, 0, 0, 60, 30, 130, 70
INVAR-45, Run: 059, F, 0, 0, 70, 35, 135, 65
INVAR-45, Run: 060, F, 0, 0, 62, 31, 131, 69
INVAR-45, Run: 061, F, 0, 0, 66, 33, 133, 67
INVAR-45, Run: 062, F, 0, 0, 74, 37, 137, 63
INVAR-45, Run: 063, F, 0, 0, 76, 38, 138, 62
INVAR-45, Run: 064, F, 0, 0, 68, 34, 134, 66
INVAR-45, Run: 065, F, 0, 0, 52, 26, 126, 74
INVAR-45, Run: 066, F, 0, 0, 80, 40, 140, 60
INVAR-45, Run: 067, F, 0, 0, 60, 30, 130, 70
INVAR-45, Run: 068, F, 0, 0, 72, 36, 136, 64
INVAR-45, Run: 069, F, 0, 0, 72, 36, 136, 64
INVAR-45, Run: 070, F, 0, 0, 60, 30, 130, 70
INVAR-45, Run: 071, F, 0, 0, 56, 28, 128, 72
INVAR-45, Run: 072, F, 0, 0, 70, 35, 135, 65
INVAR-45, Run: 073, F, 0, 0, 64, 32, 132, 68
INVAR-45, Run: 074, F, 0, 0, 66, 33, 133, 67
INVAR-45, Run: 075, F, 0, 0, 72, 36, 136, 64
INVAR-45, Run: 076, F, 0, 0, 70, 35, 135, 65
INVAR-45, Run: 077, F, 0, 0, 72, 36, 136, 64
INVAR-45, Run: 078, F, 0, 0, 66, 33, 133, 67
INVAR-45, Run: 079, F, 0, 0, 68, 34, 134, 66
INVAR-45, Run: 080, F, 0, 0, 48, 24, 124, 76
INVAR-45, Run: 081, F, 0, 0, 74, 37, 137, 63
INVAR-45, Run: 082, F, 0, 0, 70, 35, 135, 65
INVAR-45, Run: 083, F, 0, 0, 72, 36, 136, 64
INVAR-45, Run: 084, F, 0, 0, 86, 43, 143, 57
INVAR-45, Run: 085, F, 0, 0, 70, 35, 135, 65
INVAR-45, Run: 086, F, 0, 0, 86, 43, 143, 57
INVAR-45, Run: 087, F, 0, 0, 78, 39, 139, 61
INVAR-45, Run: 088, F, 0, 0, 52, 26, 126, 74
INVAR-45, Run: 089, F, 0, 0, 68, 34, 134, 66
INVAR-45, Run: 090, F, 0, 0, 70, 35, 135, 65
INVAR-45, Run: 091, F, 0, 0, 72, 36, 136, 64
INVAR-45, Run: 092, F, 0, 0, 70, 35, 135, 65
INVAR-45, Run: 093, F, 0, 0, 72, 36, 136, 64
INVAR-45, Run: 094, F, 0, 0, 70, 35, 135, 65
INVAR-45, Run: 095, F, 0, 0, 72, 36, 136, 64
INVAR-45, Run: 096, F, 0, 0, 82, 41, 141, 59
INVAR-45, Run: 097, F, 0, 0, 76, 38, 138, 62
INVAR-45, Run: 098, F, 0, 0, 68, 34, 134, 66
INVAR-45, Run: 099, F, 0, 0, 76, 38, 138, 62
INVAR-45, Run: 100, F, 0, 0, 74, 37, 137, 63
INVAR-46, Run: 001, F, 0, 0, 134, 67, 267, 133
INVAR-46, Run: 002, F, 0, 0, 126, 63, 263, 137
INVAR-46, Run: 003, F, 0, 0, 140, 70, 270, 130
INVAR-46, Run: 004, F, 0, 0, 134, 67, 267, 133
INVAR-46, Run: 005, F, 0, 0, 150, 75, 275, 125
INVAR-46, Run: 006, F, 0, 0, 138, 69, 269, 131
INVAR-46, Run: 007, F, 0, 0, 138, 69, 269, 131
INVAR-46, Run: 008, F, 0, 0, 122, 61, 261, 139
INVAR-46, Run: 009, F, 0, 0, 124, 62, 262, 138
INVAR-46, Run: 010, F, 0, 0, 116, 58, 258, 142
INVAR-46, Run: 011, F, 0, 0, 148, 74, 274, 126
INVAR-46, Run: 012, F, 0, 0, 146, 73, 273, 127
INVAR-46, Run: 013, F, 0, 0, 124, 62, 262, 138
INVAR-46, Run: 014, F, 0, 0, 160, 80, 280, 120
INVAR-46, Run: 015, F, 0, 0, 144, 72, 272, 128
INVAR-46, Run: 016, F, 0, 0, 116, 58, 258, 142
INVAR-46, Run: 017, F, 0, 0, 138, 69, 269, 131
INVAR-46, Run: 018, F, 0, 0, 126, 63, 263, 137
INVAR-46, Run: 019, F, 0, 0, 152, 76, 276, 124
INVAR-46, Run: 020, F, 0, 0, 132, 66, 266, 134
INVAR-46, Run: 021, F, 0, 0, 148, 74, 274, 126
INVAR-46, Run: 022, F, 0, 0, 138, 69, 269, 131
INVAR-46, Run: 023, F, 0, 0, 152, 76, 276, 124
INVAR-46, Run: 024, F, 0, 0, 136, 68, 268, 132
INVAR-46, Run: 025, F, 0, 0, 130, 65, 265, 135
INVAR-46, Run: 026, F, 0, 0, 132, 66, 266, 134
INVAR-46, Run: 027, F, 0, 0, 148, 74, 274, 126
INVAR-46, Run: 028, F, 0, 0, 130, 65, 265, 135
INVAR-46, Run: 029, F, 0, 0, 158, 79, 279, 121
INVAR-46, Run: 030, F, 0, 0, 130, 65, 265, 135
INVAR-46, Run: 031, F, 0, 0, 140, 70, 270, 130
INVAR-46, Run: 032, F, 0, 0, 122, 61, 261, 139
INVAR-46, Run: 033, F, 0, 0, 124, 62, 262, 138
INVAR-46, Run: 034, F, 0, 0, 138, 69, 269, 131
INVAR-46, Run: 035, F, 0, 0, 116, 58, 258, 142
INVAR-46, Run: 036, F, 0, 0, 120, 60, 260, 140
INVAR-46, Run: 037, F, 0, 0, 154, 77, 277, 123
INVAR-46, Run: 038, F, 0, 0, 124, 62, 262, 138
INVAR-46, Run: 039, F, 0, 0, 118, 59, 259, 141
INVAR-46, Run: 040, F, 0, 0, 140, 70, 270, 130
INVAR-46, Run: 041, F, 0, 0, 130, 65, 265, 135
INVAR-46, Run: 042, F, 0, 0, 134, 67, 267, 133
INVAR-46, Run: 043, F, 0, 0, 114, 57, 257, 143
INVAR-46, Run: 044, F, 0, 0, 110, 55, 255, 145
INVAR-46, Run: 045, F, 0, 0, 136, 68, 268, 132
INVAR-46, Run: 046, F, 0, 0, 136, 68, 268, 132
INVAR-46, Run: 047, F, 0, 0, 116, 58, 258, 142
INVAR-46, Run: 048, F, 0, 0, 138, 69, 269, 131
INVAR-46, Run: 049, F, 0, 0, 134, 67, 267, 133
INVAR-46, Run: 050, F, 0, 0, 134, 67, 267, 133
INVAR-46, Run: 051, F, 0, 0, 130, 65, 265, 135
INVAR-46, Run: 052, F, 0, 0, 146, 73, 273, 127
INVAR-46, Run: 053, F, 0, 0, 158, 79, 279, 121
INVAR-46, Run: 054, F, 0, 0, 138, 69, 269, 131
INVAR-46, Run: 055, F, 0, 0, 124, 62, 262, 138
INVAR-46, Run: 056, F, 0, 0, 132, 66, 266, 134
INVAR-46, Run: 057, F, 0, 0, 148, 74, 274, 126
INVAR-46, Run: 058, F, 0, 0, 126, 63, 263, 137
INVAR-46, Run: 059, F, 0, 0, 148, 74, 274, 126
INVAR-46, Run: 060, F, 0, 0, 124, 62, 262, 138
INVAR-46, Run: 061, F, 0, 0, 140, 70, 270, 130
INVAR-46, Run: 062, F, 0, 0, 130, 65, 265, 135
INVAR-46, Run: 063, F, 0, 0, 144, 72, 272, 128
INVAR-46, Run: 064, F, 0, 0, 158, 79, 279, 121
INVAR-46, Run: 065, F, 0, 0, 120, 60, 260, 140
INVAR-46, Run: 066, F, 0, 0, 120, 60, 260, 140
INVAR-46, Run: 067, F, 0, 0, 126, 63, 263, 137
INVAR-46, Run: 068, F, 0, 0, 120, 60, 260, 140
INVAR-46, Run: 069, F, 0, 0, 122, 61, 261, 139
INVAR-46, Run: 070, F, 0, 0, 128, 64, 264, 136
INVAR-46, Run: 071, F, 0, 0, 142, 71, 271, 129
INVAR-46, Run: 072, F, 0, 0, 148, 74, 274, 126
INVAR-46, Run: 073, F, 0, 0, 128, 64, 264, 136
INVAR-46, Run: 074, F, 0, 0, 122, 61, 261, 139
INVAR-46, Run: 075, F, 0, 0, 104, 52, 252, 148
INVAR-46, Run: 076, F, 0, 0, 136, 68, 268, 132
INVAR-46, Run: 077, F, 0, 0, 132, 66, 266, 134
INVAR-46, Run: 078, F, 0, 0, 124, 62, 262, 138
INVAR-46, Run: 079, F, 0, 0, 146, 73, 273, 127
INVAR-46, Run: 080, F, 0, 0, 150, 75, 275, 125
INVAR-46, Run: 081, F, 0, 0, 144, 72, 272, 128
INVAR-46, Run: 082, F, 0, 0, 142, 71, 271, 129
INVAR-46, Run: 083, F, 0, 0, 128, 64, 264, 136
INVAR-46, Run: 084, F, 0, 0, 122, 61, 261, 139
INVAR-46, Run: 085, F, 0, 0, 124, 62, 262, 138
INVAR-46, Run: 086, F, 0, 0, 132, 66, 266, 134
INVAR-46, Run: 087, F, 0, 0, 104, 52, 252, 148
INVAR-46, Run: 088, F, 0, 0, 132, 66, 266, 134
INVAR-46, Run: 089, F, 0, 0, 134, 67, 267, 133
INVAR-46, Run: 090, F, 0, 0, 142, 71, 271, 129
INVAR-46, Run: 091, F, 0, 0, 134, 67, 267, 133
INVAR-46, Run: 092, F, 0, 0, 132, 66, 266, 134
INVAR-46, Run: 093, F, 0, 0, 152, 76, 276, 124
INVAR-46, Run: 094, F, 0, 0, 126, 63, 263, 137
INVAR-46, Run: 095, F, 0, 0, 128, 64, 264, 136
INVAR-46, Run: 096, F, 0, 0, 136, 68, 268, 132
INVAR-46, Run: 097, F, 0, 0, 142, 71, 271, 129
INVAR-46, Run: 098, F, 0, 0, 146, 73, 273, 127
INVAR-46, Run: 099, F, 0, 0, 134, 67, 267, 133
INVAR-46, Run: 100, F, 0, 0, 144, 72, 272, 128
INVAR-5, Run: 001, F, 0, 0, 35, 14, 84, 49
INVAR-5, Run: 002, F, 0, 0, 53, 23, 93, 40
INVAR-5, Run: 003, F, 0, 0, 43, 18, 88, 45
INVAR-5, Run: 004, F, 0, 0, 45, 19, 89, 44
INVAR-5, Run: 005, F, 0, 0, 47, 20, 90, 43
INVAR-5, Run: 006, F, 0, 0, 47, 20, 90, 43
INVAR-5, Run: 007, F, 0, 0, 57, 25, 95, 38
INVAR-5, Run: 008, F, 0, 0, 49, 21, 91, 42
INVAR-5, Run: 009, F, 0, 0, 57, 25, 95, 38
INVAR-5, Run: 010, F, 0, 0, 41, 17, 87, 46
INVAR-5, Run: 011, F, 0, 0, 57, 25, 95, 38
INVAR-5, Run: 012, F, 0, 0, 51, 22, 92, 41
INVAR-5, Run: 013, F, 0, 0, 55, 24, 94, 39
INVAR-5, Run: 014, F, 0, 0, 59, 26, 96, 37
INVAR-5, Run: 015, F, 0, 0, 57, 25, 95, 38
INVAR-5, Run: 016, F, 0, 0, 47, 20, 90, 43
INVAR-5, Run: 017, F, 0, 0, 49, 21, 91, 42
INVAR-5, Run: 018, F, 0, 0, 45, 19, 89, 44
INVAR-5, Run: 019, F, 0, 0, 57, 25, 95, 38
INVAR-5, Run: 020, F, 0, 0, 55, 24, 94, 39
INVAR-5, Run: 021, F, 0, 0, 51, 22, 92, 41
INVAR-5, Run: 022, F, 0, 0, 41, 17, 87, 46
INVAR-5, Run: 023, F, 0, 0, 39, 16, 86, 47
INVAR-5, Run: 024, F, 0, 0, 51, 22, 92, 41
INVAR-5, Run: 025, F, 0, 0, 51, 22, 92, 41
INVAR-5, Run: 026, F, 0, 0, 51, 22, 92, 41
INVAR-5, Run: 027, F, 0, 0, 51, 22, 92, 41
INVAR-5, Run: 028, F, 0, 0, 57, 25, 95, 38
INVAR-5, Run: 029, F, 0, 0, 43, 18, 88, 45
INVAR-5, Run: 030, F, 0, 0, 51, 22, 92, 41
INVAR-5, Run: 031, F, 0, 0, 47, 20, 90, 43
INVAR-5, Run: 032, F, 0, 0, 51, 22, 92, 41
INVAR-5, Run: 033, F, 0, 0, 47, 20, 90, 43
INVAR-5, Run: 034, F, 0, 0, 47, 20, 90, 43
INVAR-5, Run: 035, F, 0, 0, 51, 22, 92, 41
INVAR-5, Run: 036, F, 0, 0, 45, 19, 89, 44
INVAR-5, Run: 037, F, 0, 0, 47, 20, 90, 43
INVAR-5, Run: 038, F, 0, 0, 59, 26, 96, 37
INVAR-5, Run: 039, F, 0, 0, 47, 20, 90, 43
INVAR-5, Run: 040, F, 0, 0, 45, 19, 89, 44
INVAR-5, Run: 041, F, 0, 0, 51, 22, 92, 41
INVAR-5, Run: 042, F, 0, 0, 39, 16, 86, 47
INVAR-5, Run: 043, F, 0, 0, 43, 18, 88, 45
INVAR-5, Run: 044, F, 0, 0, 41, 17, 87, 46
INVAR-5, Run: 045, F, 0, 0, 47, 20, 90, 43
INVAR-5, Run: 046, F, 0, 0, 53, 23, 93, 40
INVAR-5, Run: 047, F, 0, 0, 53, 23, 93, 40
INVAR-5, Run: 048, F, 0, 0, 43, 18, 88, 45
INVAR-5, Run: 049, F, 0, 0, 41, 17, 87, 46
INVAR-5, Run: 050, F, 0, 0, 51, 22, 92, 41
INVAR-5, Run: 051, F, 0, 0, 53, 23, 93, 40
INVAR-5, Run: 052, F, 0, 0, 57, 25, 95, 38
INVAR-5, Run: 053, F, 0, 0, 43, 18, 88, 45
INVAR-5, Run: 054, F, 0, 0, 47, 20, 90, 43
INVAR-5, Run: 055, F, 0, 0, 49, 21, 91, 42
INVAR-5, Run: 056, F, 0, 0, 57, 25, 95, 38
INVAR-5, Run: 057, F, 0, 0, 57, 25, 95, 38
INVAR-5, Run: 058, F, 0, 0, 47, 20, 90, 43
INVAR-5, Run: 059, F, 0, 0, 43, 18, 88, 45
INVAR-5, Run: 060, F, 0, 0, 47, 20, 90, 43
INVAR-5, Run: 061, F, 0, 0, 53, 23, 93, 40
INVAR-5, Run: 062, F, 0, 0, 41, 17, 87, 46
INVAR-5, Run: 063, F, 0, 0, 47, 20, 90, 43
INVAR-5, Run: 064, F, 0, 0, 39, 16, 86, 47
INVAR-5, Run: 065, F, 0, 0, 55, 24, 94, 39
INVAR-5, Run: 066, F, 0, 0, 57, 25, 95, 38
INVAR-5, Run: 067, F, 0, 0, 59, 26, 96, 37
INVAR-5, Run: 068, F, 0, 0, 43, 18, 88, 45
INVAR-5, Run: 069, F, 0, 0, 51, 22, 92, 41
INVAR-5, Run: 070, F, 0, 0, 49, 21, 91, 42
INVAR-5, Run: 071, F, 0, 0, 51, 22, 92, 41
INVAR-5, Run: 072, F, 0, 0, 53, 23, 93, 40
INVAR-5, Run: 073, F, 0, 0, 53, 23, 93, 40
INVAR-5, Run: 074, F, 0, 0, 49, 21, 91, 42
INVAR-5, Run: 075, F, 0, 0, 49, 21, 91, 42
INVAR-5, Run: 076, F, 0, 0, 49, 21, 91, 42
INVAR-5, Run: 077, F, 0, 0, 49, 21, 91, 42
INVAR-5, Run: 078, F, 0, 0, 45, 19, 89, 44
INVAR-5, Run: 079, F, 0, 0, 49, 21, 91, 42
INVAR-5, Run: 080, F, 0, 0, 45, 19, 89, 44
INVAR-5, Run: 081, F, 0, 0, 51, 22, 92, 41
INVAR-5, Run: 082, F, 0, 0, 41, 17, 87, 46
INVAR-5, Run: 083, F, 0, 0, 57, 25, 95, 38
INVAR-5, Run: 084, F, 0, 0, 49, 21, 91, 42
INVAR-5, Run: 085, F, 0, 0, 43, 18, 88, 45
INVAR-5, Run: 086, F, 0, 0, 65, 29, 99, 34
INVAR-5, Run: 087, F, 0, 0, 53, 23, 93, 40
INVAR-5, Run: 088, F, 0, 0, 61, 27, 97, 36
INVAR-5, Run: 089, F, 0, 0, 51, 22, 92, 41
INVAR-5, Run: 090, F, 0, 0, 51, 22, 92, 41
INVAR-5, Run: 091, F, 0, 0, 49, 21, 91, 42
INVAR-5, Run: 092, F, 0, 0, 55, 24, 94, 39
INVAR-5, Run: 093, F, 0, 0, 43, 18, 88, 45
INVAR-5, Run: 094, F, 0, 0, 49, 21, 91, 42
INVAR-5, Run: 095, F, 0, 0, 51, 22, 92, 41
INVAR-5, Run: 096, F, 0, 0, 57, 25, 95, 38
INVAR-5, Run: 097, F, 0, 0, 59, 26, 96, 37
INVAR-5, Run: 098, F, 0, 0, 53, 23, 93, 40
INVAR-5, Run: 099, F, 0, 0, 53, 23, 93, 40
INVAR-5, Run: 100, F, 0, 0, 47, 20, 90, 43
INVAR-6, Run: 001, F, 0, 0, 119, 48, 240, 121
INVAR-6, Run: 002, F, 0, 0, 117, 47, 239, 122
INVAR-6, Run: 003, F, 0, 0, 149, 63, 255, 106
INVAR-6, Run: 004, F, 0, 0, 119, 48, 240, 121
INVAR-6, Run: 005, F, 0, 0, 121, 49, 241, 120
INVAR-6, Run: 006, F, 0, 0, 117, 47, 239, 122
INVAR-6, Run: 007, F, 0, 0, 109, 43, 235, 126
INVAR-6, Run: 008, F, 0, 0, 147, 62, 254, 107
INVAR-6, Run: 009, F, 0, 0, 111, 44, 236, 125
INVAR-6, Run: 010, F, 0, 0, 139, 58, 250, 111
INVAR-6, Run: 011, F, 0, 0, 151, 64, 256, 105
INVAR-6, Run: 012, F, 0, 0, 129, 53, 245, 116
INVAR-6, Run: 013, F, 0, 0, 115, 46, 238, 123
INVAR-6, Run: 014, F, 0, 0, 131, 54, 246, 115
INVAR-6, Run: 015, F, 0, 0, 145, 61, 253, 108
INVAR-6, Run: 016, F, 0, 0, 121, 49, 241, 120
INVAR-6, Run: 017, F, 0, 0, 127, 52, 244, 117
INVAR-6, Run: 018, F, 0, 0, 129, 53, 245, 116
INVAR-6, Run: 019, F, 0, 0, 125, 51, 243, 118
INVAR-6, Run: 020, F, 0, 0, 123, 50, 242, 119
INVAR-6, Run: 021, F, 0, 0, 141, 59, 251, 110
INVAR-6, Run: 022, F, 0, 0, 121, 49, 241, 120
INVAR-6, Run: 023, F, 0, 0, 137, 57, 249, 112
INVAR-6, Run: 024, F, 0, 0, 147, 62, 254, 107
INVAR-6, Run: 025, F, 0, 0, 139, 58, 250, 111
INVAR-6, Run: 026, F, 0, 0, 111, 44, 236, 125
INVAR-6, Run: 027, F, 0, 0, 117, 47, 239, 122
INVAR-6, Run: 028, F, 0, 0, 141, 59, 251, 110
INVAR-6, Run: 029, F, 0, 0, 119, 48, 240, 121
INVAR-6, Run: 030, F, 0, 0, 133, 55, 247, 114
INVAR-6, Run: 031, F, 0, 0, 127, 52, 244, 117
INVAR-6, Run: 032, F, 0, 0, 131, 54, 246, 115
INVAR-6, Run: 033, F, 0, 0, 147, 62, 254, 107
INVAR-6, Run: 034, F, 0, 0, 121, 49, 241, 120
INVAR-6, Run: 035, F, 0, 0, 137, 57, 249, 112
INVAR-6, Run: 036, F, 0, 0, 135, 56, 248, 113
INVAR-6, Run: 037, F, 0, 0, 133, 55, 247, 114
INVAR-6, Run: 038, F, 0, 0, 135, 56, 248, 113
INVAR-6, Run: 039, F, 0, 0, 135, 56, 248, 113
INVAR-6, Run: 040, F, 0, 0, 119, 48, 240, 121
INVAR-6, Run: 041, F, 0, 0, 131, 54, 246, 115
INVAR-6, Run: 042, F, 0, 0, 129, 53, 245, 116
INVAR-6, Run: 043, F, 0, 0, 123, 50, 242, 119
INVAR-6, Run: 044, F, 0, 0, 133, 55, 247, 114
INVAR-6, Run: 045, F, 0, 0, 115, 46, 238, 123
INVAR-6, Run: 046, F, 0, 0, 131, 54, 246, 115
INVAR-6, Run: 047, F, 0, 0, 137, 57, 249, 112
INVAR-6, Run: 048, F, 0, 0, 119, 48, 240, 121
INVAR-6, Run: 049, F, 0, 0, 143, 60, 252, 109
INVAR-6, Run: 050, F, 0, 0, 125, 51, 243, 118
INVAR-6, Run: 051, F, 0, 0, 133, 55, 247, 114
INVAR-6, Run: 052, F, 0, 0, 119, 48, 240, 121
INVAR-6, Run: 053, F, 0, 0, 137, 57, 249, 112
INVAR-6, Run: 054, F, 0, 0, 129, 53, 245, 116
INVAR-6, Run: 055, F, 0, 0, 131, 54, 246, 115
INVAR-6, Run: 056, F, 0, 0, 121, 49, 241, 120
INVAR-6, Run: 057, F, 0, 0, 127, 52, 244, 117
INVAR-6, Run: 058, F, 0, 0, 121, 49, 241, 120
INVAR-6, Run: 059, F, 0, 0, 145, 61, 253, 108
INVAR-6, Run: 060, F, 0, 0, 137, 57, 249, 112
INVAR-6, Run: 061, F, 0, 0, 149, 63, 255, 106
INVAR-6, Run: 062, F, 0, 0, 131, 54, 246, 115
INVAR-6, Run: 063, F, 0, 0, 127, 52, 244, 117
INVAR-6, Run: 064, F, 0, 0, 119, 48, 240, 121
INVAR-6, Run: 065, F, 0, 0, 145, 61, 253, 108
INVAR-6, Run: 066, F, 0, 0, 131, 54, 246, 115
INVAR-6, Run: 067, F, 0, 0, 117, 47, 239, 122
INVAR-6, Run: 068, F, 0, 0, 139, 58, 250, 111
INVAR-6, Run: 069, F, 0, 0, 131, 54, 246, 115
INVAR-6, Run: 070, F, 0, 0, 129, 53, 245, 116
INVAR-6, Run: 071, F, 0, 0, 113, 45, 237, 124
INVAR-6, Run: 072, F, 0, 0, 141, 59, 251, 110
INVAR-6, Run: 073, F, 0, 0, 147, 62, 254, 107
INVAR-6, Run: 074, F, 0, 0, 129, 53, 245, 116
INVAR-6, Run: 075, F, 0, 0, 109, 43, 235, 126
INVAR-6, Run: 076, F, 0, 0, 141, 59, 251, 110
INVAR-6, Run: 077, F, 0, 0, 123, 50, 242, 119
INVAR-6, Run: 078, F, 0, 0, 117, 47, 239, 122
INVAR-6, Run: 079, F, 0, 0, 115, 46, 238, 123
INVAR-6, Run: 080, F, 0, 0, 141, 59, 251, 110
INVAR-6, Run: 081, F, 0, 0, 109, 43, 235, 126
INVAR-6, Run: 082, F, 0, 0, 131, 54, 246, 115
INVAR-6, Run: 083, F, 0, 0, 115, 46, 238, 123
INVAR-6, Run: 084, F, 0, 0, 139, 58, 250, 111
INVAR-6, Run: 085, F, 0, 0, 125, 51, 243, 118
INVAR-6, Run: 086, F, 0, 0, 135, 56, 248, 113
INVAR-6, Run: 087, F, 0, 0, 139, 58, 250, 111
INVAR-6, Run: 088, F, 0, 0, 131, 54, 246, 115
INVAR-6, Run: 089, F, 0, 0, 117, 47, 239, 122
INVAR-6, Run: 090, F, 0, 0, 153, 65, 257, 104
INVAR-6, Run: 091, F, 0, 0, 123, 50, 242, 119
INVAR-6, Run: 092, F, 0, 0, 121, 49, 241, 120
INVAR-6, Run: 093, F, 0, 0, 127, 52, 244, 117
INVAR-6, Run: 094, F, 0, 0, 131, 54, 246, 115
INVAR-6, Run: 095, F, 0, 0, 133, 55, 247, 114
INVAR-6, Run: 096, F, 0, 0, 133, 55, 247, 114
INVAR-6, Run: 097, F, 0, 0, 129, 53, 245, 116
INVAR-6, Run: 098, F, 0, 0, 129, 53, 245, 116
INVAR-6, Run: 099, F, 0, 0, 123, 50, 242, 119
INVAR-6, Run: 100, F, 0, 0, 147, 62, 254, 107
INVAR-7, Run: 001, P, 0, 0, 14, 0, 14, 0
INVAR-7, Run: 002, P, 0, 0, 14, 0, 14, 0
INVAR-7, Run: 003, P, 0, 0, 14, 0, 14, 0
INVAR-7, Run: 004, P, 0, 0, 14, 0, 14, 0
INVAR-7, Run: 005, P, 0, 0, 14, 0, 14, 0
INVAR-7, Run: 006, P, 0, 0, 14, 0, 14, 0
INVAR-7, Run: 007, P, 0, 0, 14, 0, 14, 0
INVAR-7, Run: 008, P, 0, 0, 14, 0, 14, 0
INVAR-7, Run: 009, P, 0, 0, 14, 0, 14, 0
INVAR-7, Run: 010, P, 0, 0, 14, 0, 14, 0
INVAR-7, Run: 011, P, 0, 0, 14, 0, 14, 0
INVAR-7, Run: 012, P, 0, 0, 14, 0, 14, 0
INVAR-7, Run: 013, P, 0, 0, 14, 0, 14, 0
INVAR-7, Run: 014, P, 0, 0, 14, 0, 14, 0
INVAR-7, Run: 015, P, 0, 0, 14, 0, 14, 0
INVAR-7, Run: 016, P, 0, 0, 14, 0, 14, 0
INVAR-7, Run: 017, P, 0, 0, 14, 0, 14, 0
INVAR-7, Run: 018, P, 0, 0, 14, 0, 14, 0
INVAR-7, Run: 019, P, 0, 0, 14, 0, 14, 0
INVAR-7, Run: 020, P, 0, 0, 14, 0, 14, 0
INVAR-7, Run: 021, P, 0, 0, 14, 0, 14, 0
INVAR-7, Run: 022, P, 0, 0, 14, 0, 14, 0
INVAR-7, Run: 023, P, 0, 0, 14, 0, 14, 0
INVAR-7, Run: 024, P, 0, 0, 14, 0, 14, 0
INVAR-7, Run: 025, P, 0, 0, 14, 0, 14, 0
INVAR-7, Run: 026, P, 0, 0, 14, 0, 14, 0
INVAR-7, Run: 027, P, 0, 0, 14, 0, 14, 0
INVAR-7, Run: 028, P, 0, 0, 14, 0, 14, 0
INVAR-7, Run: 029, P, 0, 0, 14, 0, 14, 0
INVAR-7, Run: 030, P, 0, 0, 14, 0, 14, 0
INVAR-7, Run: 031, P, 0, 0, 14, 0, 14, 0
INVAR-7, Run: 032, P, 0, 0, 14, 0, 14, 0
INVAR-7, Run: 033, P, 0, 0, 14, 0, 14, 0
INVAR-7, Run: 034, P, 0, 0, 14, 0, 14, 0
INVAR-7, Run: 035, P, 0, 0, 14, 0, 14, 0
INVAR-7, Run: 036, P, 0, 0, 14, 0, 14, 0
INVAR-7, Run: 037, P, 0, 0, 14, 0, 14, 0
INVAR-7, Run: 038, P, 0, 0, 14, 0, 14, 0
INVAR-7, Run: 039, P, 0, 0, 14, 0, 14, 0
INVAR-7, Run: 040, P, 0, 0, 14, 0, 14, 0
INVAR-7, Run: 041, P, 0, 0, 14, 0, 14, 0
INVAR-7, Run: 042, P, 0, 0, 14, 0, 14, 0
INVAR-7, Run: 043, P, 0, 0, 14, 0, 14, 0
INVAR-7, Run: 044, P, 0, 0, 14, 0, 14, 0
INVAR-7, Run: 045, P, 0, 0, 14, 0, 14, 0
INVAR-7, Run: 046, P, 0, 0, 14, 0, 14, 0
INVAR-7, Run: 047, P, 0, 0, 14, 0, 14, 0
INVAR-7, Run: 048, P, 0, 0, 14, 0, 14, 0
INVAR-7, Run: 049, P, 0, 0, 14, 0, 14, 0
INVAR-7, Run: 050, P, 0, 0, 14, 0, 14, 0
INVAR-7, Run: 051, P, 0, 0, 14, 0, 14, 0
INVAR-7, Run: 052, P, 0, 0, 14, 0, 14, 0
INVAR-7, Run: 053, P, 0, 0, 14, 0, 14, 0
INVAR-7, Run: 054, P, 0, 0, 14, 0, 14, 0
INVAR-7, Run: 055, P, 0, 0, 14, 0, 14, 0
INVAR-7, Run: 056, P, 0, 0, 14, 0, 14, 0
INVAR-7, Run: 057, P, 0, 0, 14, 0, 14, 0
INVAR-7, Run: 058, P, 0, 0, 14, 0, 14, 0
INVAR-7, Run: 059, P, 0, 0, 14, 0, 14, 0
INVAR-7, Run: 060, P, 0, 0, 14, 0, 14, 0
INVAR-7, Run: 061, P, 0, 0, 14, 0, 14, 0
INVAR-7, Run: 062, P, 0, 0, 14, 0, 14, 0
INVAR-7, Run: 063, P, 0, 0, 14, 0, 14, 0
INVAR-7, Run: 064, P, 0, 0, 14, 0, 14, 0
INVAR-7, Run: 065, P, 0, 0, 14, 0, 14, 0
INVAR-7, Run: 066, P, 0, 0, 14, 0, 14, 0
INVAR-7, Run: 067, P, 0, 0, 14, 0, 14, 0
INVAR-7, Run: 068, P, 0, 0, 14, 0, 14, 0
INVAR-7, Run: 069, P, 0, 0, 14, 0, 14, 0
INVAR-7, Run: 070, P, 0, 0, 14, 0, 14, 0
INVAR-7, Run: 071, P, 0, 0, 14, 0, 14, 0
INVAR-7, Run: 072, P, 0, 0, 14, 0, 14, 0
INVAR-7, Run: 073, P, 0, 0, 14, 0, 14, 0
INVAR-7, Run: 074, P, 0, 0, 14, 0, 14, 0
INVAR-7, Run: 075, P, 0, 0, 14, 0, 14, 0
INVAR-7, Run: 076, P, 0, 0, 14, 0, 14, 0
INVAR-7, Run: 077, P, 0, 0, 14, 0, 14, 0
INVAR-7, Run: 078, P, 0, 0, 14, 0, 14, 0
INVAR-7, Run: 079, P, 0, 0, 14, 0, 14, 0
INVAR-7, Run: 080, P, 0, 0, 14, 0, 14, 0
INVAR-7, Run: 081, P, 0, 0, 14, 0, 14, 0
INVAR-7, Run: 082, P, 0, 0, 14, 0, 14, 0
INVAR-7, Run: 083, P, 0, 0, 14, 0, 14, 0
INVAR-7, Run: 084, P, 0, 0, 14, 0, 14, 0
INVAR-7, Run: 085, P, 0, 0, 14, 0, 14, 0
INVAR-7, Run: 086, P, 0, 0, 14, 0, 14, 0
INVAR-7, Run: 087, P, 0, 0, 14, 0, 14, 0
INVAR-7, Run: 088, P, 0, 0, 14, 0, 14, 0
INVAR-7, Run: 089, P, 0, 0, 14, 0, 14, 0
INVAR-7, Run: 090, P, 0, 0, 14, 0, 14, 0
INVAR-7, Run: 091, P, 0, 0, 14, 0, 14, 0
INVAR-7, Run: 092, P, 0, 0, 14, 0, 14, 0
INVAR-7, Run: 093, P, 0, 0, 14, 0, 14, 0
INVAR-7, Run: 094, P, 0, 0, 14, 0, 14, 0
INVAR-7, Run: 095, P, 0, 0, 14, 0, 14, 0
INVAR-7, Run: 096, P, 0, 0, 14, 0, 14, 0
INVAR-7, Run: 097, P, 0, 0, 14, 0, 14, 0
INVAR-7, Run: 098, P, 0, 0, 14, 0, 14, 0
INVAR-7, Run: 099, P, 0, 0, 14, 0, 14, 0
INVAR-7, Run: 100, P, 0, 0, 14, 0, 14, 0
INVAR-8, Run: 001, P, 0, 0, 90, 0, 90, 0
INVAR-8, Run: 002, P, 0, 0, 90, 0, 90, 0
INVAR-8, Run: 003, P, 0, 0, 90, 0, 90, 0
INVAR-8, Run: 004, P, 0, 0, 90, 0, 90, 0
INVAR-8, Run: 005, P, 0, 0, 90, 0, 90, 0
INVAR-8, Run: 006, P, 0, 0, 90, 0, 90, 0
INVAR-8, Run: 007, P, 0, 0, 90, 0, 90, 0
INVAR-8, Run: 008, P, 0, 0, 90, 0, 90, 0
INVAR-8, Run: 009, P, 0, 0, 90, 0, 90, 0
INVAR-8, Run: 010, P, 0, 0, 90, 0, 90, 0
INVAR-8, Run: 011, P, 0, 0, 90, 0, 90, 0
INVAR-8, Run: 012, P, 0, 0, 90, 0, 90, 0
INVAR-8, Run: 013, P, 0, 0, 90, 0, 90, 0
INVAR-8, Run: 014, P, 0, 0, 90, 0, 90, 0
INVAR-8, Run: 015, P, 0, 0, 90, 0, 90, 0
INVAR-8, Run: 016, P, 0, 0, 90, 0, 90, 0
INVAR-8, Run: 017, P, 0, 0, 90, 0, 90, 0
INVAR-8, Run: 018, P, 0, 0, 90, 0, 90, 0
INVAR-8, Run: 019, P, 0, 0, 90, 0, 90, 0
INVAR-8, Run: 020, P, 0, 0, 90, 0, 90, 0
INVAR-8, Run: 021, P, 0, 0, 90, 0, 90, 0
INVAR-8, Run: 022, P, 0, 0, 90, 0, 90, 0
INVAR-8, Run: 023, P, 0, 0, 90, 0, 90, 0
INVAR-8, Run: 024, P, 0, 0, 90, 0, 90, 0
INVAR-8, Run: 025, P, 0, 0, 90, 0, 90, 0
INVAR-8, Run: 026, P, 0, 0, 90, 0, 90, 0
INVAR-8, Run: 027, P, 0, 0, 90, 0, 90, 0
INVAR-8, Run: 028, P, 0, 0, 90, 0, 90, 0
INVAR-8, Run: 029, P, 0, 0, 90, 0, 90, 0
INVAR-8, Run: 030, P, 0, 0, 90, 0, 90, 0
INVAR-8, Run: 031, P, 0, 0, 90, 0, 90, 0
INVAR-8, Run: 032, P, 0, 0, 90, 0, 90, 0
INVAR-8, Run: 033, P, 0, 0, 90, 0, 90, 0
INVAR-8, Run: 034, P, 0, 0, 90, 0, 90, 0
INVAR-8, Run: 035, P, 0, 0, 90, 0, 90, 0
INVAR-8, Run: 036, P, 0, 0, 90, 0, 90, 0
INVAR-8, Run: 037, P, 0, 0, 90, 0, 90, 0
INVAR-8, Run: 038, P, 0, 0, 90, 0, 90, 0
INVAR-8, Run: 039, P, 0, 0, 90, 0, 90, 0
INVAR-8, Run: 040, P, 0, 0, 90, 0, 90, 0
INVAR-8, Run: 041, P, 0, 0, 90, 0, 90, 0
INVAR-8, Run: 042, P, 0, 0, 90, 0, 90, 0
INVAR-8, Run: 043, P, 0, 0, 90, 0, 90, 0
INVAR-8, Run: 044, P, 0, 0, 90, 0, 90, 0
INVAR-8, Run: 045, P, 0, 0, 90, 0, 90, 0
INVAR-8, Run: 046, P, 0, 0, 90, 0, 90, 0
INVAR-8, Run: 047, P, 0, 0, 90, 0, 90, 0
INVAR-8, Run: 048, P, 0, 0, 90, 0, 90, 0
INVAR-8, Run: 049, P, 0, 0, 90, 0, 90, 0
INVAR-8, Run: 050, P, 0, 0, 90, 0, 90, 0
INVAR-8, Run: 051, P, 0, 0, 90, 0, 90, 0
INVAR-8, Run: 052, P, 0, 0, 90, 0, 90, 0
INVAR-8, Run: 053, P, 0, 0, 90, 0, 90, 0
INVAR-8, Run: 054, P, 0, 0, 90, 0, 90, 0
INVAR-8, Run: 055, P, 0, 0, 90, 0, 90, 0
INVAR-8, Run: 056, P, 0, 0, 90, 0, 90, 0
INVAR-8, Run: 057, P, 0, 0, 90, 0, 90, 0
INVAR-8, Run: 058, P, 0, 0, 90, 0, 90, 0
INVAR-8, Run: 059, P, 0, 0, 90, 0, 90, 0
INVAR-8, Run: 060, P, 0, 0, 90, 0, 90, 0
INVAR-8, Run: 061, P, 0, 0, 90, 0, 90, 0
INVAR-8, Run: 062, P, 0, 0, 90, 0, 90, 0
INVAR-8, Run: 063, P, 0, 0, 90, 0, 90, 0
INVAR-8, Run: 064, P, 0, 0, 90, 0, 90, 0
INVAR-8, Run: 065, P, 0, 0, 90, 0, 90, 0
INVAR-8, Run: 066, P, 0, 0, 90, 0, 90, 0
INVAR-8, Run: 067, P, 0, 0, 90, 0, 90, 0
INVAR-8, Run: 068, P, 0, 0, 90, 0, 90, 0
INVAR-8, Run: 069, P, 0, 0, 90, 0, 90, 0
INVAR-8, Run: 070, P, 0, 0, 90, 0, 90, 0
INVAR-8, Run: 071, P, 0, 0, 90, 0, 90, 0
INVAR-8, Run: 072, P, 0, 0, 90, 0, 90, 0
INVAR-8, Run: 073, P, 0, 0, 90, 0, 90, 0
INVAR-8, Run: 074, P, 0, 0, 90, 0, 90, 0
INVAR-8, Run: 075, P, 0, 0, 90, 0, 90, 0
INVAR-8, Run: 076, P, 0, 0, 90, 0, 90, 0
INVAR-8, Run: 077, P, 0, 0, 90, 0, 90, 0
INVAR-8, Run: 078, P, 0, 0, 90, 0, 90, 0
INVAR-8, Run: 079, P, 0, 0, 90, 0, 90, 0
INVAR-8, Run: 080, P, 0, 0, 90, 0, 90, 0
INVAR-8, Run: 081, P, 0, 0, 90, 0, 90, 0
INVAR-8, Run: 082, P, 0, 0, 90, 0, 90, 0
INVAR-8, Run: 083, P, 0, 0, 90, 0, 90, 0
INVAR-8, Run: 084, P, 0, 0, 90, 0, 90, 0
INVAR-8, Run: 085, P, 0, 0, 90, 0, 90, 0
INVAR-8, Run: 086, P, 0, 0, 90, 0, 90, 0
INVAR-8, Run: 087, P, 0, 0, 90, 0, 90, 0
INVAR-8, Run: 088, P, 0, 0, 90, 0, 90, 0
INVAR-8, Run: 089, P, 0, 0, 90, 0, 90, 0
INVAR-8, Run: 090, P, 0, 0, 90, 0, 90, 0
INVAR-8, Run: 091, P, 0, 0, 90, 0, 90, 0
INVAR-8, Run: 092, P, 0, 0, 90, 0, 90, 0
INVAR-8, Run: 093, P, 0, 0, 90, 0, 90, 0
INVAR-8, Run: 094, P, 0, 0, 90, 0, 90, 0
INVAR-8, Run: 095, P, 0, 0, 90, 0, 90, 0
INVAR-8, Run: 096, P, 0, 0, 90, 0, 90, 0
INVAR-8, Run: 097, P, 0, 0, 90, 0, 90, 0
INVAR-8, Run: 098, P, 0, 0, 90, 0, 90, 0
INVAR-8, Run: 099, P, 0, 0, 90, 0, 90, 0
INVAR-8, Run: 100, P, 0, 0, 90, 0, 90, 0
INVAR-9, Run: 001, P, 0, 0, 198, 0, 198, 0
INVAR-9, Run: 002, P, 0, 0, 198, 0, 198, 0
INVAR-9, Run: 003, P, 0, 0, 198, 0, 198, 0
INVAR-9, Run: 004, P, 0, 0, 198, 0, 198, 0
INVAR-9, Run: 005, P, 0, 0, 198, 0, 198, 0
INVAR-9, Run: 006, P, 0, 0, 198, 0, 198, 0
INVAR-9, Run: 007, P, 0, 0, 198, 0, 198, 0
INVAR-9, Run: 008, P, 0, 0, 198, 0, 198, 0
INVAR-9, Run: 009, P, 0, 0, 198, 0, 198, 0
INVAR-9, Run: 010, P, 0, 0, 198, 0, 198, 0
INVAR-9, Run: 011, P, 0, 0, 198, 0, 198, 0
INVAR-9, Run: 012, P, 0, 0, 198, 0, 198, 0
INVAR-9, Run: 013, P, 0, 0, 198, 0, 198, 0
INVAR-9, Run: 014, P, 0, 0, 198, 0, 198, 0
INVAR-9, Run: 015, P, 0, 0, 198, 0, 198, 0
INVAR-9, Run: 016, P, 0, 0, 198, 0, 198, 0
INVAR-9, Run: 017, P, 0, 0, 198, 0, 198, 0
INVAR-9, Run: 018, P, 0, 0, 198, 0, 198, 0
INVAR-9, Run: 019, P, 0, 0, 198, 0, 198, 0
INVAR-9, Run: 020, P, 0, 0, 198, 0, 198, 0
INVAR-9, Run: 021, P, 0, 0, 198, 0, 198, 0
INVAR-9, Run: 022, P, 0, 0, 198, 0, 198, 0
INVAR-9, Run: 023, P, 0, 0, 198, 0, 198, 0
INVAR-9, Run: 024, P, 0, 0, 198, 0, 198, 0
INVAR-9, Run: 025, P, 0, 0, 198, 0, 198, 0
INVAR-9, Run: 026, P, 0, 0, 198, 0, 198, 0
INVAR-9, Run: 027, P, 0, 0, 198, 0, 198, 0
INVAR-9, Run: 028, P, 0, 0, 198, 0, 198, 0
INVAR-9, Run: 029, P, 0, 0, 198, 0, 198, 0
INVAR-9, Run: 030, P, 0, 0, 198, 0, 198, 0
INVAR-9, Run: 031, P, 0, 0, 198, 0, 198, 0
INVAR-9, Run: 032, P, 0, 0, 198, 0, 198, 0
INVAR-9, Run: 033, P, 0, 0, 198, 0, 198, 0
INVAR-9, Run: 034, P, 0, 0, 198, 0, 198, 0
INVAR-9, Run: 035, P, 0, 0, 198, 0, 198, 0
INVAR-9, Run: 036, P, 0, 0, 198, 0, 198, 0
INVAR-9, Run: 037, P, 0, 0, 198, 0, 198, 0
INVAR-9, Run: 038, P, 0, 0, 198, 0, 198, 0
INVAR-9, Run: 039, P, 0, 0, 198, 0, 198, 0
INVAR-9, Run: 040, P, 0, 0, 198, 0, 198, 0
INVAR-9, Run: 041, P, 0, 0, 198, 0, 198, 0
INVAR-9, Run: 042, P, 0, 0, 198, 0, 198, 0
INVAR-9, Run: 043, P, 0, 0, 198, 0, 198, 0
INVAR-9, Run: 044, P, 0, 0, 198, 0, 198, 0
INVAR-9, Run: 045, P, 0, 0, 198, 0, 198, 0
INVAR-9, Run: 046, P, 0, 0, 198, 0, 198, 0
INVAR-9, Run: 047, P, 0, 0, 198, 0, 198, 0
INVAR-9, Run: 048, P, 0, 0, 198, 0, 198, 0
INVAR-9, Run: 049, P, 0, 0, 198, 0, 198, 0
INVAR-9, Run: 050, P, 0, 0, 198, 0, 198, 0
INVAR-9, Run: 051, P, 0, 0, 198, 0, 198, 0
INVAR-9, Run: 052, P, 0, 0, 198, 0, 198, 0
INVAR-9, Run: 053, P, 0, 0, 198, 0, 198, 0
INVAR-9, Run: 054, P, 0, 0, 198, 0, 198, 0
INVAR-9, Run: 055, P, 0, 0, 198, 0, 198, 0
INVAR-9, Run: 056, P, 0, 0, 198, 0, 198, 0
INVAR-9, Run: 057, P, 0, 0, 198, 0, 198, 0
INVAR-9, Run: 058, P, 0, 0, 198, 0, 198, 0
INVAR-9, Run: 059, P, 0, 0, 198, 0, 198, 0
INVAR-9, Run: 060, P, 0, 0, 198, 0, 198, 0
INVAR-9, Run: 061, P, 0, 0, 198, 0, 198, 0
INVAR-9, Run: 062, P, 0, 0, 198, 0, 198, 0
INVAR-9, Run: 063, P, 0, 0, 198, 0, 198, 0
INVAR-9, Run: 064, P, 0, 0, 198, 0, 198, 0
INVAR-9, Run: 065, P, 0, 0, 198, 0, 198, 0
INVAR-9, Run: 066, P, 0, 0, 198, 0, 198, 0
INVAR-9, Run: 067, P, 0, 0, 198, 0, 198, 0
INVAR-9, Run: 068, P, 0, 0, 198, 0, 198, 0
INVAR-9, Run: 069, P, 0, 0, 198, 0, 198, 0
INVAR-9, Run: 070, P, 0, 0, 198, 0, 198, 0
INVAR-9, Run: 071, P, 0, 0, 198, 0, 198, 0
INVAR-9, Run: 072, P, 0, 0, 198, 0, 198, 0
INVAR-9, Run: 073, P, 0, 0, 198, 0, 198, 0
INVAR-9, Run: 074, P, 0, 0, 198, 0, 198, 0
INVAR-9, Run: 075, P, 0, 0, 198, 0, 198, 0
INVAR-9, Run: 076, P, 0, 0, 198, 0, 198, 0
INVAR-9, Run: 077, P, 0, 0, 198, 0, 198, 0
INVAR-9, Run: 078, P, 0, 0, 198, 0, 198, 0
INVAR-9, Run: 079, P, 0, 0, 198, 0, 198, 0
INVAR-9, Run: 080, P, 0, 0, 198, 0, 198, 0
INVAR-9, Run: 081, P, 0, 0, 198, 0, 198, 0
INVAR-9, Run: 082, P, 0, 0, 198, 0, 198, 0
INVAR-9, Run: 083, P, 0, 0, 198, 0, 198, 0
INVAR-9, Run: 084, P, 0, 0, 198, 0, 198, 0
INVAR-9, Run: 085, P, 0, 0, 198, 0, 198, 0
INVAR-9, Run: 086, P, 0, 0, 198, 0, 198, 0
INVAR-9, Run: 087, P, 0, 0, 198, 0, 198, 0
INVAR-9, Run: 088, P, 0, 0, 198, 0, 198, 0
INVAR-9, Run: 089, P, 0, 0, 198, 0, 198, 0
INVAR-9, Run: 090, P, 0, 0, 198, 0, 198, 0
INVAR-9, Run: 091, P, 0, 0, 198, 0, 198, 0
INVAR-9, Run: 092, P, 0, 0, 198, 0, 198, 0
INVAR-9, Run: 093, P, 0, 0, 198, 0, 198, 0
INVAR-9, Run: 094, P, 0, 0, 198, 0, 198, 0
INVAR-9, Run: 095, P, 0, 0, 198, 0, 198, 0
INVAR-9, Run: 096, P, 0, 0, 198, 0, 198, 0
INVAR-9, Run: 097, P, 0, 0, 198, 0, 198, 0
INVAR-9, Run: 098, P, 0, 0, 198, 0, 198, 0
INVAR-9, Run: 099, P, 0, 0, 198, 0, 198, 0
INVAR-9, Run: 100, P, 0, 0, 198, 0, 198, 0
