Input Number, Run_Number, Result@ 100, PO, H, PE, X1, M, CE, Y, D, CO, A, B, NEW_REACTION, Reaction1, Reaction10, Reaction11, Reaction2, Reaction3, Reaction4, Reaction5, Reaction6, Reaction7, Reaction8, Reaction9
INVAR-1, Run: 001, P, 0, 0, 1, 0, 0, 10, 10, 0, 0, 54, 0, 2, 18, 30, 112, 8, 5, 4, 10, 18, 27, 40, 112
INVAR-1, Run: 002, P, 0, 0, 1, 0, 0, 12, 12, 0, 0, 54, 0, 6, 18, 41, 197, 6, 7, 4, 12, 18, 27, 53, 197
INVAR-1, Run: 003, P, 0, 0, 1, 0, 0, 11, 11, 0, 0, 54, 0, 4, 18, 23, 115, 7, 6, 4, 11, 18, 27, 34, 115
INVAR-1, Run: 004, P, 0, 0, 1, 0, 0, 12, 12, 0, 0, 54, 0, 6, 18, 28, 80, 6, 4, 7, 12, 18, 27, 40, 80
INVAR-1, Run: 005, P, 0, 0, 1, 0, 0, 13, 13, 0, 0, 54, 0, 8, 18, 23, 81, 5, 5, 7, 13, 18, 27, 36, 81
INVAR-1, Run: 006, P, 0, 0, 1, 0, 0, 10, 10, 0, 0, 54, 0, 2, 18, 15, 41, 8, 3, 6, 10, 18, 27, 25, 41
INVAR-1, Run: 007, P, 0, 0, 1, 0, 0, 11, 11, 0, 0, 54, 0, 4, 18, 13, 85, 7, 7, 3, 11, 18, 27, 24, 85
INVAR-1, Run: 008, P, 0, 0, 1, 0, 0, 12, 12, 0, 0, 54, 0, 6, 18, 25, 150, 6, 7, 4, 12, 18, 27, 37, 150
INVAR-1, Run: 009, P, 0, 0, 1, 0, 0, 15, 15, 0, 0, 54, 0, 12, 18, 47, 73, 3, 7, 7, 15, 18, 27, 62, 73
INVAR-1, Run: 010, P, 0, 0, 1, 0, 0, 11, 11, 0, 0, 54, 0, 4, 18, 24, 70, 7, 8, 2, 11, 18, 27, 35, 70
INVAR-1, Run: 011, P, 0, 0, 1, 0, 0, 14, 14, 0, 0, 54, 0, 10, 18, 22, 73, 4, 8, 5, 14, 18, 27, 36, 73
INVAR-1, Run: 012, P, 0, 0, 1, 0, 0, 13, 13, 0, 0, 54, 0, 8, 18, 49, 137, 5, 6, 6, 13, 18, 27, 62, 137
INVAR-1, Run: 013, P, 0, 0, 1, 0, 0, 11, 11, 0, 0, 54, 0, 4, 18, 11, 100, 7, 6, 4, 11, 18, 27, 22, 100
INVAR-1, Run: 014, P, 0, 0, 1, 0, 0, 11, 11, 0, 0, 54, 0, 4, 18, 23, 65, 7, 4, 6, 11, 18, 27, 34, 65
INVAR-1, Run: 015, P, 0, 0, 1, 0, 0, 11, 11, 0, 0, 54, 0, 4, 18, 11, 47, 7, 7, 3, 11, 18, 27, 22, 47
INVAR-1, Run: 016, P, 0, 0, 1, 0, 0, 12, 12, 0, 0, 54, 0, 6, 18, 29, 110, 6, 7, 4, 12, 18, 27, 41, 110
INVAR-1, Run: 017, P, 0, 0, 1, 0, 0, 11, 11, 0, 0, 54, 0, 4, 18, 18, 108, 7, 7, 3, 11, 18, 27, 29, 108
INVAR-1, Run: 018, P, 0, 0, 1, 0, 0, 11, 11, 0, 0, 54, 0, 4, 18, 20, 61, 7, 2, 8, 11, 18, 27, 31, 61
INVAR-1, Run: 019, P, 0, 0, 1, 0, 0, 10, 10, 0, 0, 54, 0, 2, 18, 19, 75, 8, 5, 4, 10, 18, 27, 29, 75
INVAR-1, Run: 020, P, 0, 0, 1, 0, 0, 12, 12, 0, 0, 54, 0, 6, 18, 28, 99, 6, 6, 5, 12, 18, 27, 40, 99
INVAR-1, Run: 021, P, 0, 0, 1, 0, 0, 10, 10, 0, 0, 54, 0, 2, 18, 16, 71, 8, 5, 4, 10, 18, 27, 26, 71
INVAR-1, Run: 022, P, 0, 0, 1, 0, 0, 11, 11, 0, 0, 54, 0, 4, 18, 10, 34, 7, 4, 6, 11, 18, 27, 21, 34
INVAR-1, Run: 023, P, 0, 0, 1, 0, 0, 11, 11, 0, 0, 54, 0, 4, 18, 15, 44, 7, 4, 6, 11, 18, 27, 26, 44
INVAR-1, Run: 024, P, 0, 0, 1, 0, 0, 12, 12, 0, 0, 54, 0, 6, 18, 9, 51, 6, 3, 8, 12, 18, 27, 21, 51
INVAR-1, Run: 025, P, 0, 0, 1, 0, 0, 12, 12, 0, 0, 54, 0, 6, 18, 29, 252, 6, 6, 5, 12, 18, 27, 41, 252
INVAR-1, Run: 026, P, 0, 0, 1, 0, 0, 12, 12, 0, 0, 54, 0, 6, 18, 22, 112, 6, 7, 4, 12, 18, 27, 34, 112
INVAR-1, Run: 027, P, 0, 0, 1, 0, 0, 11, 11, 0, 0, 54, 0, 4, 18, 19, 50, 7, 4, 6, 11, 18, 27, 30, 50
INVAR-1, Run: 028, P, 0, 0, 1, 0, 0, 11, 11, 0, 0, 54, 0, 4, 18, 19, 74, 7, 6, 4, 11, 18, 27, 30, 74
INVAR-1, Run: 029, P, 0, 0, 1, 0, 0, 11, 11, 0, 0, 54, 0, 4, 18, 19, 85, 7, 5, 5, 11, 18, 27, 30, 85
INVAR-1, Run: 030, P, 0, 0, 1, 0, 0, 10, 10, 0, 0, 54, 0, 2, 18, 32, 154, 8, 2, 7, 10, 18, 27, 42, 154
INVAR-1, Run: 031, P, 0, 0, 1, 0, 0, 12, 12, 0, 0, 54, 0, 6, 18, 28, 123, 6, 6, 5, 12, 18, 27, 40, 123
INVAR-1, Run: 032, P, 0, 0, 1, 0, 0, 12, 12, 0, 0, 54, 0, 6, 18, 21, 124, 6, 9, 2, 12, 18, 27, 33, 124
INVAR-1, Run: 033, P, 0, 0, 1, 0, 0, 12, 12, 0, 0, 54, 0, 6, 18, 21, 80, 6, 7, 4, 12, 18, 27, 33, 80
INVAR-1, Run: 034, P, 0, 0, 1, 0, 0, 10, 10, 0, 0, 54, 0, 2, 18, 19, 66, 8, 6, 3, 10, 18, 27, 29, 66
INVAR-1, Run: 035, P, 0, 0, 1, 0, 0, 11, 11, 0, 0, 54, 0, 4, 18, 26, 117, 7, 6, 4, 11, 18, 27, 37, 117
INVAR-1, Run: 036, P, 0, 0, 1, 0, 0, 12, 12, 0, 0, 54, 0, 6, 18, 41, 180, 6, 7, 4, 12, 18, 27, 53, 180
INVAR-1, Run: 037, P, 0, 0, 1, 0, 0, 11, 11, 0, 0, 54, 0, 4, 18, 20, 77, 7, 4, 6, 11, 18, 27, 31, 77
INVAR-1, Run: 038, P, 0, 0, 1, 0, 0, 12, 12, 0, 0, 54, 0, 6, 18, 34, 119, 6, 7, 4, 12, 18, 27, 46, 119
INVAR-1, Run: 039, P, 0, 0, 1, 0, 0, 12, 12, 0, 0, 54, 0, 6, 18, 34, 48, 6, 5, 6, 12, 18, 27, 46, 48
INVAR-1, Run: 040, P, 0, 0, 1, 0, 0, 12, 12, 0, 0, 54, 0, 6, 18, 18, 86, 6, 6, 5, 12, 18, 27, 30, 86
INVAR-1, Run: 041, P, 0, 0, 1, 0, 0, 11, 11, 0, 0, 54, 0, 4, 18, 12, 80, 7, 6, 4, 11, 18, 27, 23, 80
INVAR-1, Run: 042, P, 0, 0, 1, 0, 0, 12, 12, 0, 0, 54, 0, 6, 18, 18, 68, 6, 7, 4, 12, 18, 27, 30, 68
INVAR-1, Run: 043, P, 0, 0, 1, 0, 0, 14, 14, 0, 0, 54, 0, 10, 18, 42, 94, 4, 8, 5, 14, 18, 27, 56, 94
INVAR-1, Run: 044, P, 0, 0, 1, 0, 0, 12, 12, 0, 0, 54, 0, 6, 18, 46, 231, 6, 9, 2, 12, 18, 27, 58, 231
INVAR-1, Run: 045, P, 0, 0, 1, 0, 0, 12, 12, 0, 0, 54, 0, 6, 18, 27, 125, 6, 8, 3, 12, 18, 27, 39, 125
INVAR-1, Run: 046, P, 0, 0, 1, 0, 0, 10, 10, 0, 0, 54, 0, 2, 18, 18, 62, 8, 5, 4, 10, 18, 27, 28, 62
INVAR-1, Run: 047, P, 0, 0, 1, 0, 0, 12, 12, 0, 0, 54, 0, 6, 18, 23, 52, 6, 6, 5, 12, 18, 27, 35, 52
INVAR-1, Run: 048, P, 0, 0, 1, 0, 0, 12, 12, 0, 0, 54, 0, 6, 18, 37, 167, 6, 6, 5, 12, 18, 27, 49, 167
INVAR-1, Run: 049, P, 0, 0, 1, 0, 0, 10, 10, 0, 0, 54, 0, 2, 18, 14, 39, 8, 5, 4, 10, 18, 27, 24, 39
INVAR-1, Run: 050, P, 0, 0, 1, 0, 0, 12, 12, 0, 0, 54, 0, 6, 18, 29, 164, 6, 8, 3, 12, 18, 27, 41, 164
INVAR-1, Run: 051, P, 0, 0, 1, 0, 0, 14, 14, 0, 0, 54, 0, 10, 18, 32, 193, 4, 9, 4, 14, 18, 27, 46, 193
INVAR-1, Run: 052, P, 0, 0, 1, 0, 0, 10, 10, 0, 0, 54, 0, 2, 18, 19, 50, 8, 6, 3, 10, 18, 27, 29, 50
INVAR-1, Run: 053, P, 0, 0, 1, 0, 0, 11, 11, 0, 0, 54, 0, 4, 18, 24, 72, 7, 6, 4, 11, 18, 27, 35, 72
INVAR-1, Run: 054, P, 0, 0, 1, 0, 0, 12, 12, 0, 0, 54, 0, 6, 18, 39, 104, 6, 2, 9, 12, 18, 27, 51, 104
INVAR-1, Run: 055, P, 0, 0, 1, 0, 0, 13, 13, 0, 0, 54, 0, 8, 18, 40, 142, 5, 3, 9, 13, 18, 27, 53, 142
INVAR-1, Run: 056, P, 0, 0, 1, 0, 0, 13, 13, 0, 0, 54, 0, 8, 18, 25, 107, 5, 7, 5, 13, 18, 27, 38, 107
INVAR-1, Run: 057, P, 0, 0, 1, 0, 0, 12, 12, 0, 0, 54, 0, 6, 18, 20, 39, 6, 6, 5, 12, 18, 27, 32, 39
INVAR-1, Run: 058, P, 0, 0, 1, 0, 0, 12, 12, 0, 0, 54, 0, 6, 18, 32, 79, 6, 4, 7, 12, 18, 27, 44, 79
INVAR-1, Run: 059, P, 0, 0, 1, 0, 0, 12, 12, 0, 0, 54, 0, 6, 18, 24, 76, 6, 8, 3, 12, 18, 27, 36, 76
INVAR-1, Run: 060, P, 0, 0, 1, 0, 0, 11, 11, 0, 0, 54, 0, 4, 18, 27, 116, 7, 5, 5, 11, 18, 27, 38, 116
INVAR-1, Run: 061, P, 0, 0, 1, 0, 0, 13, 13, 0, 0, 54, 0, 8, 18, 13, 49, 5, 9, 3, 13, 18, 27, 26, 49
INVAR-1, Run: 062, P, 0, 0, 1, 0, 0, 13, 13, 0, 0, 54, 0, 8, 18, 38, 80, 5, 7, 5, 13, 18, 27, 51, 80
INVAR-1, Run: 063, P, 0, 0, 1, 0, 0, 12, 12, 0, 0, 54, 0, 6, 18, 24, 116, 6, 7, 4, 12, 18, 27, 36, 116
INVAR-1, Run: 064, P, 0, 0, 1, 0, 0, 12, 12, 0, 0, 54, 0, 6, 18, 21, 145, 6, 6, 5, 12, 18, 27, 33, 145
INVAR-1, Run: 065, P, 0, 0, 1, 0, 0, 11, 11, 0, 0, 54, 0, 4, 18, 15, 108, 7, 8, 2, 11, 18, 27, 26, 108
INVAR-1, Run: 066, P, 0, 0, 1, 0, 0, 13, 13, 0, 0, 54, 0, 8, 18, 23, 72, 5, 11, 1, 13, 18, 27, 36, 72
INVAR-1, Run: 067, P, 0, 0, 1, 0, 0, 14, 14, 0, 0, 54, 0, 10, 18, 24, 63, 4, 5, 8, 14, 18, 27, 38, 63
INVAR-1, Run: 068, P, 0, 0, 1, 0, 0, 12, 12, 0, 0, 54, 0, 6, 18, 33, 75, 6, 4, 7, 12, 18, 27, 45, 75
INVAR-1, Run: 069, P, 0, 0, 1, 0, 0, 13, 13, 0, 0, 54, 0, 8, 18, 46, 148, 5, 6, 6, 13, 18, 27, 59, 148
INVAR-1, Run: 070, P, 0, 0, 1, 0, 0, 10, 10, 0, 0, 54, 0, 2, 18, 17, 114, 8, 6, 3, 10, 18, 27, 27, 114
INVAR-1, Run: 071, P, 0, 0, 1, 0, 0, 11, 11, 0, 0, 54, 0, 4, 18, 28, 168, 7, 6, 4, 11, 18, 27, 39, 168
INVAR-1, Run: 072, P, 0, 0, 1, 0, 0, 12, 12, 0, 0, 54, 0, 6, 18, 33, 94, 6, 8, 3, 12, 18, 27, 45, 94
INVAR-1, Run: 073, P, 0, 0, 1, 0, 0, 12, 12, 0, 0, 54, 0, 6, 18, 21, 45, 6, 4, 7, 12, 18, 27, 33, 45
INVAR-1, Run: 074, P, 0, 0, 1, 0, 0, 10, 10, 0, 0, 54, 0, 2, 18, 14, 83, 8, 8, 1, 10, 18, 27, 24, 83
INVAR-1, Run: 075, P, 0, 0, 1, 0, 0, 12, 12, 0, 0, 54, 0, 6, 18, 20, 94, 6, 7, 4, 12, 18, 27, 32, 94
INVAR-1, Run: 076, P, 0, 0, 1, 0, 0, 13, 13, 0, 0, 54, 0, 8, 18, 31, 187, 5, 7, 5, 13, 18, 27, 44, 187
INVAR-1, Run: 077, P, 0, 0, 1, 0, 0, 11, 11, 0, 0, 54, 0, 4, 18, 28, 96, 7, 4, 6, 11, 18, 27, 39, 96
INVAR-1, Run: 078, P, 0, 0, 1, 0, 0, 11, 11, 0, 0, 54, 0, 4, 18, 29, 137, 7, 4, 6, 11, 18, 27, 40, 137
INVAR-1, Run: 079, P, 0, 0, 1, 0, 0, 11, 11, 0, 0, 54, 0, 4, 18, 19, 50, 7, 8, 2, 11, 18, 27, 30, 50
INVAR-1, Run: 080, P, 0, 0, 1, 0, 0, 11, 11, 0, 0, 54, 0, 4, 18, 22, 88, 7, 9, 1, 11, 18, 27, 33, 88
INVAR-1, Run: 081, P, 0, 0, 1, 0, 0, 12, 12, 0, 0, 54, 0, 6, 18, 32, 139, 6, 5, 6, 12, 18, 27, 44, 139
INVAR-1, Run: 082, P, 0, 0, 1, 0, 0, 12, 12, 0, 0, 54, 0, 6, 18, 30, 99, 6, 6, 5, 12, 18, 27, 42, 99
INVAR-1, Run: 083, P, 0, 0, 1, 0, 0, 11, 11, 0, 0, 54, 0, 4, 18, 16, 66, 7, 4, 6, 11, 18, 27, 27, 66
INVAR-1, Run: 084, P, 0, 0, 1, 0, 0, 12, 12, 0, 0, 54, 0, 6, 18, 40, 146, 6, 7, 4, 12, 18, 27, 52, 146
INVAR-1, Run: 085, P, 0, 0, 1, 0, 0, 13, 13, 0, 0, 54, 0, 8, 18, 28, 30, 5, 4, 8, 13, 18, 27, 41, 30
INVAR-1, Run: 086, P, 0, 0, 1, 0, 0, 12, 12, 0, 0, 54, 0, 6, 18, 29, 139, 6, 6, 5, 12, 18, 27, 41, 139
INVAR-1, Run: 087, P, 0, 0, 1, 0, 0, 12, 12, 0, 0, 54, 0, 6, 18, 21, 105, 6, 3, 8, 12, 18, 27, 33, 105
INVAR-1, Run: 088, P, 0, 0, 1, 0, 0, 11, 11, 0, 0, 54, 0, 4, 18, 8, 55, 7, 4, 6, 11, 18, 27, 19, 55
INVAR-1, Run: 089, P, 0, 0, 1, 0, 0, 10, 10, 0, 0, 54, 0, 2, 18, 20, 94, 8, 6, 3, 10, 18, 27, 30, 94
INVAR-1, Run: 090, P, 0, 0, 1, 0, 0, 11, 11, 0, 0, 54, 0, 4, 18, 21, 63, 7, 6, 4, 11, 18, 27, 32, 63
INVAR-1, Run: 091, P, 0, 0, 1, 0, 0, 13, 13, 0, 0, 54, 0, 8, 18, 32, 133, 5, 3, 9, 13, 18, 27, 45, 133
INVAR-1, Run: 092, P, 0, 0, 1, 0, 0, 11, 11, 0, 0, 54, 0, 4, 18, 32, 90, 7, 4, 6, 11, 18, 27, 43, 90
INVAR-1, Run: 093, P, 0, 0, 1, 0, 0, 11, 11, 0, 0, 54, 0, 4, 18, 38, 187, 7, 5, 5, 11, 18, 27, 49, 187
INVAR-1, Run: 094, P, 0, 0, 1, 0, 0, 12, 12, 0, 0, 54, 0, 6, 18, 26, 141, 6, 8, 3, 12, 18, 27, 38, 141
INVAR-1, Run: 095, P, 0, 0, 1, 0, 0, 11, 11, 0, 0, 54, 0, 4, 18, 22, 69, 7, 5, 5, 11, 18, 27, 33, 69
INVAR-1, Run: 096, P, 0, 0, 1, 0, 0, 12, 12, 0, 0, 54, 0, 6, 18, 15, 47, 6, 7, 4, 12, 18, 27, 27, 47
INVAR-1, Run: 097, P, 0, 0, 1, 0, 0, 12, 12, 0, 0, 54, 0, 6, 18, 18, 105, 6, 6, 5, 12, 18, 27, 30, 105
INVAR-1, Run: 098, P, 0, 0, 1, 0, 0, 12, 12, 0, 0, 54, 0, 6, 18, 24, 90, 6, 6, 5, 12, 18, 27, 36, 90
INVAR-1, Run: 099, P, 0, 0, 1, 0, 0, 13, 13, 0, 0, 54, 0, 8, 18, 23, 37, 5, 6, 6, 13, 18, 27, 36, 37
INVAR-1, Run: 100, P, 0, 0, 1, 0, 0, 12, 12, 0, 0, 54, 0, 6, 18, 23, 102, 6, 6, 5, 12, 18, 27, 35, 102
INVAR-10, Run: 001, P, 0, 0, 1, 0, 0, 113, 113, 0, 0, 600, 0, 26, 200, 1033, 4510, 87, 68, 44, 113, 200, 300, 1146, 4510
INVAR-10, Run: 002, P, 0, 0, 1, 0, 0, 109, 109, 0, 0, 600, 0, 18, 200, 909, 3123, 91, 57, 51, 109, 200, 300, 1018, 3123
INVAR-10, Run: 003, P, 0, 0, 1, 0, 0, 112, 112, 0, 0, 600, 0, 24, 200, 1062, 5115, 88, 64, 47, 112, 200, 300, 1174, 5115
INVAR-10, Run: 004, P, 0, 0, 1, 0, 0, 111, 111, 0, 0, 600, 0, 22, 200, 1022, 4363, 89, 72, 38, 111, 200, 300, 1133, 4363
INVAR-10, Run: 005, P, 0, 0, 1, 0, 0, 110, 110, 0, 0, 600, 0, 20, 200, 961, 5269, 90, 70, 39, 110, 200, 300, 1071, 5269
INVAR-10, Run: 006, P, 0, 0, 1, 0, 0, 109, 109, 0, 0, 600, 0, 18, 200, 953, 4022, 91, 65, 43, 109, 200, 300, 1062, 4022
INVAR-10, Run: 007, P, 0, 0, 1, 0, 0, 112, 112, 0, 0, 600, 0, 24, 200, 912, 5473, 88, 63, 48, 112, 200, 300, 1024, 5473
INVAR-10, Run: 008, P, 0, 0, 1, 0, 0, 112, 112, 0, 0, 600, 0, 24, 200, 1186, 5904, 88, 71, 40, 112, 200, 300, 1298, 5904
INVAR-10, Run: 009, P, 0, 0, 1, 0, 0, 111, 111, 0, 0, 600, 0, 22, 200, 920, 3725, 89, 61, 49, 111, 200, 300, 1031, 3725
INVAR-10, Run: 010, P, 0, 0, 1, 0, 0, 107, 107, 0, 0, 600, 0, 14, 200, 1048, 3972, 93, 65, 41, 107, 200, 300, 1155, 3972
INVAR-10, Run: 011, P, 0, 0, 1, 0, 0, 108, 108, 0, 0, 600, 0, 16, 200, 1062, 4846, 92, 58, 49, 108, 200, 300, 1170, 4846
INVAR-10, Run: 012, P, 0, 0, 1, 0, 0, 113, 113, 0, 0, 600, 0, 26, 200, 1078, 4635, 87, 60, 52, 113, 200, 300, 1191, 4635
INVAR-10, Run: 013, P, 0, 0, 1, 0, 0, 112, 112, 0, 0, 600, 0, 24, 200, 1076, 5723, 88, 62, 49, 112, 200, 300, 1188, 5723
INVAR-10, Run: 014, P, 0, 0, 1, 0, 0, 108, 108, 0, 0, 600, 0, 16, 200, 985, 4644, 92, 67, 40, 108, 200, 300, 1093, 4644
INVAR-10, Run: 015, P, 0, 0, 1, 0, 0, 117, 117, 0, 0, 600, 0, 34, 200, 1288, 5074, 83, 59, 57, 117, 200, 300, 1405, 5074
INVAR-10, Run: 016, P, 0, 0, 1, 0, 0, 110, 110, 0, 0, 600, 0, 20, 200, 911, 4203, 90, 57, 52, 110, 200, 300, 1021, 4203
INVAR-10, Run: 017, P, 0, 0, 1, 0, 0, 109, 109, 0, 0, 600, 0, 18, 200, 972, 4453, 91, 70, 38, 109, 200, 300, 1081, 4453
INVAR-10, Run: 018, P, 0, 0, 1, 0, 0, 109, 109, 0, 0, 600, 0, 18, 200, 972, 5471, 91, 68, 40, 109, 200, 300, 1081, 5471
INVAR-10, Run: 019, P, 0, 0, 1, 0, 0, 113, 113, 0, 0, 600, 0, 26, 200, 1284, 5590, 87, 65, 47, 113, 200, 300, 1397, 5590
INVAR-10, Run: 020, P, 0, 0, 1, 0, 0, 109, 109, 0, 0, 600, 0, 18, 200, 925, 4701, 91, 73, 35, 109, 200, 300, 1034, 4701
INVAR-10, Run: 021, P, 0, 0, 1, 0, 0, 107, 107, 0, 0, 600, 0, 14, 200, 1392, 6006, 93, 56, 50, 107, 200, 300, 1499, 6006
INVAR-10, Run: 022, P, 0, 0, 1, 0, 0, 106, 106, 0, 0, 600, 0, 12, 200, 947, 4860, 94, 61, 44, 106, 200, 300, 1053, 4860
INVAR-10, Run: 023, P, 0, 0, 1, 0, 0, 111, 111, 0, 0, 600, 0, 22, 200, 1091, 4987, 89, 72, 38, 111, 200, 300, 1202, 4987
INVAR-10, Run: 024, P, 0, 0, 1, 0, 0, 109, 109, 0, 0, 600, 0, 18, 200, 1061, 5692, 91, 59, 49, 109, 200, 300, 1170, 5692
INVAR-10, Run: 025, P, 0, 0, 1, 0, 0, 111, 111, 0, 0, 600, 0, 22, 200, 1011, 4346, 89, 70, 40, 111, 200, 300, 1122, 4346
INVAR-10, Run: 026, P, 0, 0, 1, 0, 0, 110, 110, 0, 0, 600, 0, 20, 200, 1050, 4489, 90, 63, 46, 110, 200, 300, 1160, 4489
INVAR-10, Run: 027, P, 0, 0, 1, 0, 0, 113, 113, 0, 0, 600, 0, 26, 200, 1152, 5007, 87, 74, 38, 113, 200, 300, 1265, 5007
INVAR-10, Run: 028, P, 0, 0, 1, 0, 0, 110, 110, 0, 0, 600, 0, 20, 200, 1084, 4493, 90, 58, 51, 110, 200, 300, 1194, 4493
INVAR-10, Run: 029, P, 0, 0, 1, 0, 0, 112, 112, 0, 0, 600, 0, 24, 200, 1308, 4222, 88, 66, 45, 112, 200, 300, 1420, 4222
INVAR-10, Run: 030, P, 0, 0, 1, 0, 0, 109, 109, 0, 0, 600, 0, 18, 200, 887, 3689, 91, 66, 42, 109, 200, 300, 996, 3689
INVAR-10, Run: 031, P, 0, 0, 1, 0, 0, 113, 113, 0, 0, 600, 0, 26, 200, 1011, 3935, 87, 69, 43, 113, 200, 300, 1124, 3935
INVAR-10, Run: 032, P, 0, 0, 1, 0, 0, 108, 108, 0, 0, 600, 0, 16, 200, 1106, 4894, 92, 55, 52, 108, 200, 300, 1214, 4894
INVAR-10, Run: 033, P, 0, 0, 1, 0, 0, 110, 110, 0, 0, 600, 0, 20, 200, 1103, 4982, 90, 69, 40, 110, 200, 300, 1213, 4982
INVAR-10, Run: 034, P, 0, 0, 1, 0, 0, 107, 107, 0, 0, 600, 0, 14, 200, 793, 4182, 93, 65, 41, 107, 200, 300, 900, 4182
INVAR-10, Run: 035, P, 0, 0, 1, 0, 0, 107, 107, 0, 0, 600, 0, 14, 200, 1071, 4630, 93, 60, 46, 107, 200, 300, 1178, 4630
INVAR-10, Run: 036, P, 0, 0, 1, 0, 0, 110, 110, 0, 0, 600, 0, 20, 200, 1400, 5589, 90, 58, 51, 110, 200, 300, 1510, 5589
INVAR-10, Run: 037, P, 0, 0, 1, 0, 0, 110, 110, 0, 0, 600, 0, 20, 200, 952, 4105, 90, 57, 52, 110, 200, 300, 1062, 4105
INVAR-10, Run: 038, P, 0, 0, 1, 0, 0, 110, 110, 0, 0, 600, 0, 20, 200, 979, 3440, 90, 62, 47, 110, 200, 300, 1089, 3440
INVAR-10, Run: 039, P, 0, 0, 1, 0, 0, 109, 109, 0, 0, 600, 0, 18, 200, 1092, 4622, 91, 62, 46, 109, 200, 300, 1201, 4622
INVAR-10, Run: 040, P, 0, 0, 1, 0, 0, 110, 110, 0, 0, 600, 0, 20, 200, 1104, 5315, 90, 66, 43, 110, 200, 300, 1214, 5315
INVAR-10, Run: 041, P, 0, 0, 1, 0, 0, 108, 108, 0, 0, 600, 0, 16, 200, 951, 3876, 92, 62, 45, 108, 200, 300, 1059, 3876
INVAR-10, Run: 042, P, 0, 0, 1, 0, 0, 108, 108, 0, 0, 600, 0, 16, 200, 989, 4555, 92, 60, 47, 108, 200, 300, 1097, 4555
INVAR-10, Run: 043, P, 0, 0, 1, 0, 0, 109, 109, 0, 0, 600, 0, 18, 200, 1060, 4924, 91, 68, 40, 109, 200, 300, 1169, 4924
INVAR-10, Run: 044, P, 0, 0, 1, 0, 0, 108, 108, 0, 0, 600, 0, 16, 200, 1076, 4856, 92, 75, 32, 108, 200, 300, 1184, 4856
INVAR-10, Run: 045, P, 0, 0, 1, 0, 0, 111, 111, 0, 0, 600, 0, 22, 200, 846, 3785, 89, 69, 41, 111, 200, 300, 957, 3785
INVAR-10, Run: 046, P, 0, 0, 1, 0, 0, 110, 110, 0, 0, 600, 0, 20, 200, 886, 5322, 90, 63, 46, 110, 200, 300, 996, 5322
INVAR-10, Run: 047, P, 0, 0, 1, 0, 0, 113, 113, 0, 0, 600, 0, 26, 200, 1247, 4315, 87, 57, 55, 113, 200, 300, 1360, 4315
INVAR-10, Run: 048, P, 0, 0, 1, 0, 0, 114, 114, 0, 0, 600, 0, 28, 200, 961, 4660, 86, 73, 40, 114, 200, 300, 1075, 4660
INVAR-10, Run: 049, P, 0, 0, 1, 0, 0, 106, 106, 0, 0, 600, 0, 12, 200, 791, 4026, 94, 65, 40, 106, 200, 300, 897, 4026
INVAR-10, Run: 050, P, 0, 0, 1, 0, 0, 108, 108, 0, 0, 600, 0, 16, 200, 1186, 6954, 92, 60, 47, 108, 200, 300, 1294, 6954
INVAR-10, Run: 051, P, 0, 0, 1, 0, 0, 106, 106, 0, 0, 600, 0, 12, 200, 949, 3909, 94, 61, 44, 106, 200, 300, 1055, 3909
INVAR-10, Run: 052, P, 0, 0, 1, 0, 0, 110, 110, 0, 0, 600, 0, 20, 200, 941, 3979, 90, 63, 46, 110, 200, 300, 1051, 3979
INVAR-10, Run: 053, P, 0, 0, 1, 0, 0, 108, 108, 0, 0, 600, 0, 16, 200, 991, 4761, 92, 61, 46, 108, 200, 300, 1099, 4761
INVAR-10, Run: 054, P, 0, 0, 1, 0, 0, 108, 108, 0, 0, 600, 0, 16, 200, 995, 4688, 92, 60, 47, 108, 200, 300, 1103, 4688
INVAR-10, Run: 055, P, 0, 0, 1, 0, 0, 111, 111, 0, 0, 600, 0, 22, 200, 993, 6226, 89, 59, 51, 111, 200, 300, 1104, 6226
INVAR-10, Run: 056, P, 0, 0, 1, 0, 0, 113, 113, 0, 0, 600, 0, 26, 200, 959, 4388, 87, 74, 38, 113, 200, 300, 1072, 4388
INVAR-10, Run: 057, P, 0, 0, 1, 0, 0, 107, 107, 0, 0, 600, 0, 14, 200, 843, 4110, 93, 66, 40, 107, 200, 300, 950, 4110
INVAR-10, Run: 058, P, 0, 0, 1, 0, 0, 107, 107, 0, 0, 600, 0, 14, 200, 809, 4148, 93, 65, 41, 107, 200, 300, 916, 4148
INVAR-10, Run: 059, P, 0, 0, 1, 0, 0, 109, 109, 0, 0, 600, 0, 18, 200, 1022, 3685, 91, 53, 55, 109, 200, 300, 1131, 3685
INVAR-10, Run: 060, P, 0, 0, 1, 0, 0, 111, 111, 0, 0, 600, 0, 22, 200, 889, 3890, 89, 59, 51, 111, 200, 300, 1000, 3890
INVAR-10, Run: 061, P, 0, 0, 1, 0, 0, 109, 109, 0, 0, 600, 0, 18, 200, 1015, 6160, 91, 68, 40, 109, 200, 300, 1124, 6160
INVAR-10, Run: 062, P, 0, 0, 1, 0, 0, 110, 110, 0, 0, 600, 0, 20, 200, 865, 4084, 90, 67, 42, 110, 200, 300, 975, 4084
INVAR-10, Run: 063, P, 0, 0, 1, 0, 0, 111, 111, 0, 0, 600, 0, 22, 200, 912, 3776, 89, 58, 52, 111, 200, 300, 1023, 3776
INVAR-10, Run: 064, P, 0, 0, 1, 0, 0, 108, 108, 0, 0, 600, 0, 16, 200, 1065, 5301, 92, 62, 45, 108, 200, 300, 1173, 5301
INVAR-10, Run: 065, P, 0, 0, 1, 0, 0, 109, 109, 0, 0, 600, 0, 18, 200, 1137, 4564, 91, 62, 46, 109, 200, 300, 1246, 4564
INVAR-10, Run: 066, P, 0, 0, 1, 0, 0, 106, 106, 0, 0, 600, 0, 12, 200, 1017, 4103, 94, 56, 49, 106, 200, 300, 1123, 4103
INVAR-10, Run: 067, P, 0, 0, 1, 0, 0, 112, 112, 0, 0, 600, 0, 24, 200, 973, 3879, 88, 63, 48, 112, 200, 300, 1085, 3879
INVAR-10, Run: 068, P, 0, 0, 1, 0, 0, 111, 111, 0, 0, 600, 0, 22, 200, 1314, 4057, 89, 66, 44, 111, 200, 300, 1425, 4057
INVAR-10, Run: 069, P, 0, 0, 1, 0, 0, 111, 111, 0, 0, 600, 0, 22, 200, 1471, 6479, 89, 68, 42, 111, 200, 300, 1582, 6479
INVAR-10, Run: 070, P, 0, 0, 1, 0, 0, 111, 111, 0, 0, 600, 0, 22, 200, 1052, 4814, 89, 66, 44, 111, 200, 300, 1163, 4814
INVAR-10, Run: 071, P, 0, 0, 1, 0, 0, 109, 109, 0, 0, 600, 0, 18, 200, 1138, 4824, 91, 67, 41, 109, 200, 300, 1247, 4824
INVAR-10, Run: 072, P, 0, 0, 1, 0, 0, 109, 109, 0, 0, 600, 0, 18, 200, 769, 4018, 91, 71, 37, 109, 200, 300, 878, 4018
INVAR-10, Run: 073, P, 0, 0, 1, 0, 0, 114, 114, 0, 0, 600, 0, 28, 200, 1236, 6940, 86, 72, 41, 114, 200, 300, 1350, 6940
INVAR-10, Run: 074, P, 0, 0, 1, 0, 0, 116, 116, 0, 0, 600, 0, 32, 200, 1099, 5122, 84, 71, 44, 116, 200, 300, 1215, 5122
INVAR-10, Run: 075, P, 0, 0, 1, 0, 0, 111, 111, 0, 0, 600, 0, 22, 200, 938, 3976, 89, 62, 48, 111, 200, 300, 1049, 3976
INVAR-10, Run: 076, P, 0, 0, 1, 0, 0, 109, 109, 0, 0, 600, 0, 18, 200, 1023, 5031, 91, 52, 56, 109, 200, 300, 1132, 5031
INVAR-10, Run: 077, P, 0, 0, 1, 0, 0, 111, 111, 0, 0, 600, 0, 22, 200, 1032, 5324, 89, 71, 39, 111, 200, 300, 1143, 5324
INVAR-10, Run: 078, P, 0, 0, 1, 0, 0, 109, 109, 0, 0, 600, 0, 18, 200, 1134, 4813, 91, 68, 40, 109, 200, 300, 1243, 4813
INVAR-10, Run: 079, P, 0, 0, 1, 0, 0, 112, 112, 0, 0, 600, 0, 24, 200, 1209, 5773, 88, 58, 53, 112, 200, 300, 1321, 5773
INVAR-10, Run: 080, P, 0, 0, 1, 0, 0, 110, 110, 0, 0, 600, 0, 20, 200, 1075, 5287, 90, 65, 44, 110, 200, 300, 1185, 5287
INVAR-10, Run: 081, P, 0, 0, 1, 0, 0, 113, 113, 0, 0, 600, 0, 26, 200, 1372, 5112, 87, 67, 45, 113, 200, 300, 1485, 5112
INVAR-10, Run: 082, P, 0, 0, 1, 0, 0, 107, 107, 0, 0, 600, 0, 14, 200, 736, 4136, 93, 70, 36, 107, 200, 300, 843, 4136
INVAR-10, Run: 083, P, 0, 0, 1, 0, 0, 108, 108, 0, 0, 600, 0, 16, 200, 1084, 4062, 92, 54, 53, 108, 200, 300, 1192, 4062
INVAR-10, Run: 084, P, 0, 0, 1, 0, 0, 110, 110, 0, 0, 600, 0, 20, 200, 1017, 4093, 90, 66, 43, 110, 200, 300, 1127, 4093
INVAR-10, Run: 085, P, 0, 0, 1, 0, 0, 111, 111, 0, 0, 600, 0, 22, 200, 1025, 4453, 89, 70, 40, 111, 200, 300, 1136, 4453
INVAR-10, Run: 086, P, 0, 0, 1, 0, 0, 107, 107, 0, 0, 600, 0, 14, 200, 1081, 4783, 93, 43, 63, 107, 200, 300, 1188, 4783
INVAR-10, Run: 087, P, 0, 0, 1, 0, 0, 107, 107, 0, 0, 600, 0, 14, 200, 937, 5013, 93, 51, 55, 107, 200, 300, 1044, 5013
INVAR-10, Run: 088, P, 0, 0, 1, 0, 0, 111, 111, 0, 0, 600, 0, 22, 200, 1132, 5750, 89, 66, 44, 111, 200, 300, 1243, 5750
INVAR-10, Run: 089, P, 0, 0, 1, 0, 0, 108, 108, 0, 0, 600, 0, 16, 200, 807, 4281, 92, 64, 43, 108, 200, 300, 915, 4281
INVAR-10, Run: 090, P, 0, 0, 1, 0, 0, 113, 113, 0, 0, 600, 0, 26, 200, 1254, 4634, 87, 64, 48, 113, 200, 300, 1367, 4634
INVAR-10, Run: 091, P, 0, 0, 1, 0, 0, 108, 108, 0, 0, 600, 0, 16, 200, 1236, 5103, 92, 59, 48, 108, 200, 300, 1344, 5103
INVAR-10, Run: 092, P, 0, 0, 1, 0, 0, 111, 111, 0, 0, 600, 0, 22, 200, 1097, 5315, 89, 70, 40, 111, 200, 300, 1208, 5315
INVAR-10, Run: 093, P, 0, 0, 1, 0, 0, 111, 111, 0, 0, 600, 0, 22, 200, 785, 4378, 89, 73, 37, 111, 200, 300, 896, 4378
INVAR-10, Run: 094, P, 0, 0, 1, 0, 0, 111, 111, 0, 0, 600, 0, 22, 200, 1153, 4484, 89, 63, 47, 111, 200, 300, 1264, 4484
INVAR-10, Run: 095, P, 0, 0, 1, 0, 0, 106, 106, 0, 0, 600, 0, 12, 200, 997, 3493, 94, 55, 50, 106, 200, 300, 1103, 3493
INVAR-10, Run: 096, P, 0, 0, 1, 0, 0, 110, 110, 0, 0, 600, 0, 20, 200, 883, 4022, 90, 58, 51, 110, 200, 300, 993, 4022
INVAR-10, Run: 097, P, 0, 0, 1, 0, 0, 115, 115, 0, 0, 600, 0, 30, 200, 1116, 5194, 85, 58, 56, 115, 200, 300, 1231, 5194
INVAR-10, Run: 098, P, 0, 0, 1, 0, 0, 111, 111, 0, 0, 600, 0, 22, 200, 1074, 3638, 89, 65, 45, 111, 200, 300, 1185, 3638
INVAR-10, Run: 099, P, 0, 0, 1, 0, 0, 110, 110, 0, 0, 600, 0, 20, 200, 1130, 5367, 90, 72, 37, 110, 200, 300, 1240, 5367
INVAR-10, Run: 100, P, 0, 0, 1, 0, 0, 109, 109, 0, 0, 600, 0, 18, 200, 995, 3924, 91, 62, 46, 109, 200, 300, 1104, 3924
INVAR-2, Run: 001, P, 0, 0, 1, 0, 0, 34, 34, 0, 0, 168, 0, 12, 56, 127, 490, 22, 19, 14, 34, 56, 84, 161, 490
INVAR-2, Run: 002, P, 0, 0, 1, 0, 0, 33, 33, 0, 0, 168, 0, 10, 56, 131, 682, 23, 20, 12, 33, 56, 84, 164, 682
INVAR-2, Run: 003, P, 0, 0, 1, 0, 0, 31, 31, 0, 0, 168, 0, 6, 56, 132, 455, 25, 17, 13, 31, 56, 84, 163, 455
INVAR-2, Run: 004, P, 0, 0, 1, 0, 0, 33, 33, 0, 0, 168, 0, 10, 56, 127, 661, 23, 21, 11, 33, 56, 84, 160, 661
INVAR-2, Run: 005, P, 0, 0, 1, 0, 0, 31, 31, 0, 0, 168, 0, 6, 56, 151, 803, 25, 18, 12, 31, 56, 84, 182, 803
INVAR-2, Run: 006, P, 0, 0, 1, 0, 0, 36, 36, 0, 0, 168, 0, 16, 56, 165, 521, 20, 20, 15, 36, 56, 84, 201, 521
INVAR-2, Run: 007, P, 0, 0, 1, 0, 0, 33, 33, 0, 0, 168, 0, 10, 56, 160, 525, 23, 17, 15, 33, 56, 84, 193, 525
INVAR-2, Run: 008, P, 0, 0, 1, 0, 0, 31, 31, 0, 0, 168, 0, 6, 56, 113, 611, 25, 19, 11, 31, 56, 84, 144, 611
INVAR-2, Run: 009, P, 0, 0, 1, 0, 0, 32, 32, 0, 0, 168, 0, 8, 56, 115, 437, 24, 20, 11, 32, 56, 84, 147, 437
INVAR-2, Run: 010, P, 0, 0, 1, 0, 0, 33, 33, 0, 0, 168, 0, 10, 56, 172, 594, 23, 15, 17, 33, 56, 84, 205, 594
INVAR-2, Run: 011, P, 0, 0, 1, 0, 0, 31, 31, 0, 0, 168, 0, 6, 56, 105, 476, 25, 15, 15, 31, 56, 84, 136, 476
INVAR-2, Run: 012, P, 0, 0, 1, 0, 0, 31, 31, 0, 0, 168, 0, 6, 56, 124, 519, 25, 19, 11, 31, 56, 84, 155, 519
INVAR-2, Run: 013, P, 0, 0, 1, 0, 0, 33, 33, 0, 0, 168, 0, 10, 56, 199, 736, 23, 18, 14, 33, 56, 84, 232, 736
INVAR-2, Run: 014, P, 0, 0, 1, 0, 0, 34, 34, 0, 0, 168, 0, 12, 56, 123, 606, 22, 21, 12, 34, 56, 84, 157, 606
INVAR-2, Run: 015, P, 0, 0, 1, 0, 0, 33, 33, 0, 0, 168, 0, 10, 56, 101, 406, 23, 23, 9, 33, 56, 84, 134, 406
INVAR-2, Run: 016, P, 0, 0, 1, 0, 0, 32, 32, 0, 0, 168, 0, 8, 56, 140, 630, 24, 19, 12, 32, 56, 84, 172, 630
INVAR-2, Run: 017, P, 0, 0, 1, 0, 0, 32, 32, 0, 0, 168, 0, 8, 56, 133, 621, 24, 20, 11, 32, 56, 84, 165, 621
INVAR-2, Run: 018, P, 0, 0, 1, 0, 0, 33, 33, 0, 0, 168, 0, 10, 56, 175, 700, 23, 16, 16, 33, 56, 84, 208, 700
INVAR-2, Run: 019, P, 0, 0, 1, 0, 0, 32, 32, 0, 0, 168, 0, 8, 56, 120, 510, 24, 20, 11, 32, 56, 84, 152, 510
INVAR-2, Run: 020, P, 0, 0, 1, 0, 0, 34, 34, 0, 0, 168, 0, 12, 56, 212, 705, 22, 16, 17, 34, 56, 84, 246, 705
INVAR-2, Run: 021, P, 0, 0, 1, 0, 0, 30, 30, 0, 0, 168, 0, 4, 56, 216, 912, 26, 20, 9, 30, 56, 84, 246, 912
INVAR-2, Run: 022, P, 0, 0, 1, 0, 0, 32, 32, 0, 0, 168, 0, 8, 56, 162, 904, 24, 20, 11, 32, 56, 84, 194, 904
INVAR-2, Run: 023, P, 0, 0, 1, 0, 0, 34, 34, 0, 0, 168, 0, 12, 56, 102, 404, 22, 18, 15, 34, 56, 84, 136, 404
INVAR-2, Run: 024, P, 0, 0, 1, 0, 0, 33, 33, 0, 0, 168, 0, 10, 56, 79, 486, 23, 22, 10, 33, 56, 84, 112, 486
INVAR-2, Run: 025, P, 0, 0, 1, 0, 0, 34, 34, 0, 0, 168, 0, 12, 56, 136, 611, 22, 18, 15, 34, 56, 84, 170, 611
INVAR-2, Run: 026, P, 0, 0, 1, 0, 0, 32, 32, 0, 0, 168, 0, 8, 56, 196, 829, 24, 15, 16, 32, 56, 84, 228, 829
INVAR-2, Run: 027, P, 0, 0, 1, 0, 0, 32, 32, 0, 0, 168, 0, 8, 56, 187, 688, 24, 22, 9, 32, 56, 84, 219, 688
INVAR-2, Run: 028, P, 0, 0, 1, 0, 0, 33, 33, 0, 0, 168, 0, 10, 56, 170, 716, 23, 18, 14, 33, 56, 84, 203, 716
INVAR-2, Run: 029, P, 0, 0, 1, 0, 0, 31, 31, 0, 0, 168, 0, 6, 56, 70, 483, 25, 18, 12, 31, 56, 84, 101, 483
INVAR-2, Run: 030, P, 0, 0, 1, 0, 0, 33, 33, 0, 0, 168, 0, 10, 56, 190, 798, 23, 16, 16, 33, 56, 84, 223, 798
INVAR-2, Run: 031, P, 0, 0, 1, 0, 0, 32, 32, 0, 0, 168, 0, 8, 56, 133, 496, 24, 17, 14, 32, 56, 84, 165, 496
INVAR-2, Run: 032, P, 0, 0, 1, 0, 0, 32, 32, 0, 0, 168, 0, 8, 56, 129, 417, 24, 18, 13, 32, 56, 84, 161, 417
INVAR-2, Run: 033, P, 0, 0, 1, 0, 0, 32, 32, 0, 0, 168, 0, 8, 56, 131, 635, 24, 20, 11, 32, 56, 84, 163, 635
INVAR-2, Run: 034, P, 0, 0, 1, 0, 0, 34, 34, 0, 0, 168, 0, 12, 56, 209, 570, 22, 19, 14, 34, 56, 84, 243, 570
INVAR-2, Run: 035, P, 0, 0, 1, 0, 0, 33, 33, 0, 0, 168, 0, 10, 56, 276, 1066, 23, 15, 17, 33, 56, 84, 309, 1066
INVAR-2, Run: 036, P, 0, 0, 1, 0, 0, 34, 34, 0, 0, 168, 0, 12, 56, 173, 557, 22, 21, 12, 34, 56, 84, 207, 557
INVAR-2, Run: 037, P, 0, 0, 1, 0, 0, 32, 32, 0, 0, 168, 0, 8, 56, 167, 628, 24, 11, 20, 32, 56, 84, 199, 628
INVAR-2, Run: 038, P, 0, 0, 1, 0, 0, 33, 33, 0, 0, 168, 0, 10, 56, 202, 661, 23, 18, 14, 33, 56, 84, 235, 661
INVAR-2, Run: 039, P, 0, 0, 1, 0, 0, 33, 33, 0, 0, 168, 0, 10, 56, 153, 462, 23, 19, 13, 33, 56, 84, 186, 462
INVAR-2, Run: 040, P, 0, 0, 1, 0, 0, 34, 34, 0, 0, 168, 0, 12, 56, 156, 370, 22, 18, 15, 34, 56, 84, 190, 370
INVAR-2, Run: 041, P, 0, 0, 1, 0, 0, 33, 33, 0, 0, 168, 0, 10, 56, 144, 655, 23, 17, 15, 33, 56, 84, 177, 655
INVAR-2, Run: 042, P, 0, 0, 1, 0, 0, 31, 31, 0, 0, 168, 0, 6, 56, 103, 404, 25, 17, 13, 31, 56, 84, 134, 404
INVAR-2, Run: 043, P, 0, 0, 1, 0, 0, 34, 34, 0, 0, 168, 0, 12, 56, 124, 715, 22, 20, 13, 34, 56, 84, 158, 715
INVAR-2, Run: 044, P, 0, 0, 1, 0, 0, 34, 34, 0, 0, 168, 0, 12, 56, 242, 615, 22, 19, 14, 34, 56, 84, 276, 615
INVAR-2, Run: 045, P, 0, 0, 1, 0, 0, 31, 31, 0, 0, 168, 0, 6, 56, 127, 609, 25, 19, 11, 31, 56, 84, 158, 609
INVAR-2, Run: 046, P, 0, 0, 1, 0, 0, 35, 35, 0, 0, 168, 0, 14, 56, 188, 602, 21, 19, 15, 35, 56, 84, 223, 602
INVAR-2, Run: 047, P, 0, 0, 1, 0, 0, 33, 33, 0, 0, 168, 0, 10, 56, 130, 548, 23, 18, 14, 33, 56, 84, 163, 548
INVAR-2, Run: 048, P, 0, 0, 1, 0, 0, 32, 32, 0, 0, 168, 0, 8, 56, 139, 783, 24, 18, 13, 32, 56, 84, 171, 783
INVAR-2, Run: 049, P, 0, 0, 1, 0, 0, 34, 34, 0, 0, 168, 0, 12, 56, 132, 459, 22, 19, 14, 34, 56, 84, 166, 459
INVAR-2, Run: 050, P, 0, 0, 1, 0, 0, 34, 34, 0, 0, 168, 0, 12, 56, 125, 515, 22, 17, 16, 34, 56, 84, 159, 515
INVAR-2, Run: 051, P, 0, 0, 1, 0, 0, 35, 35, 0, 0, 168, 0, 14, 56, 166, 776, 21, 20, 14, 35, 56, 84, 201, 776
INVAR-2, Run: 052, P, 0, 0, 1, 0, 0, 34, 34, 0, 0, 168, 0, 12, 56, 125, 730, 22, 19, 14, 34, 56, 84, 159, 730
INVAR-2, Run: 053, P, 0, 0, 1, 0, 0, 31, 31, 0, 0, 168, 0, 6, 56, 84, 389, 25, 18, 12, 31, 56, 84, 115, 389
INVAR-2, Run: 054, P, 0, 0, 1, 0, 0, 31, 31, 0, 0, 168, 0, 6, 56, 126, 708, 25, 18, 12, 31, 56, 84, 157, 708
INVAR-2, Run: 055, P, 0, 0, 1, 0, 0, 32, 32, 0, 0, 168, 0, 8, 56, 145, 709, 24, 21, 10, 32, 56, 84, 177, 709
INVAR-2, Run: 056, P, 0, 0, 1, 0, 0, 32, 32, 0, 0, 168, 0, 8, 56, 129, 535, 24, 16, 15, 32, 56, 84, 161, 535
INVAR-2, Run: 057, P, 0, 0, 1, 0, 0, 33, 33, 0, 0, 168, 0, 10, 56, 128, 440, 23, 17, 15, 33, 56, 84, 161, 440
INVAR-2, Run: 058, P, 0, 0, 1, 0, 0, 33, 33, 0, 0, 168, 0, 10, 56, 177, 617, 23, 12, 20, 33, 56, 84, 210, 617
INVAR-2, Run: 059, P, 0, 0, 1, 0, 0, 31, 31, 0, 0, 168, 0, 6, 56, 136, 347, 25, 13, 17, 31, 56, 84, 167, 347
INVAR-2, Run: 060, P, 0, 0, 1, 0, 0, 32, 32, 0, 0, 168, 0, 8, 56, 121, 515, 24, 15, 16, 32, 56, 84, 153, 515
INVAR-2, Run: 061, P, 0, 0, 1, 0, 0, 33, 33, 0, 0, 168, 0, 10, 56, 153, 594, 23, 21, 11, 33, 56, 84, 186, 594
INVAR-2, Run: 062, P, 0, 0, 1, 0, 0, 31, 31, 0, 0, 168, 0, 6, 56, 160, 665, 25, 12, 18, 31, 56, 84, 191, 665
INVAR-2, Run: 063, P, 0, 0, 1, 0, 0, 33, 33, 0, 0, 168, 0, 10, 56, 128, 668, 23, 15, 17, 33, 56, 84, 161, 668
INVAR-2, Run: 064, P, 0, 0, 1, 0, 0, 31, 31, 0, 0, 168, 0, 6, 56, 122, 483, 25, 14, 16, 31, 56, 84, 153, 483
INVAR-2, Run: 065, P, 0, 0, 1, 0, 0, 34, 34, 0, 0, 168, 0, 12, 56, 141, 434, 22, 19, 14, 34, 56, 84, 175, 434
INVAR-2, Run: 066, P, 0, 0, 1, 0, 0, 34, 34, 0, 0, 168, 0, 12, 56, 148, 319, 22, 14, 19, 34, 56, 84, 182, 319
INVAR-2, Run: 067, P, 0, 0, 1, 0, 0, 32, 32, 0, 0, 168, 0, 8, 56, 198, 764, 24, 20, 11, 32, 56, 84, 230, 764
INVAR-2, Run: 068, P, 0, 0, 1, 0, 0, 33, 33, 0, 0, 168, 0, 10, 56, 141, 374, 23, 19, 13, 33, 56, 84, 174, 374
INVAR-2, Run: 069, P, 0, 0, 1, 0, 0, 35, 35, 0, 0, 168, 0, 14, 56, 182, 523, 21, 16, 18, 35, 56, 84, 217, 523
INVAR-2, Run: 070, P, 0, 0, 1, 0, 0, 33, 33, 0, 0, 168, 0, 10, 56, 161, 855, 23, 16, 16, 33, 56, 84, 194, 855
INVAR-2, Run: 071, P, 0, 0, 1, 0, 0, 33, 33, 0, 0, 168, 0, 10, 56, 135, 515, 23, 13, 19, 33, 56, 84, 168, 515
INVAR-2, Run: 072, P, 0, 0, 1, 0, 0, 31, 31, 0, 0, 168, 0, 6, 56, 177, 541, 25, 15, 15, 31, 56, 84, 208, 541
INVAR-2, Run: 073, P, 0, 0, 1, 0, 0, 34, 34, 0, 0, 168, 0, 12, 56, 143, 549, 22, 18, 15, 34, 56, 84, 177, 549
INVAR-2, Run: 074, P, 0, 0, 1, 0, 0, 32, 32, 0, 0, 168, 0, 8, 56, 180, 691, 24, 17, 14, 32, 56, 84, 212, 691
INVAR-2, Run: 075, P, 0, 0, 1, 0, 0, 35, 35, 0, 0, 168, 0, 14, 56, 156, 802, 21, 26, 8, 35, 56, 84, 191, 802
INVAR-2, Run: 076, P, 0, 0, 1, 0, 0, 38, 38, 0, 0, 168, 0, 20, 56, 172, 559, 18, 22, 15, 38, 56, 84, 210, 559
INVAR-2, Run: 077, P, 0, 0, 1, 0, 0, 36, 36, 0, 0, 168, 0, 16, 56, 156, 526, 20, 20, 15, 36, 56, 84, 192, 526
INVAR-2, Run: 078, P, 0, 0, 1, 0, 0, 32, 32, 0, 0, 168, 0, 8, 56, 120, 518, 24, 23, 8, 32, 56, 84, 152, 518
INVAR-2, Run: 079, P, 0, 0, 1, 0, 0, 33, 33, 0, 0, 168, 0, 10, 56, 152, 509, 23, 18, 14, 33, 56, 84, 185, 509
INVAR-2, Run: 080, P, 0, 0, 1, 0, 0, 34, 34, 0, 0, 168, 0, 12, 56, 147, 493, 22, 17, 16, 34, 56, 84, 181, 493
INVAR-2, Run: 081, P, 0, 0, 1, 0, 0, 34, 34, 0, 0, 168, 0, 12, 56, 127, 493, 22, 19, 14, 34, 56, 84, 161, 493
INVAR-2, Run: 082, P, 0, 0, 1, 0, 0, 31, 31, 0, 0, 168, 0, 6, 56, 127, 508, 25, 15, 15, 31, 56, 84, 158, 508
INVAR-2, Run: 083, P, 0, 0, 1, 0, 0, 33, 33, 0, 0, 168, 0, 10, 56, 178, 532, 23, 22, 10, 33, 56, 84, 211, 532
INVAR-2, Run: 084, P, 0, 0, 1, 0, 0, 34, 34, 0, 0, 168, 0, 12, 56, 175, 481, 22, 17, 16, 34, 56, 84, 209, 481
INVAR-2, Run: 085, P, 0, 0, 1, 0, 0, 33, 33, 0, 0, 168, 0, 10, 56, 163, 806, 23, 21, 11, 33, 56, 84, 196, 806
INVAR-2, Run: 086, P, 0, 0, 1, 0, 0, 35, 35, 0, 0, 168, 0, 14, 56, 157, 785, 21, 23, 11, 35, 56, 84, 192, 785
INVAR-2, Run: 087, P, 0, 0, 1, 0, 0, 33, 33, 0, 0, 168, 0, 10, 56, 143, 560, 23, 14, 18, 33, 56, 84, 176, 560
INVAR-2, Run: 088, P, 0, 0, 1, 0, 0, 33, 33, 0, 0, 168, 0, 10, 56, 163, 877, 23, 25, 7, 33, 56, 84, 196, 877
INVAR-2, Run: 089, P, 0, 0, 1, 0, 0, 34, 34, 0, 0, 168, 0, 12, 56, 126, 398, 22, 22, 11, 34, 56, 84, 160, 398
INVAR-2, Run: 090, P, 0, 0, 1, 0, 0, 31, 31, 0, 0, 168, 0, 6, 56, 129, 434, 25, 8, 22, 31, 56, 84, 160, 434
INVAR-2, Run: 091, P, 0, 0, 1, 0, 0, 33, 33, 0, 0, 168, 0, 10, 56, 199, 717, 23, 16, 16, 33, 56, 84, 232, 717
INVAR-2, Run: 092, P, 0, 0, 1, 0, 0, 35, 35, 0, 0, 168, 0, 14, 56, 243, 594, 21, 13, 21, 35, 56, 84, 278, 594
INVAR-2, Run: 093, P, 0, 0, 1, 0, 0, 31, 31, 0, 0, 168, 0, 6, 56, 154, 621, 25, 17, 13, 31, 56, 84, 185, 621
INVAR-2, Run: 094, P, 0, 0, 1, 0, 0, 33, 33, 0, 0, 168, 0, 10, 56, 212, 633, 23, 16, 16, 33, 56, 84, 245, 633
INVAR-2, Run: 095, P, 0, 0, 1, 0, 0, 34, 34, 0, 0, 168, 0, 12, 56, 199, 760, 22, 24, 9, 34, 56, 84, 233, 760
INVAR-2, Run: 096, P, 0, 0, 1, 0, 0, 33, 33, 0, 0, 168, 0, 10, 56, 102, 525, 23, 21, 11, 33, 56, 84, 135, 525
INVAR-2, Run: 097, P, 0, 0, 1, 0, 0, 31, 31, 0, 0, 168, 0, 6, 56, 132, 571, 25, 22, 8, 31, 56, 84, 163, 571
INVAR-2, Run: 098, P, 0, 0, 1, 0, 0, 32, 32, 0, 0, 168, 0, 8, 56, 130, 711, 24, 20, 11, 32, 56, 84, 162, 711
INVAR-2, Run: 099, P, 0, 0, 1, 0, 0, 35, 35, 0, 0, 168, 0, 14, 56, 196, 937, 21, 18, 16, 35, 56, 84, 231, 937
INVAR-2, Run: 100, P, 0, 0, 1, 0, 0, 33, 33, 0, 0, 168, 0, 10, 56, 149, 699, 23, 16, 16, 33, 56, 84, 182, 699
INVAR-3, Run: 001, P, 0, 0, 1, 0, 0, 89, 89, 0, 0, 492, 0, 14, 164, 722, 3342, 75, 55, 33, 89, 164, 246, 811, 3342
INVAR-3, Run: 002, P, 0, 0, 1, 0, 0, 91, 91, 0, 0, 492, 0, 18, 164, 903, 4135, 73, 48, 42, 91, 164, 246, 994, 4135
INVAR-3, Run: 003, P, 0, 0, 1, 0, 0, 90, 90, 0, 0, 492, 0, 16, 164, 849, 4298, 74, 48, 41, 90, 164, 246, 939, 4298
INVAR-3, Run: 004, P, 0, 0, 1, 0, 0, 89, 89, 0, 0, 492, 0, 14, 164, 693, 2775, 75, 53, 35, 89, 164, 246, 782, 2775
INVAR-3, Run: 005, P, 0, 0, 1, 0, 0, 91, 91, 0, 0, 492, 0, 18, 164, 695, 2815, 73, 52, 38, 91, 164, 246, 786, 2815
INVAR-3, Run: 006, P, 0, 0, 1, 0, 0, 86, 86, 0, 0, 492, 0, 8, 164, 903, 3028, 78, 43, 42, 86, 164, 246, 989, 3028
INVAR-3, Run: 007, P, 0, 0, 1, 0, 0, 90, 90, 0, 0, 492, 0, 16, 164, 914, 2728, 74, 41, 48, 90, 164, 246, 1004, 2728
INVAR-3, Run: 008, P, 0, 0, 1, 0, 0, 90, 90, 0, 0, 492, 0, 16, 164, 659, 3103, 74, 59, 30, 90, 164, 246, 749, 3103
INVAR-3, Run: 009, P, 0, 0, 1, 0, 0, 91, 91, 0, 0, 492, 0, 18, 164, 800, 2737, 73, 50, 40, 91, 164, 246, 891, 2737
INVAR-3, Run: 010, P, 0, 0, 1, 0, 0, 91, 91, 0, 0, 492, 0, 18, 164, 800, 3941, 73, 58, 32, 91, 164, 246, 891, 3941
INVAR-3, Run: 011, P, 0, 0, 1, 0, 0, 93, 93, 0, 0, 492, 0, 22, 164, 717, 3594, 71, 61, 31, 93, 164, 246, 810, 3594
INVAR-3, Run: 012, P, 0, 0, 1, 0, 0, 90, 90, 0, 0, 492, 0, 16, 164, 592, 2928, 74, 59, 30, 90, 164, 246, 682, 2928
INVAR-3, Run: 013, P, 0, 0, 1, 0, 0, 88, 88, 0, 0, 492, 0, 12, 164, 713, 3321, 76, 54, 33, 88, 164, 246, 801, 3321
INVAR-3, Run: 014, P, 0, 0, 1, 0, 0, 89, 89, 0, 0, 492, 0, 14, 164, 629, 3064, 75, 52, 36, 89, 164, 246, 718, 3064
INVAR-3, Run: 015, P, 0, 0, 1, 0, 0, 89, 89, 0, 0, 492, 0, 14, 164, 708, 3965, 75, 42, 46, 89, 164, 246, 797, 3965
INVAR-3, Run: 016, P, 0, 0, 1, 0, 0, 93, 93, 0, 0, 492, 0, 22, 164, 799, 2772, 71, 55, 37, 93, 164, 246, 892, 2772
INVAR-3, Run: 017, P, 0, 0, 1, 0, 0, 95, 95, 0, 0, 492, 0, 26, 164, 878, 3226, 69, 46, 48, 95, 164, 246, 973, 3226
INVAR-3, Run: 018, P, 0, 0, 1, 0, 0, 91, 91, 0, 0, 492, 0, 18, 164, 751, 3633, 73, 58, 32, 91, 164, 246, 842, 3633
INVAR-3, Run: 019, P, 0, 0, 1, 0, 0, 93, 93, 0, 0, 492, 0, 22, 164, 891, 3719, 71, 49, 43, 93, 164, 246, 984, 3719
INVAR-3, Run: 020, P, 0, 0, 1, 0, 0, 92, 92, 0, 0, 492, 0, 20, 164, 775, 3761, 72, 53, 38, 92, 164, 246, 867, 3761
INVAR-3, Run: 021, P, 0, 0, 1, 0, 0, 91, 91, 0, 0, 492, 0, 18, 164, 770, 3458, 73, 55, 35, 91, 164, 246, 861, 3458
INVAR-3, Run: 022, P, 0, 0, 1, 0, 0, 93, 93, 0, 0, 492, 0, 22, 164, 806, 2742, 71, 56, 36, 93, 164, 246, 899, 2742
INVAR-3, Run: 023, P, 0, 0, 1, 0, 0, 88, 88, 0, 0, 492, 0, 12, 164, 643, 3861, 76, 52, 35, 88, 164, 246, 731, 3861
INVAR-3, Run: 024, P, 0, 0, 1, 0, 0, 89, 89, 0, 0, 492, 0, 14, 164, 872, 3015, 75, 50, 38, 89, 164, 246, 961, 3015
INVAR-3, Run: 025, P, 0, 0, 1, 0, 0, 89, 89, 0, 0, 492, 0, 14, 164, 928, 3445, 75, 40, 48, 89, 164, 246, 1017, 3445
INVAR-3, Run: 026, P, 0, 0, 1, 0, 0, 90, 90, 0, 0, 492, 0, 16, 164, 853, 3560, 74, 45, 44, 90, 164, 246, 943, 3560
INVAR-3, Run: 027, P, 0, 0, 1, 0, 0, 91, 91, 0, 0, 492, 0, 18, 164, 793, 3296, 73, 55, 35, 91, 164, 246, 884, 3296
INVAR-3, Run: 028, P, 0, 0, 1, 0, 0, 91, 91, 0, 0, 492, 0, 18, 164, 685, 2979, 73, 47, 43, 91, 164, 246, 776, 2979
INVAR-3, Run: 029, P, 0, 0, 1, 0, 0, 90, 90, 0, 0, 492, 0, 16, 164, 686, 3023, 74, 50, 39, 90, 164, 246, 776, 3023
INVAR-3, Run: 030, P, 0, 0, 1, 0, 0, 89, 89, 0, 0, 492, 0, 14, 164, 864, 3722, 75, 55, 33, 89, 164, 246, 953, 3722
INVAR-3, Run: 031, P, 0, 0, 1, 0, 0, 91, 91, 0, 0, 492, 0, 18, 164, 734, 2901, 73, 53, 37, 91, 164, 246, 825, 2901
INVAR-3, Run: 032, P, 0, 0, 1, 0, 0, 88, 88, 0, 0, 492, 0, 12, 164, 650, 3083, 76, 57, 30, 88, 164, 246, 738, 3083
INVAR-3, Run: 033, P, 0, 0, 1, 0, 0, 90, 90, 0, 0, 492, 0, 16, 164, 783, 4374, 74, 49, 40, 90, 164, 246, 873, 4374
INVAR-3, Run: 034, P, 0, 0, 1, 0, 0, 92, 92, 0, 0, 492, 0, 20, 164, 700, 2977, 72, 49, 42, 92, 164, 246, 792, 2977
INVAR-3, Run: 035, P, 0, 0, 1, 0, 0, 90, 90, 0, 0, 492, 0, 16, 164, 910, 3071, 74, 48, 41, 90, 164, 246, 1000, 3071
INVAR-3, Run: 036, P, 0, 0, 1, 0, 0, 90, 90, 0, 0, 492, 0, 16, 164, 794, 2794, 74, 49, 40, 90, 164, 246, 884, 2794
INVAR-3, Run: 037, P, 0, 0, 1, 0, 0, 93, 93, 0, 0, 492, 0, 22, 164, 741, 3907, 71, 48, 44, 93, 164, 246, 834, 3907
INVAR-3, Run: 038, P, 0, 0, 1, 0, 0, 91, 91, 0, 0, 492, 0, 18, 164, 777, 3527, 73, 46, 44, 91, 164, 246, 868, 3527
INVAR-3, Run: 039, P, 0, 0, 1, 0, 0, 93, 93, 0, 0, 492, 0, 22, 164, 913, 3647, 71, 54, 38, 93, 164, 246, 1006, 3647
INVAR-3, Run: 040, P, 0, 0, 1, 0, 0, 88, 88, 0, 0, 492, 0, 12, 164, 719, 3276, 76, 56, 31, 88, 164, 246, 807, 3276
INVAR-3, Run: 041, P, 0, 0, 1, 0, 0, 88, 88, 0, 0, 492, 0, 12, 164, 640, 3092, 76, 51, 36, 88, 164, 246, 728, 3092
INVAR-3, Run: 042, P, 0, 0, 1, 0, 0, 92, 92, 0, 0, 492, 0, 20, 164, 813, 3493, 72, 46, 45, 92, 164, 246, 905, 3493
INVAR-3, Run: 043, P, 0, 0, 1, 0, 0, 91, 91, 0, 0, 492, 0, 18, 164, 870, 3052, 73, 53, 37, 91, 164, 246, 961, 3052
INVAR-3, Run: 044, P, 0, 0, 1, 0, 0, 88, 88, 0, 0, 492, 0, 12, 164, 856, 3189, 76, 60, 27, 88, 164, 246, 944, 3189
INVAR-3, Run: 045, P, 0, 0, 1, 0, 0, 90, 90, 0, 0, 492, 0, 16, 164, 838, 3289, 74, 58, 31, 90, 164, 246, 928, 3289
INVAR-3, Run: 046, P, 0, 0, 1, 0, 0, 89, 89, 0, 0, 492, 0, 14, 164, 735, 3219, 75, 50, 38, 89, 164, 246, 824, 3219
INVAR-3, Run: 047, P, 0, 0, 1, 0, 0, 88, 88, 0, 0, 492, 0, 12, 164, 890, 3345, 76, 53, 34, 88, 164, 246, 978, 3345
INVAR-3, Run: 048, P, 0, 0, 1, 0, 0, 89, 89, 0, 0, 492, 0, 14, 164, 767, 3667, 75, 58, 30, 89, 164, 246, 856, 3667
INVAR-3, Run: 049, P, 0, 0, 1, 0, 0, 88, 88, 0, 0, 492, 0, 12, 164, 684, 2688, 76, 55, 32, 88, 164, 246, 772, 2688
INVAR-3, Run: 050, P, 0, 0, 1, 0, 0, 89, 89, 0, 0, 492, 0, 14, 164, 938, 3818, 75, 50, 38, 89, 164, 246, 1027, 3818
INVAR-3, Run: 051, P, 0, 0, 1, 0, 0, 93, 93, 0, 0, 492, 0, 22, 164, 683, 3234, 71, 59, 33, 93, 164, 246, 776, 3234
INVAR-3, Run: 052, P, 0, 0, 1, 0, 0, 91, 91, 0, 0, 492, 0, 18, 164, 773, 3641, 73, 59, 31, 91, 164, 246, 864, 3641
INVAR-3, Run: 053, P, 0, 0, 1, 0, 0, 92, 92, 0, 0, 492, 0, 20, 164, 680, 2735, 72, 54, 37, 92, 164, 246, 772, 2735
INVAR-3, Run: 054, P, 0, 0, 1, 0, 0, 91, 91, 0, 0, 492, 0, 18, 164, 725, 3796, 73, 55, 35, 91, 164, 246, 816, 3796
INVAR-3, Run: 055, P, 0, 0, 1, 0, 0, 88, 88, 0, 0, 492, 0, 12, 164, 756, 2852, 76, 41, 46, 88, 164, 246, 844, 2852
INVAR-3, Run: 056, P, 0, 0, 1, 0, 0, 94, 94, 0, 0, 492, 0, 24, 164, 938, 3261, 70, 60, 33, 94, 164, 246, 1032, 3261
INVAR-3, Run: 057, P, 0, 0, 1, 0, 0, 87, 87, 0, 0, 492, 0, 10, 164, 860, 4070, 77, 51, 35, 87, 164, 246, 947, 4070
INVAR-3, Run: 058, P, 0, 0, 1, 0, 0, 91, 91, 0, 0, 492, 0, 18, 164, 685, 3684, 73, 53, 37, 91, 164, 246, 776, 3684
INVAR-3, Run: 059, P, 0, 0, 1, 0, 0, 90, 90, 0, 0, 492, 0, 16, 164, 770, 2984, 74, 51, 38, 90, 164, 246, 860, 2984
INVAR-3, Run: 060, P, 0, 0, 1, 0, 0, 90, 90, 0, 0, 492, 0, 16, 164, 687, 2515, 74, 45, 44, 90, 164, 246, 777, 2515
INVAR-3, Run: 061, P, 0, 0, 1, 0, 0, 88, 88, 0, 0, 492, 0, 12, 164, 722, 3142, 76, 42, 45, 88, 164, 246, 810, 3142
INVAR-3, Run: 062, P, 0, 0, 1, 0, 0, 93, 93, 0, 0, 492, 0, 22, 164, 638, 3219, 71, 51, 41, 93, 164, 246, 731, 3219
INVAR-3, Run: 063, P, 0, 0, 1, 0, 0, 93, 93, 0, 0, 492, 0, 22, 164, 836, 3222, 71, 48, 44, 93, 164, 246, 929, 3222
INVAR-3, Run: 064, P, 0, 0, 1, 0, 0, 92, 92, 0, 0, 492, 0, 20, 164, 732, 3455, 72, 51, 40, 92, 164, 246, 824, 3455
INVAR-3, Run: 065, P, 0, 0, 1, 0, 0, 91, 91, 0, 0, 492, 0, 18, 164, 757, 2947, 73, 55, 35, 91, 164, 246, 848, 2947
INVAR-3, Run: 066, P, 0, 0, 1, 0, 0, 92, 92, 0, 0, 492, 0, 20, 164, 868, 4017, 72, 55, 36, 92, 164, 246, 960, 4017
INVAR-3, Run: 067, P, 0, 0, 1, 0, 0, 90, 90, 0, 0, 492, 0, 16, 164, 905, 4881, 74, 59, 30, 90, 164, 246, 995, 4881
INVAR-3, Run: 068, P, 0, 0, 1, 0, 0, 89, 89, 0, 0, 492, 0, 14, 164, 665, 3635, 75, 52, 36, 89, 164, 246, 754, 3635
INVAR-3, Run: 069, P, 0, 0, 1, 0, 0, 89, 89, 0, 0, 492, 0, 14, 164, 756, 3274, 75, 59, 29, 89, 164, 246, 845, 3274
INVAR-3, Run: 070, P, 0, 0, 1, 0, 0, 90, 90, 0, 0, 492, 0, 16, 164, 829, 3693, 74, 55, 34, 90, 164, 246, 919, 3693
INVAR-3, Run: 071, P, 0, 0, 1, 0, 0, 91, 91, 0, 0, 492, 0, 18, 164, 775, 3364, 73, 56, 34, 91, 164, 246, 866, 3364
INVAR-3, Run: 072, P, 0, 0, 1, 0, 0, 89, 89, 0, 0, 492, 0, 14, 164, 968, 3520, 75, 53, 35, 89, 164, 246, 1057, 3520
INVAR-3, Run: 073, P, 0, 0, 1, 0, 0, 90, 90, 0, 0, 492, 0, 16, 164, 880, 2931, 74, 49, 40, 90, 164, 246, 970, 2931
INVAR-3, Run: 074, P, 0, 0, 1, 0, 0, 93, 93, 0, 0, 492, 0, 22, 164, 804, 3741, 71, 58, 34, 93, 164, 246, 897, 3741
INVAR-3, Run: 075, P, 0, 0, 1, 0, 0, 90, 90, 0, 0, 492, 0, 16, 164, 810, 4183, 74, 58, 31, 90, 164, 246, 900, 4183
INVAR-3, Run: 076, P, 0, 0, 1, 0, 0, 94, 94, 0, 0, 492, 0, 24, 164, 697, 3358, 70, 51, 42, 94, 164, 246, 791, 3358
INVAR-3, Run: 077, P, 0, 0, 1, 0, 0, 91, 91, 0, 0, 492, 0, 18, 164, 744, 3580, 73, 54, 36, 91, 164, 246, 835, 3580
INVAR-3, Run: 078, P, 0, 0, 1, 0, 0, 91, 91, 0, 0, 492, 0, 18, 164, 703, 2785, 73, 52, 38, 91, 164, 246, 794, 2785
INVAR-3, Run: 079, P, 0, 0, 1, 0, 0, 91, 91, 0, 0, 492, 0, 18, 164, 756, 2721, 73, 51, 39, 91, 164, 246, 847, 2721
INVAR-3, Run: 080, P, 0, 0, 1, 0, 0, 91, 91, 0, 0, 492, 0, 18, 164, 694, 2787, 73, 45, 45, 91, 164, 246, 785, 2787
INVAR-3, Run: 081, P, 0, 0, 1, 0, 0, 88, 88, 0, 0, 492, 0, 12, 164, 682, 3499, 76, 63, 24, 88, 164, 246, 770, 3499
INVAR-3, Run: 082, P, 0, 0, 1, 0, 0, 90, 90, 0, 0, 492, 0, 16, 164, 818, 3262, 74, 51, 38, 90, 164, 246, 908, 3262
INVAR-3, Run: 083, P, 0, 0, 1, 0, 0, 91, 91, 0, 0, 492, 0, 18, 164, 893, 4033, 73, 53, 37, 91, 164, 246, 984, 4033
INVAR-3, Run: 084, P, 0, 0, 1, 0, 0, 89, 89, 0, 0, 492, 0, 14, 164, 672, 2209, 75, 51, 37, 89, 164, 246, 761, 2209
INVAR-3, Run: 085, P, 0, 0, 1, 0, 0, 90, 90, 0, 0, 492, 0, 16, 164, 1036, 4387, 74, 49, 40, 90, 164, 246, 1126, 4387
INVAR-3, Run: 086, P, 0, 0, 1, 0, 0, 90, 90, 0, 0, 492, 0, 16, 164, 538, 3326, 74, 51, 38, 90, 164, 246, 628, 3326
INVAR-3, Run: 087, P, 0, 0, 1, 0, 0, 91, 91, 0, 0, 492, 0, 18, 164, 924, 4028, 73, 53, 37, 91, 164, 246, 1015, 4028
INVAR-3, Run: 088, P, 0, 0, 1, 0, 0, 90, 90, 0, 0, 492, 0, 16, 164, 924, 3027, 74, 48, 41, 90, 164, 246, 1014, 3027
INVAR-3, Run: 089, P, 0, 0, 1, 0, 0, 89, 89, 0, 0, 492, 0, 14, 164, 724, 2784, 75, 46, 42, 89, 164, 246, 813, 2784
INVAR-3, Run: 090, P, 0, 0, 1, 0, 0, 91, 91, 0, 0, 492, 0, 18, 164, 936, 4710, 73, 52, 38, 91, 164, 246, 1027, 4710
INVAR-3, Run: 091, P, 0, 0, 1, 0, 0, 89, 89, 0, 0, 492, 0, 14, 164, 595, 2739, 75, 57, 31, 89, 164, 246, 684, 2739
INVAR-3, Run: 092, P, 0, 0, 1, 0, 0, 87, 87, 0, 0, 492, 0, 10, 164, 704, 3428, 77, 48, 38, 87, 164, 246, 791, 3428
INVAR-3, Run: 093, P, 0, 0, 1, 0, 0, 97, 97, 0, 0, 492, 0, 30, 164, 828, 3984, 67, 57, 39, 97, 164, 246, 925, 3984
INVAR-3, Run: 094, P, 0, 0, 1, 0, 0, 88, 88, 0, 0, 492, 0, 12, 164, 721, 4209, 76, 48, 39, 88, 164, 246, 809, 4209
INVAR-3, Run: 095, P, 0, 0, 1, 0, 0, 87, 87, 0, 0, 492, 0, 10, 164, 650, 2803, 77, 54, 32, 87, 164, 246, 737, 2803
INVAR-3, Run: 096, P, 0, 0, 1, 0, 0, 87, 87, 0, 0, 492, 0, 10, 164, 741, 2039, 77, 48, 38, 87, 164, 246, 828, 2039
INVAR-3, Run: 097, P, 0, 0, 1, 0, 0, 87, 87, 0, 0, 492, 0, 10, 164, 665, 3324, 77, 54, 32, 87, 164, 246, 752, 3324
INVAR-3, Run: 098, P, 0, 0, 1, 0, 0, 89, 89, 0, 0, 492, 0, 14, 164, 731, 3797, 75, 50, 38, 89, 164, 246, 820, 3797
INVAR-3, Run: 099, P, 0, 0, 1, 0, 0, 94, 94, 0, 0, 492, 0, 24, 164, 872, 3721, 70, 59, 34, 94, 164, 246, 966, 3721
INVAR-3, Run: 100, P, 0, 0, 1, 0, 0, 89, 89, 0, 0, 492, 0, 14, 164, 780, 3344, 75, 57, 31, 89, 164, 246, 869, 3344
INVAR-4, Run: 001, P, 0, 0, 1, 0, 0, 24, 24, 0, 0, 118, 1, 9, 39, 94, 358, 15, 12, 11, 24, 39, 58, 118, 358
INVAR-4, Run: 002, P, 0, 0, 1, 0, 0, 24, 24, 0, 0, 118, 1, 9, 39, 123, 327, 15, 12, 11, 24, 39, 58, 147, 327
INVAR-4, Run: 003, P, 0, 0, 1, 0, 0, 22, 22, 0, 0, 118, 1, 5, 39, 51, 298, 17, 13, 8, 22, 39, 58, 73, 298
INVAR-4, Run: 004, P, 0, 0, 1, 0, 0, 26, 26, 0, 0, 118, 1, 13, 39, 102, 386, 13, 14, 11, 26, 39, 58, 128, 386
INVAR-4, Run: 005, P, 0, 0, 1, 0, 0, 25, 25, 0, 0, 118, 1, 11, 39, 47, 168, 14, 12, 12, 25, 39, 58, 72, 168
INVAR-4, Run: 006, P, 0, 0, 1, 0, 0, 24, 24, 0, 0, 118, 1, 9, 39, 142, 619, 15, 12, 11, 24, 39, 58, 166, 619
INVAR-4, Run: 007, P, 0, 0, 1, 0, 0, 23, 23, 0, 0, 118, 1, 7, 39, 66, 343, 16, 13, 9, 23, 39, 58, 89, 343
INVAR-4, Run: 008, P, 0, 0, 1, 0, 0, 24, 24, 0, 0, 118, 1, 9, 39, 77, 378, 15, 14, 9, 24, 39, 58, 101, 378
INVAR-4, Run: 009, P, 0, 0, 1, 0, 0, 22, 22, 0, 0, 118, 1, 5, 39, 81, 421, 17, 12, 9, 22, 39, 58, 103, 421
INVAR-4, Run: 010, P, 0, 0, 1, 0, 0, 24, 24, 0, 0, 118, 1, 9, 39, 63, 289, 15, 12, 11, 24, 39, 58, 87, 289
INVAR-4, Run: 011, P, 0, 0, 1, 0, 0, 25, 25, 0, 0, 118, 1, 11, 39, 113, 528, 14, 12, 12, 25, 39, 58, 138, 528
INVAR-4, Run: 012, P, 0, 0, 1, 0, 0, 26, 26, 0, 0, 118, 1, 13, 39, 112, 391, 13, 16, 9, 26, 39, 58, 138, 391
INVAR-4, Run: 013, P, 0, 0, 1, 0, 0, 25, 25, 0, 0, 118, 1, 11, 39, 89, 460, 14, 13, 11, 25, 39, 58, 114, 460
INVAR-4, Run: 014, P, 0, 0, 1, 0, 0, 23, 23, 0, 0, 118, 1, 7, 39, 136, 471, 16, 12, 10, 23, 39, 58, 159, 471
INVAR-4, Run: 015, P, 0, 0, 1, 0, 0, 23, 23, 0, 0, 118, 1, 7, 39, 69, 338, 16, 15, 7, 23, 39, 58, 92, 338
INVAR-4, Run: 016, P, 0, 0, 1, 0, 0, 24, 24, 0, 0, 118, 1, 9, 39, 81, 190, 15, 12, 11, 24, 39, 58, 105, 190
INVAR-4, Run: 017, P, 0, 0, 1, 0, 0, 24, 24, 0, 0, 118, 1, 9, 39, 101, 229, 15, 9, 14, 24, 39, 58, 125, 229
INVAR-4, Run: 018, P, 0, 0, 1, 0, 0, 23, 23, 0, 0, 118, 1, 7, 39, 74, 362, 16, 15, 7, 23, 39, 58, 97, 362
INVAR-4, Run: 019, P, 0, 0, 1, 0, 0, 22, 22, 0, 0, 118, 1, 5, 39, 81, 346, 17, 16, 5, 22, 39, 58, 103, 346
INVAR-4, Run: 020, P, 0, 0, 1, 0, 0, 23, 23, 0, 0, 118, 1, 7, 39, 100, 297, 16, 8, 14, 23, 39, 58, 123, 297
INVAR-4, Run: 021, P, 0, 0, 1, 0, 0, 23, 23, 0, 0, 118, 1, 7, 39, 79, 217, 16, 15, 7, 23, 39, 58, 102, 217
INVAR-4, Run: 022, P, 0, 0, 1, 0, 0, 22, 22, 0, 0, 118, 1, 5, 39, 51, 181, 17, 9, 12, 22, 39, 58, 73, 181
INVAR-4, Run: 023, P, 0, 0, 1, 0, 0, 24, 24, 0, 0, 118, 1, 9, 39, 108, 418, 15, 14, 9, 24, 39, 58, 132, 418
INVAR-4, Run: 024, P, 0, 0, 1, 0, 0, 22, 22, 0, 0, 118, 1, 5, 39, 68, 284, 17, 10, 11, 22, 39, 58, 90, 284
INVAR-4, Run: 025, P, 0, 0, 1, 0, 0, 25, 25, 0, 0, 118, 1, 11, 39, 102, 284, 14, 14, 10, 25, 39, 58, 127, 284
INVAR-4, Run: 026, P, 0, 0, 1, 0, 0, 25, 25, 0, 0, 118, 1, 11, 39, 78, 370, 14, 11, 13, 25, 39, 58, 103, 370
INVAR-4, Run: 027, P, 0, 0, 1, 0, 0, 23, 23, 0, 0, 118, 1, 7, 39, 136, 592, 16, 12, 10, 23, 39, 58, 159, 592
INVAR-4, Run: 028, P, 0, 0, 1, 0, 0, 24, 24, 0, 0, 118, 1, 9, 39, 59, 328, 15, 19, 4, 24, 39, 58, 83, 328
INVAR-4, Run: 029, P, 0, 0, 1, 0, 0, 22, 22, 0, 0, 118, 1, 5, 39, 72, 520, 17, 12, 9, 22, 39, 58, 94, 520
INVAR-4, Run: 030, P, 0, 0, 1, 0, 0, 22, 22, 0, 0, 118, 1, 5, 39, 44, 329, 17, 14, 7, 22, 39, 58, 66, 329
INVAR-4, Run: 031, P, 0, 0, 1, 0, 0, 21, 21, 0, 0, 118, 1, 3, 39, 73, 302, 18, 11, 9, 21, 39, 58, 94, 302
INVAR-4, Run: 032, P, 0, 0, 1, 0, 0, 26, 26, 0, 0, 118, 1, 13, 39, 130, 493, 13, 13, 12, 26, 39, 58, 156, 493
INVAR-4, Run: 033, P, 0, 0, 1, 0, 0, 22, 22, 0, 0, 118, 1, 5, 39, 70, 321, 17, 12, 9, 22, 39, 58, 92, 321
INVAR-4, Run: 034, P, 0, 0, 1, 0, 0, 23, 23, 0, 0, 118, 1, 7, 39, 78, 227, 16, 16, 6, 23, 39, 58, 101, 227
INVAR-4, Run: 035, P, 0, 0, 1, 0, 0, 23, 23, 0, 0, 118, 1, 7, 39, 74, 425, 16, 17, 5, 23, 39, 58, 97, 425
INVAR-4, Run: 036, P, 0, 0, 1, 0, 0, 23, 23, 0, 0, 118, 1, 7, 39, 51, 332, 16, 16, 6, 23, 39, 58, 74, 332
INVAR-4, Run: 037, P, 0, 0, 1, 0, 0, 24, 24, 0, 0, 118, 1, 9, 39, 99, 376, 15, 9, 14, 24, 39, 58, 123, 376
INVAR-4, Run: 038, P, 0, 0, 1, 0, 0, 23, 23, 0, 0, 118, 1, 7, 39, 77, 375, 16, 15, 7, 23, 39, 58, 100, 375
INVAR-4, Run: 039, P, 0, 0, 1, 0, 0, 23, 23, 0, 0, 118, 1, 7, 39, 110, 466, 16, 11, 11, 23, 39, 58, 133, 466
INVAR-4, Run: 040, P, 0, 0, 1, 0, 0, 25, 25, 0, 0, 118, 1, 11, 39, 98, 575, 14, 16, 8, 25, 39, 58, 123, 575
INVAR-4, Run: 041, P, 0, 0, 1, 0, 0, 20, 20, 0, 0, 118, 1, 1, 39, 81, 295, 19, 12, 7, 20, 39, 58, 101, 295
INVAR-4, Run: 042, P, 0, 0, 1, 0, 0, 23, 23, 0, 0, 118, 1, 7, 39, 64, 374, 16, 13, 9, 23, 39, 58, 87, 374
INVAR-4, Run: 043, P, 0, 0, 1, 0, 0, 24, 24, 0, 0, 118, 1, 9, 39, 80, 328, 15, 15, 8, 24, 39, 58, 104, 328
INVAR-4, Run: 044, P, 0, 0, 1, 0, 0, 22, 22, 0, 0, 118, 1, 5, 39, 54, 351, 17, 8, 13, 22, 39, 58, 76, 351
INVAR-4, Run: 045, P, 0, 0, 1, 0, 0, 25, 25, 0, 0, 118, 1, 11, 39, 82, 242, 14, 6, 18, 25, 39, 58, 107, 242
INVAR-4, Run: 046, P, 0, 0, 1, 0, 0, 23, 23, 0, 0, 118, 1, 7, 39, 65, 480, 16, 13, 9, 23, 39, 58, 88, 480
INVAR-4, Run: 047, P, 0, 0, 1, 0, 0, 23, 23, 0, 0, 118, 1, 7, 39, 84, 448, 16, 13, 9, 23, 39, 58, 107, 448
INVAR-4, Run: 048, P, 0, 0, 1, 0, 0, 23, 23, 0, 0, 118, 1, 7, 39, 112, 350, 16, 14, 8, 23, 39, 58, 135, 350
INVAR-4, Run: 049, P, 0, 0, 1, 0, 0, 24, 24, 0, 0, 118, 1, 9, 39, 161, 517, 15, 8, 15, 24, 39, 58, 185, 517
INVAR-4, Run: 050, P, 0, 0, 1, 0, 0, 25, 25, 0, 0, 118, 1, 11, 39, 64, 480, 14, 22, 2, 25, 39, 58, 89, 480
INVAR-4, Run: 051, P, 0, 0, 1, 0, 0, 23, 23, 0, 0, 118, 1, 7, 39, 62, 308, 16, 9, 13, 23, 39, 58, 85, 308
INVAR-4, Run: 052, P, 0, 0, 1, 0, 0, 23, 23, 0, 0, 118, 1, 7, 39, 77, 497, 16, 11, 11, 23, 39, 58, 100, 497
INVAR-4, Run: 053, P, 0, 0, 1, 0, 0, 22, 22, 0, 0, 118, 1, 5, 39, 97, 377, 17, 14, 7, 22, 39, 58, 119, 377
INVAR-4, Run: 054, P, 0, 0, 1, 0, 0, 26, 26, 0, 0, 118, 1, 13, 39, 86, 223, 13, 11, 14, 26, 39, 58, 112, 223
INVAR-4, Run: 055, P, 0, 0, 1, 0, 0, 22, 22, 0, 0, 118, 1, 5, 39, 67, 344, 17, 13, 8, 22, 39, 58, 89, 344
INVAR-4, Run: 056, P, 0, 0, 1, 0, 0, 24, 24, 0, 0, 118, 1, 9, 39, 112, 426, 15, 14, 9, 24, 39, 58, 136, 426
INVAR-4, Run: 057, P, 0, 0, 1, 0, 0, 23, 23, 0, 0, 118, 1, 7, 39, 103, 388, 16, 16, 6, 23, 39, 58, 126, 388
INVAR-4, Run: 058, P, 0, 0, 1, 0, 0, 25, 25, 0, 0, 118, 1, 11, 39, 78, 202, 14, 11, 13, 25, 39, 58, 103, 202
INVAR-4, Run: 059, P, 0, 0, 1, 0, 0, 23, 23, 0, 0, 118, 1, 7, 39, 123, 467, 16, 12, 10, 23, 39, 58, 146, 467
INVAR-4, Run: 060, P, 0, 0, 1, 0, 0, 23, 23, 0, 0, 118, 1, 7, 39, 137, 420, 16, 11, 11, 23, 39, 58, 160, 420
INVAR-4, Run: 061, P, 0, 0, 1, 0, 0, 23, 23, 0, 0, 118, 1, 7, 39, 85, 210, 16, 10, 12, 23, 39, 58, 108, 210
INVAR-4, Run: 062, P, 0, 0, 1, 0, 0, 24, 24, 0, 0, 118, 1, 9, 39, 106, 300, 15, 12, 11, 24, 39, 58, 130, 300
INVAR-4, Run: 063, P, 0, 0, 1, 0, 0, 22, 22, 0, 0, 118, 1, 5, 39, 95, 316, 17, 8, 13, 22, 39, 58, 117, 316
INVAR-4, Run: 064, P, 0, 0, 1, 0, 0, 21, 21, 0, 0, 118, 1, 3, 39, 67, 472, 18, 16, 4, 21, 39, 58, 88, 472
INVAR-4, Run: 065, P, 0, 0, 1, 0, 0, 22, 22, 0, 0, 118, 1, 5, 39, 60, 350, 17, 9, 12, 22, 39, 58, 82, 350
INVAR-4, Run: 066, P, 0, 0, 1, 0, 0, 25, 25, 0, 0, 118, 1, 11, 39, 110, 414, 14, 15, 9, 25, 39, 58, 135, 414
INVAR-4, Run: 067, P, 0, 0, 1, 0, 0, 21, 21, 0, 0, 118, 1, 3, 39, 70, 358, 18, 11, 9, 21, 39, 58, 91, 358
INVAR-4, Run: 068, P, 0, 0, 1, 0, 0, 23, 23, 0, 0, 118, 1, 7, 39, 52, 229, 16, 11, 11, 23, 39, 58, 75, 229
INVAR-4, Run: 069, P, 0, 0, 1, 0, 0, 22, 22, 0, 0, 118, 1, 5, 39, 98, 471, 17, 16, 5, 22, 39, 58, 120, 471
INVAR-4, Run: 070, P, 0, 0, 1, 0, 0, 22, 22, 0, 0, 118, 1, 5, 39, 87, 415, 17, 13, 8, 22, 39, 58, 109, 415
INVAR-4, Run: 071, P, 0, 0, 1, 0, 0, 23, 23, 0, 0, 118, 1, 7, 39, 121, 328, 16, 11, 11, 23, 39, 58, 144, 328
INVAR-4, Run: 072, P, 0, 0, 1, 0, 0, 24, 24, 0, 0, 118, 1, 9, 39, 64, 250, 15, 14, 9, 24, 39, 58, 88, 250
INVAR-4, Run: 073, P, 0, 0, 1, 0, 0, 25, 25, 0, 0, 118, 1, 11, 39, 125, 235, 14, 6, 18, 25, 39, 58, 150, 235
INVAR-4, Run: 074, P, 0, 0, 1, 0, 0, 24, 24, 0, 0, 118, 1, 9, 39, 75, 207, 15, 14, 9, 24, 39, 58, 99, 207
INVAR-4, Run: 075, P, 0, 0, 1, 0, 0, 22, 22, 0, 0, 118, 1, 5, 39, 92, 402, 17, 10, 11, 22, 39, 58, 114, 402
INVAR-4, Run: 076, P, 0, 0, 1, 0, 0, 25, 25, 0, 0, 118, 1, 11, 39, 75, 274, 14, 9, 15, 25, 39, 58, 100, 274
INVAR-4, Run: 077, P, 0, 0, 1, 0, 0, 24, 24, 0, 0, 118, 1, 9, 39, 69, 208, 15, 13, 10, 24, 39, 58, 93, 208
INVAR-4, Run: 078, P, 0, 0, 1, 0, 0, 25, 25, 0, 0, 118, 1, 11, 39, 128, 422, 14, 15, 9, 25, 39, 58, 153, 422
INVAR-4, Run: 079, P, 0, 0, 1, 0, 0, 26, 26, 0, 0, 118, 1, 13, 39, 121, 266, 13, 9, 16, 26, 39, 58, 147, 266
INVAR-4, Run: 080, P, 0, 0, 1, 0, 0, 21, 21, 0, 0, 118, 1, 3, 39, 50, 270, 18, 14, 6, 21, 39, 58, 71, 270
INVAR-4, Run: 081, P, 0, 0, 1, 0, 0, 22, 22, 0, 0, 118, 1, 5, 39, 81, 368, 17, 14, 7, 22, 39, 58, 103, 368
INVAR-4, Run: 082, P, 0, 0, 1, 0, 0, 25, 25, 0, 0, 118, 1, 11, 39, 95, 351, 14, 8, 16, 25, 39, 58, 120, 351
INVAR-4, Run: 083, P, 0, 0, 1, 0, 0, 24, 24, 0, 0, 118, 1, 9, 39, 69, 280, 15, 14, 9, 24, 39, 58, 93, 280
INVAR-4, Run: 084, P, 0, 0, 1, 0, 0, 22, 22, 0, 0, 118, 1, 5, 39, 108, 458, 17, 10, 11, 22, 39, 58, 130, 458
INVAR-4, Run: 085, P, 0, 0, 1, 0, 0, 25, 25, 0, 0, 118, 1, 11, 39, 115, 413, 14, 17, 7, 25, 39, 58, 140, 413
INVAR-4, Run: 086, P, 0, 0, 1, 0, 0, 23, 23, 0, 0, 118, 1, 7, 39, 69, 290, 16, 14, 8, 23, 39, 58, 92, 290
INVAR-4, Run: 087, P, 0, 0, 1, 0, 0, 23, 23, 0, 0, 118, 1, 7, 39, 97, 298, 16, 13, 9, 23, 39, 58, 120, 298
INVAR-4, Run: 088, P, 0, 0, 1, 0, 0, 24, 24, 0, 0, 118, 1, 9, 39, 97, 457, 15, 16, 7, 24, 39, 58, 121, 457
INVAR-4, Run: 089, P, 0, 0, 1, 0, 0, 23, 23, 0, 0, 118, 1, 7, 39, 59, 229, 16, 11, 11, 23, 39, 58, 82, 229
INVAR-4, Run: 090, P, 0, 0, 1, 0, 0, 22, 22, 0, 0, 118, 1, 5, 39, 67, 401, 17, 13, 8, 22, 39, 58, 89, 401
INVAR-4, Run: 091, P, 0, 0, 1, 0, 0, 24, 24, 0, 0, 118, 1, 9, 39, 99, 206, 15, 13, 10, 24, 39, 58, 123, 206
INVAR-4, Run: 092, P, 0, 0, 1, 0, 0, 24, 24, 0, 0, 118, 1, 9, 39, 103, 415, 15, 15, 8, 24, 39, 58, 127, 415
INVAR-4, Run: 093, P, 0, 0, 1, 0, 0, 22, 22, 0, 0, 118, 1, 5, 39, 70, 513, 17, 14, 7, 22, 39, 58, 92, 513
INVAR-4, Run: 094, P, 0, 0, 1, 0, 0, 22, 22, 0, 0, 118, 1, 5, 39, 121, 410, 17, 12, 9, 22, 39, 58, 143, 410
INVAR-4, Run: 095, P, 0, 0, 1, 0, 0, 24, 24, 0, 0, 118, 1, 9, 39, 124, 497, 15, 14, 9, 24, 39, 58, 148, 497
INVAR-4, Run: 096, P, 0, 0, 1, 0, 0, 22, 22, 0, 0, 118, 1, 5, 39, 118, 542, 17, 11, 10, 22, 39, 58, 140, 542
INVAR-4, Run: 097, P, 0, 0, 1, 0, 0, 24, 24, 0, 0, 118, 1, 9, 39, 99, 281, 15, 13, 10, 24, 39, 58, 123, 281
INVAR-4, Run: 098, P, 0, 0, 1, 0, 0, 25, 25, 0, 0, 118, 1, 11, 39, 85, 293, 14, 14, 10, 25, 39, 58, 110, 293
INVAR-4, Run: 099, P, 0, 0, 1, 0, 0, 26, 26, 0, 0, 118, 1, 13, 39, 65, 156, 13, 14, 11, 26, 39, 58, 91, 156
INVAR-4, Run: 100, P, 0, 0, 1, 0, 0, 22, 22, 0, 0, 118, 1, 5, 39, 44, 228, 17, 9, 12, 22, 39, 58, 66, 228
INVAR-5, Run: 001, P, 0, 0, 1, 0, 0, 32, 32, 0, 0, 160, 1, 11, 53, 151, 619, 21, 22, 9, 32, 53, 79, 183, 619
INVAR-5, Run: 002, P, 0, 0, 1, 0, 0, 32, 32, 0, 0, 160, 1, 11, 53, 111, 304, 21, 18, 13, 32, 53, 79, 143, 304
INVAR-5, Run: 003, P, 0, 0, 1, 0, 0, 31, 31, 0, 0, 160, 1, 9, 53, 158, 509, 22, 17, 13, 31, 53, 79, 189, 509
INVAR-5, Run: 004, P, 0, 0, 1, 0, 0, 31, 31, 0, 0, 160, 1, 9, 53, 108, 607, 22, 21, 9, 31, 53, 79, 139, 607
INVAR-5, Run: 005, P, 0, 0, 1, 0, 0, 31, 31, 0, 0, 160, 1, 9, 53, 123, 537, 22, 16, 14, 31, 53, 79, 154, 537
INVAR-5, Run: 006, P, 0, 0, 1, 0, 0, 34, 34, 0, 0, 160, 1, 15, 53, 162, 474, 19, 17, 16, 34, 53, 79, 196, 474
INVAR-5, Run: 007, P, 0, 0, 1, 0, 0, 33, 33, 0, 0, 160, 1, 13, 53, 156, 567, 20, 14, 18, 33, 53, 79, 189, 567
INVAR-5, Run: 008, P, 0, 0, 1, 0, 0, 31, 31, 0, 0, 160, 1, 9, 53, 136, 506, 22, 19, 11, 31, 53, 79, 167, 506
INVAR-5, Run: 009, P, 0, 0, 1, 0, 0, 33, 33, 0, 0, 160, 1, 13, 53, 233, 906, 20, 21, 11, 33, 53, 79, 266, 906
INVAR-5, Run: 010, P, 0, 0, 1, 0, 0, 30, 30, 0, 0, 160, 1, 7, 53, 177, 693, 23, 15, 14, 30, 53, 79, 207, 693
INVAR-5, Run: 011, P, 0, 0, 1, 0, 0, 31, 31, 0, 0, 160, 1, 9, 53, 148, 779, 22, 18, 12, 31, 53, 79, 179, 779
INVAR-5, Run: 012, P, 0, 0, 1, 0, 0, 30, 30, 0, 0, 160, 1, 7, 53, 158, 595, 23, 17, 12, 30, 53, 79, 188, 595
INVAR-5, Run: 013, P, 0, 0, 1, 0, 0, 32, 32, 0, 0, 160, 1, 11, 53, 203, 496, 21, 20, 11, 32, 53, 79, 235, 496
INVAR-5, Run: 014, P, 0, 0, 1, 0, 0, 32, 32, 0, 0, 160, 1, 11, 53, 143, 516, 21, 23, 8, 32, 53, 79, 175, 516
INVAR-5, Run: 015, P, 0, 0, 1, 0, 0, 34, 34, 0, 0, 160, 1, 15, 53, 136, 908, 19, 23, 10, 34, 53, 79, 170, 908
INVAR-5, Run: 016, P, 0, 0, 1, 0, 0, 33, 33, 0, 0, 160, 1, 13, 53, 179, 652, 20, 18, 14, 33, 53, 79, 212, 652
INVAR-5, Run: 017, P, 0, 0, 1, 0, 0, 32, 32, 0, 0, 160, 1, 11, 53, 122, 714, 21, 18, 13, 32, 53, 79, 154, 714
INVAR-5, Run: 018, P, 0, 0, 1, 0, 0, 31, 31, 0, 0, 160, 1, 9, 53, 149, 622, 22, 16, 14, 31, 53, 79, 180, 622
INVAR-5, Run: 019, P, 0, 0, 1, 0, 0, 30, 30, 0, 0, 160, 1, 7, 53, 101, 551, 23, 20, 9, 30, 53, 79, 131, 551
INVAR-5, Run: 020, P, 0, 0, 1, 0, 0, 30, 30, 0, 0, 160, 1, 7, 53, 127, 566, 23, 17, 12, 30, 53, 79, 157, 566
INVAR-5, Run: 021, P, 0, 0, 1, 0, 0, 31, 31, 0, 0, 160, 1, 9, 53, 134, 417, 22, 18, 12, 31, 53, 79, 165, 417
INVAR-5, Run: 022, P, 0, 0, 1, 0, 0, 32, 32, 0, 0, 160, 1, 11, 53, 136, 417, 21, 10, 21, 32, 53, 79, 168, 417
INVAR-5, Run: 023, P, 0, 0, 1, 0, 0, 30, 30, 0, 0, 160, 1, 7, 53, 141, 750, 23, 20, 9, 30, 53, 79, 171, 750
INVAR-5, Run: 024, P, 0, 0, 1, 0, 0, 31, 31, 0, 0, 160, 1, 9, 53, 130, 695, 22, 15, 15, 31, 53, 79, 161, 695
INVAR-5, Run: 025, P, 0, 0, 1, 0, 0, 32, 32, 0, 0, 160, 1, 11, 53, 190, 780, 21, 16, 15, 32, 53, 79, 222, 780
INVAR-5, Run: 026, P, 0, 0, 1, 0, 0, 32, 32, 0, 0, 160, 1, 11, 53, 140, 512, 21, 16, 15, 32, 53, 79, 172, 512
INVAR-5, Run: 027, P, 0, 0, 1, 0, 0, 33, 33, 0, 0, 160, 1, 13, 53, 143, 681, 20, 18, 14, 33, 53, 79, 176, 681
INVAR-5, Run: 028, P, 0, 0, 1, 0, 0, 31, 31, 0, 0, 160, 1, 9, 53, 145, 643, 22, 17, 13, 31, 53, 79, 176, 643
INVAR-5, Run: 029, P, 0, 0, 1, 0, 0, 30, 30, 0, 0, 160, 1, 7, 53, 120, 383, 23, 14, 15, 30, 53, 79, 150, 383
INVAR-5, Run: 030, P, 0, 0, 1, 0, 0, 31, 31, 0, 0, 160, 1, 9, 53, 163, 530, 22, 14, 16, 31, 53, 79, 194, 530
INVAR-5, Run: 031, P, 0, 0, 1, 0, 0, 30, 30, 0, 0, 160, 1, 7, 53, 165, 675, 23, 19, 10, 30, 53, 79, 195, 675
INVAR-5, Run: 032, P, 0, 0, 1, 0, 0, 30, 30, 0, 0, 160, 1, 7, 53, 121, 654, 23, 13, 16, 30, 53, 79, 151, 654
INVAR-5, Run: 033, P, 0, 0, 1, 0, 0, 29, 29, 0, 0, 160, 1, 5, 53, 95, 496, 24, 20, 8, 29, 53, 79, 124, 496
INVAR-5, Run: 034, P, 0, 0, 1, 0, 0, 30, 30, 0, 0, 160, 1, 7, 53, 69, 378, 23, 21, 8, 30, 53, 79, 99, 378
INVAR-5, Run: 035, P, 0, 0, 1, 0, 0, 30, 30, 0, 0, 160, 1, 7, 53, 126, 514, 23, 16, 13, 30, 53, 79, 156, 514
INVAR-5, Run: 036, P, 0, 0, 1, 0, 0, 29, 29, 0, 0, 160, 1, 5, 53, 100, 699, 24, 16, 12, 29, 53, 79, 129, 699
INVAR-5, Run: 037, P, 0, 0, 1, 0, 0, 32, 32, 0, 0, 160, 1, 11, 53, 151, 463, 21, 18, 13, 32, 53, 79, 183, 463
INVAR-5, Run: 038, P, 0, 0, 1, 0, 0, 31, 31, 0, 0, 160, 1, 9, 53, 129, 590, 22, 19, 11, 31, 53, 79, 160, 590
INVAR-5, Run: 039, P, 0, 0, 1, 0, 0, 30, 30, 0, 0, 160, 1, 7, 53, 108, 447, 23, 16, 13, 30, 53, 79, 138, 447
INVAR-5, Run: 040, P, 0, 0, 1, 0, 0, 31, 31, 0, 0, 160, 1, 9, 53, 124, 632, 22, 18, 12, 31, 53, 79, 155, 632
INVAR-5, Run: 041, P, 0, 0, 1, 0, 0, 31, 31, 0, 0, 160, 1, 9, 53, 154, 730, 22, 18, 12, 31, 53, 79, 185, 730
INVAR-5, Run: 042, P, 0, 0, 1, 0, 0, 31, 31, 0, 0, 160, 1, 9, 53, 144, 626, 22, 15, 15, 31, 53, 79, 175, 626
INVAR-5, Run: 043, P, 0, 0, 1, 0, 0, 32, 32, 0, 0, 160, 1, 11, 53, 183, 556, 21, 12, 19, 32, 53, 79, 215, 556
INVAR-5, Run: 044, P, 0, 0, 1, 0, 0, 30, 30, 0, 0, 160, 1, 7, 53, 141, 820, 23, 19, 10, 30, 53, 79, 171, 820
INVAR-5, Run: 045, P, 0, 0, 1, 0, 0, 33, 33, 0, 0, 160, 1, 13, 53, 149, 578, 20, 16, 16, 33, 53, 79, 182, 578
INVAR-5, Run: 046, P, 0, 0, 1, 0, 0, 31, 31, 0, 0, 160, 1, 9, 53, 103, 398, 22, 17, 13, 31, 53, 79, 134, 398
INVAR-5, Run: 047, P, 0, 0, 1, 0, 0, 30, 30, 0, 0, 160, 1, 7, 53, 165, 515, 23, 14, 15, 30, 53, 79, 195, 515
INVAR-5, Run: 048, P, 0, 0, 1, 0, 0, 30, 30, 0, 0, 160, 1, 7, 53, 172, 757, 23, 21, 8, 30, 53, 79, 202, 757
INVAR-5, Run: 049, P, 0, 0, 1, 0, 0, 32, 32, 0, 0, 160, 1, 11, 53, 142, 689, 21, 23, 8, 32, 53, 79, 174, 689
INVAR-5, Run: 050, P, 0, 0, 1, 0, 0, 31, 31, 0, 0, 160, 1, 9, 53, 129, 515, 22, 15, 15, 31, 53, 79, 160, 515
INVAR-5, Run: 051, P, 0, 0, 1, 0, 0, 30, 30, 0, 0, 160, 1, 7, 53, 114, 606, 23, 17, 12, 30, 53, 79, 144, 606
INVAR-5, Run: 052, P, 0, 0, 1, 0, 0, 31, 31, 0, 0, 160, 1, 9, 53, 143, 472, 22, 17, 13, 31, 53, 79, 174, 472
INVAR-5, Run: 053, P, 0, 0, 1, 0, 0, 33, 33, 0, 0, 160, 1, 13, 53, 158, 538, 20, 18, 14, 33, 53, 79, 191, 538
INVAR-5, Run: 054, P, 0, 0, 1, 0, 0, 31, 31, 0, 0, 160, 1, 9, 53, 80, 327, 22, 17, 13, 31, 53, 79, 111, 327
INVAR-5, Run: 055, P, 0, 0, 1, 0, 0, 32, 32, 0, 0, 160, 1, 11, 53, 115, 362, 21, 17, 14, 32, 53, 79, 147, 362
INVAR-5, Run: 056, P, 0, 0, 1, 0, 0, 32, 32, 0, 0, 160, 1, 11, 53, 144, 667, 21, 16, 15, 32, 53, 79, 176, 667
INVAR-5, Run: 057, P, 0, 0, 1, 0, 0, 31, 31, 0, 0, 160, 1, 9, 53, 196, 783, 22, 14, 16, 31, 53, 79, 227, 783
INVAR-5, Run: 058, P, 0, 0, 1, 0, 0, 33, 33, 0, 0, 160, 1, 13, 53, 123, 430, 20, 17, 15, 33, 53, 79, 156, 430
INVAR-5, Run: 059, P, 0, 0, 1, 0, 0, 32, 32, 0, 0, 160, 1, 11, 53, 99, 478, 21, 15, 16, 32, 53, 79, 131, 478
INVAR-5, Run: 060, P, 0, 0, 1, 0, 0, 35, 35, 0, 0, 160, 1, 17, 53, 167, 534, 18, 14, 20, 35, 53, 79, 202, 534
INVAR-5, Run: 061, P, 0, 0, 1, 0, 0, 31, 31, 0, 0, 160, 1, 9, 53, 224, 795, 22, 19, 11, 31, 53, 79, 255, 795
INVAR-5, Run: 062, P, 0, 0, 1, 0, 0, 32, 32, 0, 0, 160, 1, 11, 53, 159, 539, 21, 19, 12, 32, 53, 79, 191, 539
INVAR-5, Run: 063, P, 0, 0, 1, 0, 0, 35, 35, 0, 0, 160, 1, 17, 53, 161, 572, 18, 16, 18, 35, 53, 79, 196, 572
INVAR-5, Run: 064, P, 0, 0, 1, 0, 0, 33, 33, 0, 0, 160, 1, 13, 53, 143, 591, 20, 21, 11, 33, 53, 79, 176, 591
INVAR-5, Run: 065, P, 0, 0, 1, 0, 0, 32, 32, 0, 0, 160, 1, 11, 53, 92, 503, 21, 23, 8, 32, 53, 79, 124, 503
INVAR-5, Run: 066, P, 0, 0, 1, 0, 0, 31, 31, 0, 0, 160, 1, 9, 53, 128, 370, 22, 15, 15, 31, 53, 79, 159, 370
INVAR-5, Run: 067, P, 0, 0, 1, 0, 0, 31, 31, 0, 0, 160, 1, 9, 53, 231, 575, 22, 14, 16, 31, 53, 79, 262, 575
INVAR-5, Run: 068, P, 0, 0, 1, 0, 0, 30, 30, 0, 0, 160, 1, 7, 53, 148, 473, 23, 9, 20, 30, 53, 79, 178, 473
INVAR-5, Run: 069, P, 0, 0, 1, 0, 0, 32, 32, 0, 0, 160, 1, 11, 53, 114, 538, 21, 17, 14, 32, 53, 79, 146, 538
INVAR-5, Run: 070, P, 0, 0, 1, 0, 0, 32, 32, 0, 0, 160, 1, 11, 53, 148, 533, 21, 17, 14, 32, 53, 79, 180, 533
INVAR-5, Run: 071, P, 0, 0, 1, 0, 0, 32, 32, 0, 0, 160, 1, 11, 53, 168, 630, 21, 23, 8, 32, 53, 79, 200, 630
INVAR-5, Run: 072, P, 0, 0, 1, 0, 0, 34, 34, 0, 0, 160, 1, 15, 53, 197, 768, 19, 18, 15, 34, 53, 79, 231, 768
INVAR-5, Run: 073, P, 0, 0, 1, 0, 0, 30, 30, 0, 0, 160, 1, 7, 53, 99, 622, 23, 20, 9, 30, 53, 79, 129, 622
INVAR-5, Run: 074, P, 0, 0, 1, 0, 0, 28, 28, 0, 0, 160, 1, 3, 53, 93, 377, 25, 13, 14, 28, 53, 79, 121, 377
INVAR-5, Run: 075, P, 0, 0, 1, 0, 0, 31, 31, 0, 0, 160, 1, 9, 53, 144, 417, 22, 15, 15, 31, 53, 79, 175, 417
INVAR-5, Run: 076, P, 0, 0, 1, 0, 0, 32, 32, 0, 0, 160, 1, 11, 53, 149, 672, 21, 17, 14, 32, 53, 79, 181, 672
INVAR-5, Run: 077, P, 0, 0, 1, 0, 0, 32, 32, 0, 0, 160, 1, 11, 53, 160, 507, 21, 21, 10, 32, 53, 79, 192, 507
INVAR-5, Run: 078, P, 0, 0, 1, 0, 0, 30, 30, 0, 0, 160, 1, 7, 53, 118, 399, 23, 15, 14, 30, 53, 79, 148, 399
INVAR-5, Run: 079, P, 0, 0, 1, 0, 0, 30, 30, 0, 0, 160, 1, 7, 53, 145, 602, 23, 14, 15, 30, 53, 79, 175, 602
INVAR-5, Run: 080, P, 0, 0, 1, 0, 0, 34, 34, 0, 0, 160, 1, 15, 53, 186, 665, 19, 23, 10, 34, 53, 79, 220, 665
INVAR-5, Run: 081, P, 0, 0, 1, 0, 0, 30, 30, 0, 0, 160, 1, 7, 53, 88, 277, 23, 18, 11, 30, 53, 79, 118, 277
INVAR-5, Run: 082, P, 0, 0, 1, 0, 0, 28, 28, 0, 0, 160, 1, 3, 53, 96, 416, 25, 17, 10, 28, 53, 79, 124, 416
INVAR-5, Run: 083, P, 0, 0, 1, 0, 0, 30, 30, 0, 0, 160, 1, 7, 53, 130, 373, 23, 18, 11, 30, 53, 79, 160, 373
INVAR-5, Run: 084, P, 0, 0, 1, 0, 0, 32, 32, 0, 0, 160, 1, 11, 53, 209, 915, 21, 17, 14, 32, 53, 79, 241, 915
INVAR-5, Run: 085, P, 0, 0, 1, 0, 0, 30, 30, 0, 0, 160, 1, 7, 53, 95, 322, 23, 17, 12, 30, 53, 79, 125, 322
INVAR-5, Run: 086, P, 0, 0, 1, 0, 0, 32, 32, 0, 0, 160, 1, 11, 53, 120, 394, 21, 18, 13, 32, 53, 79, 152, 394
INVAR-5, Run: 087, P, 0, 0, 1, 0, 0, 32, 32, 0, 0, 160, 1, 11, 53, 124, 648, 21, 16, 15, 32, 53, 79, 156, 648
INVAR-5, Run: 088, P, 0, 0, 1, 0, 0, 29, 29, 0, 0, 160, 1, 5, 53, 103, 391, 24, 9, 19, 29, 53, 79, 132, 391
INVAR-5, Run: 089, P, 0, 0, 1, 0, 0, 30, 30, 0, 0, 160, 1, 7, 53, 122, 799, 23, 17, 12, 30, 53, 79, 152, 799
INVAR-5, Run: 090, P, 0, 0, 1, 0, 0, 28, 28, 0, 0, 160, 1, 3, 53, 150, 554, 25, 17, 10, 28, 53, 79, 178, 554
INVAR-5, Run: 091, P, 0, 0, 1, 0, 0, 32, 32, 0, 0, 160, 1, 11, 53, 192, 760, 21, 16, 15, 32, 53, 79, 224, 760
INVAR-5, Run: 092, P, 0, 0, 1, 0, 0, 30, 30, 0, 0, 160, 1, 7, 53, 134, 479, 23, 19, 10, 30, 53, 79, 164, 479
INVAR-5, Run: 093, P, 0, 0, 1, 0, 0, 33, 33, 0, 0, 160, 1, 13, 53, 107, 372, 20, 15, 17, 33, 53, 79, 140, 372
INVAR-5, Run: 094, P, 0, 0, 1, 0, 0, 33, 33, 0, 0, 160, 1, 13, 53, 162, 559, 20, 21, 11, 33, 53, 79, 195, 559
INVAR-5, Run: 095, P, 0, 0, 1, 0, 0, 31, 31, 0, 0, 160, 1, 9, 53, 112, 471, 22, 18, 12, 31, 53, 79, 143, 471
INVAR-5, Run: 096, P, 0, 0, 1, 0, 0, 32, 32, 0, 0, 160, 1, 11, 53, 145, 629, 21, 18, 13, 32, 53, 79, 177, 629
INVAR-5, Run: 097, P, 0, 0, 1, 0, 0, 31, 31, 0, 0, 160, 1, 9, 53, 156, 600, 22, 18, 12, 31, 53, 79, 187, 600
INVAR-5, Run: 098, P, 0, 0, 1, 0, 0, 31, 31, 0, 0, 160, 1, 9, 53, 78, 414, 22, 17, 13, 31, 53, 79, 109, 414
INVAR-5, Run: 099, P, 0, 0, 1, 0, 0, 33, 33, 0, 0, 160, 1, 13, 53, 177, 641, 20, 14, 18, 33, 53, 79, 210, 641
INVAR-5, Run: 100, P, 0, 0, 1, 0, 0, 32, 32, 0, 0, 160, 1, 11, 53, 161, 680, 21, 13, 18, 32, 53, 79, 193, 680
INVAR-6, Run: 001, P, 0, 0, 1, 0, 0, 98, 98, 0, 0, 526, 1, 21, 175, 779, 3016, 77, 62, 35, 98, 175, 262, 877, 3016
INVAR-6, Run: 002, P, 0, 0, 1, 0, 0, 96, 96, 0, 0, 526, 1, 17, 175, 772, 2444, 79, 51, 44, 96, 175, 262, 868, 2444
INVAR-6, Run: 003, P, 0, 0, 1, 0, 0, 95, 95, 0, 0, 526, 1, 15, 175, 858, 3640, 80, 47, 47, 95, 175, 262, 953, 3640
INVAR-6, Run: 004, P, 0, 0, 1, 0, 0, 94, 94, 0, 0, 526, 1, 13, 175, 660, 3233, 81, 57, 36, 94, 175, 262, 754, 3233
INVAR-6, Run: 005, P, 0, 0, 1, 0, 0, 98, 98, 0, 0, 526, 1, 21, 175, 775, 4142, 77, 59, 38, 98, 175, 262, 873, 4142
INVAR-6, Run: 006, P, 0, 0, 1, 0, 0, 96, 96, 0, 0, 526, 1, 17, 175, 905, 3943, 79, 54, 41, 96, 175, 262, 1001, 3943
INVAR-6, Run: 007, P, 0, 0, 1, 0, 0, 93, 93, 0, 0, 526, 1, 11, 175, 676, 3069, 82, 52, 40, 93, 175, 262, 769, 3069
INVAR-6, Run: 008, P, 0, 0, 1, 0, 0, 95, 95, 0, 0, 526, 1, 15, 175, 941, 4302, 80, 55, 39, 95, 175, 262, 1036, 4302
INVAR-6, Run: 009, P, 0, 0, 1, 0, 0, 94, 94, 0, 0, 526, 1, 13, 175, 793, 2751, 81, 52, 41, 94, 175, 262, 887, 2751
INVAR-6, Run: 010, P, 0, 0, 1, 0, 0, 96, 96, 0, 0, 526, 1, 17, 175, 1073, 3665, 79, 55, 40, 96, 175, 262, 1169, 3665
INVAR-6, Run: 011, P, 0, 0, 1, 0, 0, 96, 96, 0, 0, 526, 1, 17, 175, 751, 3707, 79, 49, 46, 96, 175, 262, 847, 3707
INVAR-6, Run: 012, P, 0, 0, 1, 0, 0, 98, 98, 0, 0, 526, 1, 21, 175, 606, 4252, 77, 79, 18, 98, 175, 262, 704, 4252
INVAR-6, Run: 013, P, 0, 0, 1, 0, 0, 100, 100, 0, 0, 526, 1, 25, 175, 867, 3447, 75, 67, 32, 100, 175, 262, 967, 3447
INVAR-6, Run: 014, P, 0, 0, 1, 0, 0, 96, 96, 0, 0, 526, 1, 17, 175, 861, 4043, 79, 62, 33, 96, 175, 262, 957, 4043
INVAR-6, Run: 015, P, 0, 0, 1, 0, 0, 101, 101, 0, 0, 526, 1, 27, 175, 968, 4907, 74, 60, 40, 101, 175, 262, 1069, 4907
INVAR-6, Run: 016, P, 0, 0, 1, 0, 0, 95, 95, 0, 0, 526, 1, 15, 175, 854, 3230, 80, 59, 35, 95, 175, 262, 949, 3230
INVAR-6, Run: 017, P, 0, 0, 1, 0, 0, 96, 96, 0, 0, 526, 1, 17, 175, 890, 4872, 79, 60, 35, 96, 175, 262, 986, 4872
INVAR-6, Run: 018, P, 0, 0, 1, 0, 0, 93, 93, 0, 0, 526, 1, 11, 175, 675, 3605, 82, 63, 29, 93, 175, 262, 768, 3605
INVAR-6, Run: 019, P, 0, 0, 1, 0, 0, 97, 97, 0, 0, 526, 1, 19, 175, 932, 3352, 78, 58, 38, 97, 175, 262, 1029, 3352
INVAR-6, Run: 020, P, 0, 0, 1, 0, 0, 95, 95, 0, 0, 526, 1, 15, 175, 910, 3009, 80, 54, 40, 95, 175, 262, 1005, 3009
INVAR-6, Run: 021, P, 0, 0, 1, 0, 0, 93, 93, 0, 0, 526, 1, 11, 175, 745, 3059, 82, 62, 30, 93, 175, 262, 838, 3059
INVAR-6, Run: 022, P, 0, 0, 1, 0, 0, 99, 99, 0, 0, 526, 1, 23, 175, 1215, 6051, 76, 59, 39, 99, 175, 262, 1314, 6051
INVAR-6, Run: 023, P, 0, 0, 1, 0, 0, 98, 98, 0, 0, 526, 1, 21, 175, 856, 4434, 77, 64, 33, 98, 175, 262, 954, 4434
INVAR-6, Run: 024, P, 0, 0, 1, 0, 0, 98, 98, 0, 0, 526, 1, 21, 175, 717, 2871, 77, 59, 38, 98, 175, 262, 815, 2871
INVAR-6, Run: 025, P, 0, 0, 1, 0, 0, 99, 99, 0, 0, 526, 1, 23, 175, 775, 3026, 76, 76, 22, 99, 175, 262, 874, 3026
INVAR-6, Run: 026, P, 0, 0, 1, 0, 0, 94, 94, 0, 0, 526, 1, 13, 175, 883, 3567, 81, 55, 38, 94, 175, 262, 977, 3567
INVAR-6, Run: 027, P, 0, 0, 1, 0, 0, 101, 101, 0, 0, 526, 1, 27, 175, 990, 3643, 74, 52, 48, 101, 175, 262, 1091, 3643
INVAR-6, Run: 028, P, 0, 0, 1, 0, 0, 95, 95, 0, 0, 526, 1, 15, 175, 804, 3703, 80, 60, 34, 95, 175, 262, 899, 3703
INVAR-6, Run: 029, P, 0, 0, 1, 0, 0, 98, 98, 0, 0, 526, 1, 21, 175, 1050, 4426, 77, 53, 44, 98, 175, 262, 1148, 4426
INVAR-6, Run: 030, P, 0, 0, 1, 0, 0, 97, 97, 0, 0, 526, 1, 19, 175, 769, 4073, 78, 59, 37, 97, 175, 262, 866, 4073
INVAR-6, Run: 031, P, 0, 0, 1, 0, 0, 96, 96, 0, 0, 526, 1, 17, 175, 799, 2721, 79, 60, 35, 96, 175, 262, 895, 2721
INVAR-6, Run: 032, P, 0, 0, 1, 0, 0, 95, 95, 0, 0, 526, 1, 15, 175, 707, 3003, 80, 59, 35, 95, 175, 262, 802, 3003
INVAR-6, Run: 033, P, 0, 0, 1, 0, 0, 95, 95, 0, 0, 526, 1, 15, 175, 707, 3239, 80, 61, 33, 95, 175, 262, 802, 3239
INVAR-6, Run: 034, P, 0, 0, 1, 0, 0, 98, 98, 0, 0, 526, 1, 21, 175, 966, 3474, 77, 66, 31, 98, 175, 262, 1064, 3474
INVAR-6, Run: 035, P, 0, 0, 1, 0, 0, 96, 96, 0, 0, 526, 1, 17, 175, 759, 3322, 79, 49, 46, 96, 175, 262, 855, 3322
INVAR-6, Run: 036, P, 0, 0, 1, 0, 0, 98, 98, 0, 0, 526, 1, 21, 175, 980, 4204, 77, 58, 39, 98, 175, 262, 1078, 4204
INVAR-6, Run: 037, P, 0, 0, 1, 0, 0, 93, 93, 0, 0, 526, 1, 11, 175, 760, 3356, 82, 45, 47, 93, 175, 262, 853, 3356
INVAR-6, Run: 038, P, 0, 0, 1, 0, 0, 99, 99, 0, 0, 526, 1, 23, 175, 846, 4049, 76, 54, 44, 99, 175, 262, 945, 4049
INVAR-6, Run: 039, P, 0, 0, 1, 0, 0, 94, 94, 0, 0, 526, 1, 13, 175, 940, 3285, 81, 52, 41, 94, 175, 262, 1034, 3285
INVAR-6, Run: 040, P, 0, 0, 1, 0, 0, 99, 99, 0, 0, 526, 1, 23, 175, 894, 3694, 76, 61, 37, 99, 175, 262, 993, 3694
INVAR-6, Run: 041, P, 0, 0, 1, 0, 0, 95, 95, 0, 0, 526, 1, 15, 175, 776, 3174, 80, 56, 38, 95, 175, 262, 871, 3174
INVAR-6, Run: 042, P, 0, 0, 1, 0, 0, 94, 94, 0, 0, 526, 1, 13, 175, 689, 1988, 81, 57, 36, 94, 175, 262, 783, 1988
INVAR-6, Run: 043, P, 0, 0, 1, 0, 0, 98, 98, 0, 0, 526, 1, 21, 175, 822, 2723, 77, 57, 40, 98, 175, 262, 920, 2723
INVAR-6, Run: 044, P, 0, 0, 1, 0, 0, 94, 94, 0, 0, 526, 1, 13, 175, 753, 2960, 81, 54, 39, 94, 175, 262, 847, 2960
INVAR-6, Run: 045, P, 0, 0, 1, 0, 0, 98, 98, 0, 0, 526, 1, 21, 175, 791, 2677, 77, 53, 44, 98, 175, 262, 889, 2677
INVAR-6, Run: 046, P, 0, 0, 1, 0, 0, 96, 96, 0, 0, 526, 1, 17, 175, 1004, 3264, 79, 54, 41, 96, 175, 262, 1100, 3264
INVAR-6, Run: 047, P, 0, 0, 1, 0, 0, 96, 96, 0, 0, 526, 1, 17, 175, 816, 3660, 79, 57, 38, 96, 175, 262, 912, 3660
INVAR-6, Run: 048, P, 0, 0, 1, 0, 0, 96, 96, 0, 0, 526, 1, 17, 175, 948, 2895, 79, 51, 44, 96, 175, 262, 1044, 2895
INVAR-6, Run: 049, P, 0, 0, 1, 0, 0, 95, 95, 0, 0, 526, 1, 15, 175, 1088, 3982, 80, 49, 45, 95, 175, 262, 1183, 3982
INVAR-6, Run: 050, P, 0, 0, 1, 0, 0, 98, 98, 0, 0, 526, 1, 21, 175, 885, 4766, 77, 50, 47, 98, 175, 262, 983, 4766
INVAR-6, Run: 051, P, 0, 0, 1, 0, 0, 97, 97, 0, 0, 526, 1, 19, 175, 764, 3373, 78, 57, 39, 97, 175, 262, 861, 3373
INVAR-6, Run: 052, P, 0, 0, 1, 0, 0, 97, 97, 0, 0, 526, 1, 19, 175, 820, 2397, 78, 53, 43, 97, 175, 262, 917, 2397
INVAR-6, Run: 053, P, 0, 0, 1, 0, 0, 98, 98, 0, 0, 526, 1, 21, 175, 869, 3284, 77, 63, 34, 98, 175, 262, 967, 3284
INVAR-6, Run: 054, P, 0, 0, 1, 0, 0, 95, 95, 0, 0, 526, 1, 15, 175, 673, 3299, 80, 51, 43, 95, 175, 262, 768, 3299
INVAR-6, Run: 055, P, 0, 0, 1, 0, 0, 101, 101, 0, 0, 526, 1, 27, 175, 845, 4377, 74, 58, 42, 101, 175, 262, 946, 4377
INVAR-6, Run: 056, P, 0, 0, 1, 0, 0, 96, 96, 0, 0, 526, 1, 17, 175, 941, 5034, 79, 50, 45, 96, 175, 262, 1037, 5034
INVAR-6, Run: 057, P, 0, 0, 1, 0, 0, 93, 93, 0, 0, 526, 1, 11, 175, 905, 4003, 82, 59, 33, 93, 175, 262, 998, 4003
INVAR-6, Run: 058, P, 0, 0, 1, 0, 0, 98, 98, 0, 0, 526, 1, 21, 175, 843, 3959, 77, 68, 29, 98, 175, 262, 941, 3959
INVAR-6, Run: 059, P, 0, 0, 1, 0, 0, 97, 97, 0, 0, 526, 1, 19, 175, 765, 4067, 78, 62, 34, 97, 175, 262, 862, 4067
INVAR-6, Run: 060, P, 0, 0, 1, 0, 0, 96, 96, 0, 0, 526, 1, 17, 175, 776, 3072, 79, 53, 42, 96, 175, 262, 872, 3072
INVAR-6, Run: 061, P, 0, 0, 1, 0, 0, 94, 94, 0, 0, 526, 1, 13, 175, 718, 3191, 81, 57, 36, 94, 175, 262, 812, 3191
INVAR-6, Run: 062, P, 0, 0, 1, 0, 0, 99, 99, 0, 0, 526, 1, 23, 175, 764, 3296, 76, 57, 41, 99, 175, 262, 863, 3296
INVAR-6, Run: 063, P, 0, 0, 1, 0, 0, 95, 95, 0, 0, 526, 1, 15, 175, 790, 4062, 80, 59, 35, 95, 175, 262, 885, 4062
INVAR-6, Run: 064, P, 0, 0, 1, 0, 0, 96, 96, 0, 0, 526, 1, 17, 175, 827, 3653, 79, 52, 43, 96, 175, 262, 923, 3653
INVAR-6, Run: 065, P, 0, 0, 1, 0, 0, 99, 99, 0, 0, 526, 1, 23, 175, 910, 3783, 76, 61, 37, 99, 175, 262, 1009, 3783
INVAR-6, Run: 066, P, 0, 0, 1, 0, 0, 95, 95, 0, 0, 526, 1, 15, 175, 774, 2671, 80, 54, 40, 95, 175, 262, 869, 2671
INVAR-6, Run: 067, P, 0, 0, 1, 0, 0, 97, 97, 0, 0, 526, 1, 19, 175, 902, 3357, 78, 63, 33, 97, 175, 262, 999, 3357
INVAR-6, Run: 068, P, 0, 0, 1, 0, 0, 96, 96, 0, 0, 526, 1, 17, 175, 868, 4889, 79, 54, 41, 96, 175, 262, 964, 4889
INVAR-6, Run: 069, P, 0, 0, 1, 0, 0, 93, 93, 0, 0, 526, 1, 11, 175, 843, 3420, 82, 61, 31, 93, 175, 262, 936, 3420
INVAR-6, Run: 070, P, 0, 0, 1, 0, 0, 93, 93, 0, 0, 526, 1, 11, 175, 611, 2878, 82, 52, 40, 93, 175, 262, 704, 2878
INVAR-6, Run: 071, P, 0, 0, 1, 0, 0, 96, 96, 0, 0, 526, 1, 17, 175, 732, 3173, 79, 53, 42, 96, 175, 262, 828, 3173
INVAR-6, Run: 072, P, 0, 0, 1, 0, 0, 95, 95, 0, 0, 526, 1, 15, 175, 994, 4099, 80, 51, 43, 95, 175, 262, 1089, 4099
INVAR-6, Run: 073, P, 0, 0, 1, 0, 0, 100, 100, 0, 0, 526, 1, 25, 175, 768, 3120, 75, 58, 41, 100, 175, 262, 868, 3120
INVAR-6, Run: 074, P, 0, 0, 1, 0, 0, 94, 94, 0, 0, 526, 1, 13, 175, 776, 3164, 81, 48, 45, 94, 175, 262, 870, 3164
INVAR-6, Run: 075, P, 0, 0, 1, 0, 0, 96, 96, 0, 0, 526, 1, 17, 175, 935, 3728, 79, 51, 44, 96, 175, 262, 1031, 3728
INVAR-6, Run: 076, P, 0, 0, 1, 0, 0, 96, 96, 0, 0, 526, 1, 17, 175, 966, 4839, 79, 51, 44, 96, 175, 262, 1062, 4839
INVAR-6, Run: 077, P, 0, 0, 1, 0, 0, 100, 100, 0, 0, 526, 1, 25, 175, 867, 3273, 75, 60, 39, 100, 175, 262, 967, 3273
INVAR-6, Run: 078, P, 0, 0, 1, 0, 0, 95, 95, 0, 0, 526, 1, 15, 175, 698, 3474, 80, 48, 46, 95, 175, 262, 793, 3474
INVAR-6, Run: 079, P, 0, 0, 1, 0, 0, 97, 97, 0, 0, 526, 1, 19, 175, 922, 5355, 78, 58, 38, 97, 175, 262, 1019, 5355
INVAR-6, Run: 080, P, 0, 0, 1, 0, 0, 98, 98, 0, 0, 526, 1, 21, 175, 1067, 3673, 77, 59, 38, 98, 175, 262, 1165, 3673
INVAR-6, Run: 081, P, 0, 0, 1, 0, 0, 95, 95, 0, 0, 526, 1, 15, 175, 694, 3481, 80, 58, 36, 95, 175, 262, 789, 3481
INVAR-6, Run: 082, P, 0, 0, 1, 0, 0, 97, 97, 0, 0, 526, 1, 19, 175, 1021, 4692, 78, 52, 44, 97, 175, 262, 1118, 4692
INVAR-6, Run: 083, P, 0, 0, 1, 0, 0, 95, 95, 0, 0, 526, 1, 15, 175, 1006, 3293, 80, 65, 29, 95, 175, 262, 1101, 3293
INVAR-6, Run: 084, P, 0, 0, 1, 0, 0, 95, 95, 0, 0, 526, 1, 15, 175, 819, 3591, 80, 59, 35, 95, 175, 262, 914, 3591
INVAR-6, Run: 085, P, 0, 0, 1, 0, 0, 95, 95, 0, 0, 526, 1, 15, 175, 786, 4023, 80, 60, 34, 95, 175, 262, 881, 4023
INVAR-6, Run: 086, P, 0, 0, 1, 0, 0, 95, 95, 0, 0, 526, 1, 15, 175, 783, 3560, 80, 64, 30, 95, 175, 262, 878, 3560
INVAR-6, Run: 087, P, 0, 0, 1, 0, 0, 93, 93, 0, 0, 526, 1, 11, 175, 920, 3514, 82, 46, 46, 93, 175, 262, 1013, 3514
INVAR-6, Run: 088, P, 0, 0, 1, 0, 0, 94, 94, 0, 0, 526, 1, 13, 175, 995, 3533, 81, 48, 45, 94, 175, 262, 1089, 3533
INVAR-6, Run: 089, P, 0, 0, 1, 0, 0, 93, 93, 0, 0, 526, 1, 11, 175, 786, 3528, 82, 50, 42, 93, 175, 262, 879, 3528
INVAR-6, Run: 090, P, 0, 0, 1, 0, 0, 100, 100, 0, 0, 526, 1, 25, 175, 825, 3028, 75, 59, 40, 100, 175, 262, 925, 3028
INVAR-6, Run: 091, P, 0, 0, 1, 0, 0, 97, 97, 0, 0, 526, 1, 19, 175, 850, 4635, 78, 52, 44, 97, 175, 262, 947, 4635
INVAR-6, Run: 092, P, 0, 0, 1, 0, 0, 94, 94, 0, 0, 526, 1, 13, 175, 1068, 5631, 81, 54, 39, 94, 175, 262, 1162, 5631
INVAR-6, Run: 093, P, 0, 0, 1, 0, 0, 97, 97, 0, 0, 526, 1, 19, 175, 758, 4052, 78, 62, 34, 97, 175, 262, 855, 4052
INVAR-6, Run: 094, P, 0, 0, 1, 0, 0, 95, 95, 0, 0, 526, 1, 15, 175, 693, 3041, 80, 51, 43, 95, 175, 262, 788, 3041
INVAR-6, Run: 095, P, 0, 0, 1, 0, 0, 97, 97, 0, 0, 526, 1, 19, 175, 1090, 3382, 78, 57, 39, 97, 175, 262, 1187, 3382
INVAR-6, Run: 096, P, 0, 0, 1, 0, 0, 94, 94, 0, 0, 526, 1, 13, 175, 798, 3498, 81, 50, 43, 94, 175, 262, 892, 3498
INVAR-6, Run: 097, P, 0, 0, 1, 0, 0, 96, 96, 0, 0, 526, 1, 17, 175, 1043, 4051, 79, 58, 37, 96, 175, 262, 1139, 4051
INVAR-6, Run: 098, P, 0, 0, 1, 0, 0, 98, 98, 0, 0, 526, 1, 21, 175, 777, 3517, 77, 70, 27, 98, 175, 262, 875, 3517
INVAR-6, Run: 099, P, 0, 0, 1, 0, 0, 96, 96, 0, 0, 526, 1, 17, 175, 921, 3827, 79, 61, 34, 96, 175, 262, 1017, 3827
INVAR-6, Run: 100, P, 0, 0, 1, 0, 0, 97, 97, 0, 0, 526, 1, 19, 175, 750, 4230, 78, 55, 41, 97, 175, 262, 847, 4230
INVAR-7, Run: 001, P, 0, 0, 0, 0, 0, 0, 0, 0, 0, 0, 0, 0, 0, 0, 0, 0, 0, 0, 0, 0, 0, 0, 0
INVAR-7, Run: 002, P, 0, 0, 0, 0, 0, 0, 0, 0, 0, 0, 0, 0, 0, 0, 0, 0, 0, 0, 0, 0, 0, 0, 0
INVAR-7, Run: 003, P, 0, 0, 0, 0, 0, 0, 0, 0, 0, 0, 0, 0, 0, 0, 0, 0, 0, 0, 0, 0, 0, 0, 0
INVAR-7, Run: 004, P, 0, 0, 0, 0, 0, 0, 0, 0, 0, 0, 0, 0, 0, 0, 0, 0, 0, 0, 0, 0, 0, 0, 0
INVAR-7, Run: 005, P, 0, 0, 0, 0, 0, 0, 0, 0, 0, 0, 0, 0, 0, 0, 0, 0, 0, 0, 0, 0, 0, 0, 0
INVAR-7, Run: 006, P, 0, 0, 0, 0, 0, 0, 0, 0, 0, 0, 0, 0, 0, 0, 0, 0, 0, 0, 0, 0, 0, 0, 0
INVAR-7, Run: 007, P, 0, 0, 0, 0, 0, 0, 0, 0, 0, 0, 0, 0, 0, 0, 0, 0, 0, 0, 0, 0, 0, 0, 0
INVAR-7, Run: 008, P, 0, 0, 0, 0, 0, 0, 0, 0, 0, 0, 0, 0, 0, 0, 0, 0, 0, 0, 0, 0, 0, 0, 0
INVAR-7, Run: 009, P, 0, 0, 0, 0, 0, 0, 0, 0, 0, 0, 0, 0, 0, 0, 0, 0, 0, 0, 0, 0, 0, 0, 0
INVAR-7, Run: 010, P, 0, 0, 0, 0, 0, 0, 0, 0, 0, 0, 0, 0, 0, 0, 0, 0, 0, 0, 0, 0, 0, 0, 0
INVAR-7, Run: 011, P, 0, 0, 0, 0, 0, 0, 0, 0, 0, 0, 0, 0, 0, 0, 0, 0, 0, 0, 0, 0, 0, 0, 0
INVAR-7, Run: 012, P, 0, 0, 0, 0, 0, 0, 0, 0, 0, 0, 0, 0, 0, 0, 0, 0, 0, 0, 0, 0, 0, 0, 0
INVAR-7, Run: 013, P, 0, 0, 0, 0, 0, 0, 0, 0, 0, 0, 0, 0, 0, 0, 0, 0, 0, 0, 0, 0, 0, 0, 0
INVAR-7, Run: 014, P, 0, 0, 0, 0, 0, 0, 0, 0, 0, 0, 0, 0, 0, 0, 0, 0, 0, 0, 0, 0, 0, 0, 0
INVAR-7, Run: 015, P, 0, 0, 0, 0, 0, 0, 0, 0, 0, 0, 0, 0, 0, 0, 0, 0, 0, 0, 0, 0, 0, 0, 0
INVAR-7, Run: 016, P, 0, 0, 0, 0, 0, 0, 0, 0, 0, 0, 0, 0, 0, 0, 0, 0, 0, 0, 0, 0, 0, 0, 0
INVAR-7, Run: 017, P, 0, 0, 0, 0, 0, 0, 0, 0, 0, 0, 0, 0, 0, 0, 0, 0, 0, 0, 0, 0, 0, 0, 0
INVAR-7, Run: 018, P, 0, 0, 0, 0, 0, 0, 0, 0, 0, 0, 0, 0, 0, 0, 0, 0, 0, 0, 0, 0, 0, 0, 0
INVAR-7, Run: 019, P, 0, 0, 0, 0, 0, 0, 0, 0, 0, 0, 0, 0, 0, 0, 0, 0, 0, 0, 0, 0, 0, 0, 0
INVAR-7, Run: 020, P, 0, 0, 0, 0, 0, 0, 0, 0, 0, 0, 0, 0, 0, 0, 0, 0, 0, 0, 0, 0, 0, 0, 0
INVAR-7, Run: 021, P, 0, 0, 0, 0, 0, 0, 0, 0, 0, 0, 0, 0, 0, 0, 0, 0, 0, 0, 0, 0, 0, 0, 0
INVAR-7, Run: 022, P, 0, 0, 0, 0, 0, 0, 0, 0, 0, 0, 0, 0, 0, 0, 0, 0, 0, 0, 0, 0, 0, 0, 0
INVAR-7, Run: 023, P, 0, 0, 0, 0, 0, 0, 0, 0, 0, 0, 0, 0, 0, 0, 0, 0, 0, 0, 0, 0, 0, 0, 0
INVAR-7, Run: 024, P, 0, 0, 0, 0, 0, 0, 0, 0, 0, 0, 0, 0, 0, 0, 0, 0, 0, 0, 0, 0, 0, 0, 0
INVAR-7, Run: 025, P, 0, 0, 0, 0, 0, 0, 0, 0, 0, 0, 0, 0, 0, 0, 0, 0, 0, 0, 0, 0, 0, 0, 0
INVAR-7, Run: 026, P, 0, 0, 0, 0, 0, 0, 0, 0, 0, 0, 0, 0, 0, 0, 0, 0, 0, 0, 0, 0, 0, 0, 0
INVAR-7, Run: 027, P, 0, 0, 0, 0, 0, 0, 0, 0, 0, 0, 0, 0, 0, 0, 0, 0, 0, 0, 0, 0, 0, 0, 0
INVAR-7, Run: 028, P, 0, 0, 0, 0, 0, 0, 0, 0, 0, 0, 0, 0, 0, 0, 0, 0, 0, 0, 0, 0, 0, 0, 0
INVAR-7, Run: 029, P, 0, 0, 0, 0, 0, 0, 0, 0, 0, 0, 0, 0, 0, 0, 0, 0, 0, 0, 0, 0, 0, 0, 0
INVAR-7, Run: 030, P, 0, 0, 0, 0, 0, 0, 0, 0, 0, 0, 0, 0, 0, 0, 0, 0, 0, 0, 0, 0, 0, 0, 0
INVAR-7, Run: 031, P, 0, 0, 0, 0, 0, 0, 0, 0, 0, 0, 0, 0, 0, 0, 0, 0, 0, 0, 0, 0, 0, 0, 0
INVAR-7, Run: 032, P, 0, 0, 0, 0, 0, 0, 0, 0, 0, 0, 0, 0, 0, 0, 0, 0, 0, 0, 0, 0, 0, 0, 0
INVAR-7, Run: 033, P, 0, 0, 0, 0, 0, 0, 0, 0, 0, 0, 0, 0, 0, 0, 0, 0, 0, 0, 0, 0, 0, 0, 0
INVAR-7, Run: 034, P, 0, 0, 0, 0, 0, 0, 0, 0, 0, 0, 0, 0, 0, 0, 0, 0, 0, 0, 0, 0, 0, 0, 0
INVAR-7, Run: 035, P, 0, 0, 0, 0, 0, 0, 0, 0, 0, 0, 0, 0, 0, 0, 0, 0, 0, 0, 0, 0, 0, 0, 0
INVAR-7, Run: 036, P, 0, 0, 0, 0, 0, 0, 0, 0, 0, 0, 0, 0, 0, 0, 0, 0, 0, 0, 0, 0, 0, 0, 0
INVAR-7, Run: 037, P, 0, 0, 0, 0, 0, 0, 0, 0, 0, 0, 0, 0, 0, 0, 0, 0, 0, 0, 0, 0, 0, 0, 0
INVAR-7, Run: 038, P, 0, 0, 0, 0, 0, 0, 0, 0, 0, 0, 0, 0, 0, 0, 0, 0, 0, 0, 0, 0, 0, 0, 0
INVAR-7, Run: 039, P, 0, 0, 0, 0, 0, 0, 0, 0, 0, 0, 0, 0, 0, 0, 0, 0, 0, 0, 0, 0, 0, 0, 0
INVAR-7, Run: 040, P, 0, 0, 0, 0, 0, 0, 0, 0, 0, 0, 0, 0, 0, 0, 0, 0, 0, 0, 0, 0, 0, 0, 0
INVAR-7, Run: 041, P, 0, 0, 0, 0, 0, 0, 0, 0, 0, 0, 0, 0, 0, 0, 0, 0, 0, 0, 0, 0, 0, 0, 0
INVAR-7, Run: 042, P, 0, 0, 0, 0, 0, 0, 0, 0, 0, 0, 0, 0, 0, 0, 0, 0, 0, 0, 0, 0, 0, 0, 0
INVAR-7, Run: 043, P, 0, 0, 0, 0, 0, 0, 0, 0, 0, 0, 0, 0, 0, 0, 0, 0, 0, 0, 0, 0, 0, 0, 0
INVAR-7, Run: 044, P, 0, 0, 0, 0, 0, 0, 0, 0, 0, 0, 0, 0, 0, 0, 0, 0, 0, 0, 0, 0, 0, 0, 0
INVAR-7, Run: 045, P, 0, 0, 0, 0, 0, 0, 0, 0, 0, 0, 0, 0, 0, 0, 0, 0, 0, 0, 0, 0, 0, 0, 0
INVAR-7, Run: 046, P, 0, 0, 0, 0, 0, 0, 0, 0, 0, 0, 0, 0, 0, 0, 0, 0, 0, 0, 0, 0, 0, 0, 0
INVAR-7, Run: 047, P, 0, 0, 0, 0, 0, 0, 0, 0, 0, 0, 0, 0, 0, 0, 0, 0, 0, 0, 0, 0, 0, 0, 0
INVAR-7, Run: 048, P, 0, 0, 0, 0, 0, 0, 0, 0, 0, 0, 0, 0, 0, 0, 0, 0, 0, 0, 0, 0, 0, 0, 0
INVAR-7, Run: 049, P, 0, 0, 0, 0, 0, 0, 0, 0, 0, 0, 0, 0, 0, 0, 0, 0, 0, 0, 0, 0, 0, 0, 0
INVAR-7, Run: 050, P, 0, 0, 0, 0, 0, 0, 0, 0, 0, 0, 0, 0, 0, 0, 0, 0, 0, 0, 0, 0, 0, 0, 0
INVAR-7, Run: 051, P, 0, 0, 0, 0, 0, 0, 0, 0, 0, 0, 0, 0, 0, 0, 0, 0, 0, 0, 0, 0, 0, 0, 0
INVAR-7, Run: 052, P, 0, 0, 0, 0, 0, 0, 0, 0, 0, 0, 0, 0, 0, 0, 0, 0, 0, 0, 0, 0, 0, 0, 0
INVAR-7, Run: 053, P, 0, 0, 0, 0, 0, 0, 0, 0, 0, 0, 0, 0, 0, 0, 0, 0, 0, 0, 0, 0, 0, 0, 0
INVAR-7, Run: 054, P, 0, 0, 0, 0, 0, 0, 0, 0, 0, 0, 0, 0, 0, 0, 0, 0, 0, 0, 0, 0, 0, 0, 0
INVAR-7, Run: 055, P, 0, 0, 0, 0, 0, 0, 0, 0, 0, 0, 0, 0, 0, 0, 0, 0, 0, 0, 0, 0, 0, 0, 0
INVAR-7, Run: 056, P, 0, 0, 0, 0, 0, 0, 0, 0, 0, 0, 0, 0, 0, 0, 0, 0, 0, 0, 0, 0, 0, 0, 0
INVAR-7, Run: 057, P, 0, 0, 0, 0, 0, 0, 0, 0, 0, 0, 0, 0, 0, 0, 0, 0, 0, 0, 0, 0, 0, 0, 0
INVAR-7, Run: 058, P, 0, 0, 0, 0, 0, 0, 0, 0, 0, 0, 0, 0, 0, 0, 0, 0, 0, 0, 0, 0, 0, 0, 0
INVAR-7, Run: 059, P, 0, 0, 0, 0, 0, 0, 0, 0, 0, 0, 0, 0, 0, 0, 0, 0, 0, 0, 0, 0, 0, 0, 0
INVAR-7, Run: 060, P, 0, 0, 0, 0, 0, 0, 0, 0, 0, 0, 0, 0, 0, 0, 0, 0, 0, 0, 0, 0, 0, 0, 0
INVAR-7, Run: 061, P, 0, 0, 0, 0, 0, 0, 0, 0, 0, 0, 0, 0, 0, 0, 0, 0, 0, 0, 0, 0, 0, 0, 0
INVAR-7, Run: 062, P, 0, 0, 0, 0, 0, 0, 0, 0, 0, 0, 0, 0, 0, 0, 0, 0, 0, 0, 0, 0, 0, 0, 0
INVAR-7, Run: 063, P, 0, 0, 0, 0, 0, 0, 0, 0, 0, 0, 0, 0, 0, 0, 0, 0, 0, 0, 0, 0, 0, 0, 0
INVAR-7, Run: 064, P, 0, 0, 0, 0, 0, 0, 0, 0, 0, 0, 0, 0, 0, 0, 0, 0, 0, 0, 0, 0, 0, 0, 0
INVAR-7, Run: 065, P, 0, 0, 0, 0, 0, 0, 0, 0, 0, 0, 0, 0, 0, 0, 0, 0, 0, 0, 0, 0, 0, 0, 0
INVAR-7, Run: 066, P, 0, 0, 0, 0, 0, 0, 0, 0, 0, 0, 0, 0, 0, 0, 0, 0, 0, 0, 0, 0, 0, 0, 0
INVAR-7, Run: 067, P, 0, 0, 0, 0, 0, 0, 0, 0, 0, 0, 0, 0, 0, 0, 0, 0, 0, 0, 0, 0, 0, 0, 0
INVAR-7, Run: 068, P, 0, 0, 0, 0, 0, 0, 0, 0, 0, 0, 0, 0, 0, 0, 0, 0, 0, 0, 0, 0, 0, 0, 0
INVAR-7, Run: 069, P, 0, 0, 0, 0, 0, 0, 0, 0, 0, 0, 0, 0, 0, 0, 0, 0, 0, 0, 0, 0, 0, 0, 0
INVAR-7, Run: 070, P, 0, 0, 0, 0, 0, 0, 0, 0, 0, 0, 0, 0, 0, 0, 0, 0, 0, 0, 0, 0, 0, 0, 0
INVAR-7, Run: 071, P, 0, 0, 0, 0, 0, 0, 0, 0, 0, 0, 0, 0, 0, 0, 0, 0, 0, 0, 0, 0, 0, 0, 0
INVAR-7, Run: 072, P, 0, 0, 0, 0, 0, 0, 0, 0, 0, 0, 0, 0, 0, 0, 0, 0, 0, 0, 0, 0, 0, 0, 0
INVAR-7, Run: 073, P, 0, 0, 0, 0, 0, 0, 0, 0, 0, 0, 0, 0, 0, 0, 0, 0, 0, 0, 0, 0, 0, 0, 0
INVAR-7, Run: 074, P, 0, 0, 0, 0, 0, 0, 0, 0, 0, 0, 0, 0, 0, 0, 0, 0, 0, 0, 0, 0, 0, 0, 0
INVAR-7, Run: 075, P, 0, 0, 0, 0, 0, 0, 0, 0, 0, 0, 0, 0, 0, 0, 0, 0, 0, 0, 0, 0, 0, 0, 0
INVAR-7, Run: 076, P, 0, 0, 0, 0, 0, 0, 0, 0, 0, 0, 0, 0, 0, 0, 0, 0, 0, 0, 0, 0, 0, 0, 0
INVAR-7, Run: 077, P, 0, 0, 0, 0, 0, 0, 0, 0, 0, 0, 0, 0, 0, 0, 0, 0, 0, 0, 0, 0, 0, 0, 0
INVAR-7, Run: 078, P, 0, 0, 0, 0, 0, 0, 0, 0, 0, 0, 0, 0, 0, 0, 0, 0, 0, 0, 0, 0, 0, 0, 0
INVAR-7, Run: 079, P, 0, 0, 0, 0, 0, 0, 0, 0, 0, 0, 0, 0, 0, 0, 0, 0, 0, 0, 0, 0, 0, 0, 0
INVAR-7, Run: 080, P, 0, 0, 0, 0, 0, 0, 0, 0, 0, 0, 0, 0, 0, 0, 0, 0, 0, 0, 0, 0, 0, 0, 0
INVAR-7, Run: 081, P, 0, 0, 0, 0, 0, 0, 0, 0, 0, 0, 0, 0, 0, 0, 0, 0, 0, 0, 0, 0, 0, 0, 0
INVAR-7, Run: 082, P, 0, 0, 0, 0, 0, 0, 0, 0, 0, 0, 0, 0, 0, 0, 0, 0, 0, 0, 0, 0, 0, 0, 0
INVAR-7, Run: 083, P, 0, 0, 0, 0, 0, 0, 0, 0, 0, 0, 0, 0, 0, 0, 0, 0, 0, 0, 0, 0, 0, 0, 0
INVAR-7, Run: 084, P, 0, 0, 0, 0, 0, 0, 0, 0, 0, 0, 0, 0, 0, 0, 0, 0, 0, 0, 0, 0, 0, 0, 0
INVAR-7, Run: 085, P, 0, 0, 0, 0, 0, 0, 0, 0, 0, 0, 0, 0, 0, 0, 0, 0, 0, 0, 0, 0, 0, 0, 0
INVAR-7, Run: 086, P, 0, 0, 0, 0, 0, 0, 0, 0, 0, 0, 0, 0, 0, 0, 0, 0, 0, 0, 0, 0, 0, 0, 0
INVAR-7, Run: 087, P, 0, 0, 0, 0, 0, 0, 0, 0, 0, 0, 0, 0, 0, 0, 0, 0, 0, 0, 0, 0, 0, 0, 0
INVAR-7, Run: 088, P, 0, 0, 0, 0, 0, 0, 0, 0, 0, 0, 0, 0, 0, 0, 0, 0, 0, 0, 0, 0, 0, 0, 0
INVAR-7, Run: 089, P, 0, 0, 0, 0, 0, 0, 0, 0, 0, 0, 0, 0, 0, 0, 0, 0, 0, 0, 0, 0, 0, 0, 0
INVAR-7, Run: 090, P, 0, 0, 0, 0, 0, 0, 0, 0, 0, 0, 0, 0, 0, 0, 0, 0, 0, 0, 0, 0, 0, 0, 0
INVAR-7, Run: 091, P, 0, 0, 0, 0, 0, 0, 0, 0, 0, 0, 0, 0, 0, 0, 0, 0, 0, 0, 0, 0, 0, 0, 0
INVAR-7, Run: 092, P, 0, 0, 0, 0, 0, 0, 0, 0, 0, 0, 0, 0, 0, 0, 0, 0, 0, 0, 0, 0, 0, 0, 0
INVAR-7, Run: 093, P, 0, 0, 0, 0, 0, 0, 0, 0, 0, 0, 0, 0, 0, 0, 0, 0, 0, 0, 0, 0, 0, 0, 0
INVAR-7, Run: 094, P, 0, 0, 0, 0, 0, 0, 0, 0, 0, 0, 0, 0, 0, 0, 0, 0, 0, 0, 0, 0, 0, 0, 0
INVAR-7, Run: 095, P, 0, 0, 0, 0, 0, 0, 0, 0, 0, 0, 0, 0, 0, 0, 0, 0, 0, 0, 0, 0, 0, 0, 0
INVAR-7, Run: 096, P, 0, 0, 0, 0, 0, 0, 0, 0, 0, 0, 0, 0, 0, 0, 0, 0, 0, 0, 0, 0, 0, 0, 0
INVAR-7, Run: 097, P, 0, 0, 0, 0, 0, 0, 0, 0, 0, 0, 0, 0, 0, 0, 0, 0, 0, 0, 0, 0, 0, 0, 0
INVAR-7, Run: 098, P, 0, 0, 0, 0, 0, 0, 0, 0, 0, 0, 0, 0, 0, 0, 0, 0, 0, 0, 0, 0, 0, 0, 0
INVAR-7, Run: 099, P, 0, 0, 0, 0, 0, 0, 0, 0, 0, 0, 0, 0, 0, 0, 0, 0, 0, 0, 0, 0, 0, 0, 0
INVAR-7, Run: 100, P, 0, 0, 0, 0, 0, 0, 0, 0, 0, 0, 0, 0, 0, 0, 0, 0, 0, 0, 0, 0, 0, 0, 0
INVAR-8, Run: 001, P, 0, 0, 1, 0, 0, 32, 32, 0, 0, 150, 0, 14, 50, 166, 473, 18, 13, 18, 32, 50, 75, 198, 473
INVAR-8, Run: 002, P, 0, 0, 1, 0, 0, 32, 32, 0, 0, 150, 0, 14, 50, 111, 442, 18, 17, 14, 32, 50, 75, 143, 442
INVAR-8, Run: 003, P, 0, 0, 1, 0, 0, 26, 26, 0, 0, 150, 0, 2, 50, 84, 403, 24, 15, 10, 26, 50, 75, 110, 403
INVAR-8, Run: 004, P, 0, 0, 1, 0, 0, 29, 29, 0, 0, 150, 0, 8, 50, 70, 435, 21, 16, 12, 29, 50, 75, 99, 435
INVAR-8, Run: 005, P, 0, 0, 1, 0, 0, 33, 33, 0, 0, 150, 0, 16, 50, 182, 630, 17, 15, 17, 33, 50, 75, 215, 630
INVAR-8, Run: 006, P, 0, 0, 1, 0, 0, 28, 28, 0, 0, 150, 0, 6, 50, 122, 556, 22, 18, 9, 28, 50, 75, 150, 556
INVAR-8, Run: 007, P, 0, 0, 1, 0, 0, 30, 30, 0, 0, 150, 0, 10, 50, 128, 531, 20, 13, 16, 30, 50, 75, 158, 531
INVAR-8, Run: 008, P, 0, 0, 1, 0, 0, 30, 30, 0, 0, 150, 0, 10, 50, 129, 497, 20, 16, 13, 30, 50, 75, 159, 497
INVAR-8, Run: 009, P, 0, 0, 1, 0, 0, 28, 28, 0, 0, 150, 0, 6, 50, 97, 473, 22, 21, 6, 28, 50, 75, 125, 473
INVAR-8, Run: 010, P, 0, 0, 1, 0, 0, 32, 32, 0, 0, 150, 0, 14, 50, 148, 897, 18, 26, 5, 32, 50, 75, 180, 897
INVAR-8, Run: 011, P, 0, 0, 1, 0, 0, 30, 30, 0, 0, 150, 0, 10, 50, 122, 489, 20, 22, 7, 30, 50, 75, 152, 489
INVAR-8, Run: 012, P, 0, 0, 1, 0, 0, 30, 30, 0, 0, 150, 0, 10, 50, 141, 711, 20, 17, 12, 30, 50, 75, 171, 711
INVAR-8, Run: 013, P, 0, 0, 1, 0, 0, 29, 29, 0, 0, 150, 0, 8, 50, 136, 532, 21, 16, 12, 29, 50, 75, 165, 532
INVAR-8, Run: 014, P, 0, 0, 1, 0, 0, 29, 29, 0, 0, 150, 0, 8, 50, 122, 551, 21, 18, 10, 29, 50, 75, 151, 551
INVAR-8, Run: 015, P, 0, 0, 1, 0, 0, 31, 31, 0, 0, 150, 0, 12, 50, 118, 451, 19, 20, 10, 31, 50, 75, 149, 451
INVAR-8, Run: 016, P, 0, 0, 1, 0, 0, 29, 29, 0, 0, 150, 0, 8, 50, 155, 484, 21, 15, 13, 29, 50, 75, 184, 484
INVAR-8, Run: 017, P, 0, 0, 1, 0, 0, 30, 30, 0, 0, 150, 0, 10, 50, 107, 539, 20, 17, 12, 30, 50, 75, 137, 539
INVAR-8, Run: 018, P, 0, 0, 1, 0, 0, 31, 31, 0, 0, 150, 0, 12, 50, 163, 707, 19, 17, 13, 31, 50, 75, 194, 707
INVAR-8, Run: 019, P, 0, 0, 1, 0, 0, 29, 29, 0, 0, 150, 0, 8, 50, 88, 237, 21, 18, 10, 29, 50, 75, 117, 237
INVAR-8, Run: 020, P, 0, 0, 1, 0, 0, 27, 27, 0, 0, 150, 0, 4, 50, 70, 424, 23, 18, 8, 27, 50, 75, 97, 424
INVAR-8, Run: 021, P, 0, 0, 1, 0, 0, 29, 29, 0, 0, 150, 0, 8, 50, 113, 601, 21, 15, 13, 29, 50, 75, 142, 601
INVAR-8, Run: 022, P, 0, 0, 1, 0, 0, 30, 30, 0, 0, 150, 0, 10, 50, 129, 590, 20, 15, 14, 30, 50, 75, 159, 590
INVAR-8, Run: 023, P, 0, 0, 1, 0, 0, 30, 30, 0, 0, 150, 0, 10, 50, 79, 360, 20, 17, 12, 30, 50, 75, 109, 360
INVAR-8, Run: 024, P, 0, 0, 1, 0, 0, 29, 29, 0, 0, 150, 0, 8, 50, 136, 485, 21, 12, 16, 29, 50, 75, 165, 485
INVAR-8, Run: 025, P, 0, 0, 1, 0, 0, 31, 31, 0, 0, 150, 0, 12, 50, 159, 488, 19, 17, 13, 31, 50, 75, 190, 488
INVAR-8, Run: 026, P, 0, 0, 1, 0, 0, 29, 29, 0, 0, 150, 0, 8, 50, 151, 518, 21, 14, 14, 29, 50, 75, 180, 518
INVAR-8, Run: 027, P, 0, 0, 1, 0, 0, 34, 34, 0, 0, 150, 0, 18, 50, 161, 496, 16, 17, 16, 34, 50, 75, 195, 496
INVAR-8, Run: 028, P, 0, 0, 1, 0, 0, 31, 31, 0, 0, 150, 0, 12, 50, 149, 476, 19, 16, 14, 31, 50, 75, 180, 476
INVAR-8, Run: 029, P, 0, 0, 1, 0, 0, 28, 28, 0, 0, 150, 0, 6, 50, 107, 308, 22, 15, 12, 28, 50, 75, 135, 308
INVAR-8, Run: 030, P, 0, 0, 1, 0, 0, 30, 30, 0, 0, 150, 0, 10, 50, 99, 412, 20, 19, 10, 30, 50, 75, 129, 412
INVAR-8, Run: 031, P, 0, 0, 1, 0, 0, 30, 30, 0, 0, 150, 0, 10, 50, 91, 288, 20, 11, 18, 30, 50, 75, 121, 288
INVAR-8, Run: 032, P, 0, 0, 1, 0, 0, 31, 31, 0, 0, 150, 0, 12, 50, 112, 700, 19, 24, 6, 31, 50, 75, 143, 700
INVAR-8, Run: 033, P, 0, 0, 1, 0, 0, 29, 29, 0, 0, 150, 0, 8, 50, 131, 411, 21, 21, 7, 29, 50, 75, 160, 411
INVAR-8, Run: 034, P, 0, 0, 1, 0, 0, 30, 30, 0, 0, 150, 0, 10, 50, 138, 602, 20, 21, 8, 30, 50, 75, 168, 602
INVAR-8, Run: 035, P, 0, 0, 1, 0, 0, 27, 27, 0, 0, 150, 0, 4, 50, 113, 569, 23, 15, 11, 27, 50, 75, 140, 569
INVAR-8, Run: 036, P, 0, 0, 1, 0, 0, 28, 28, 0, 0, 150, 0, 6, 50, 136, 651, 22, 16, 11, 28, 50, 75, 164, 651
INVAR-8, Run: 037, P, 0, 0, 1, 0, 0, 31, 31, 0, 0, 150, 0, 12, 50, 127, 403, 19, 14, 16, 31, 50, 75, 158, 403
INVAR-8, Run: 038, P, 0, 0, 1, 0, 0, 31, 31, 0, 0, 150, 0, 12, 50, 116, 640, 19, 18, 12, 31, 50, 75, 147, 640
INVAR-8, Run: 039, P, 0, 0, 1, 0, 0, 27, 27, 0, 0, 150, 0, 4, 50, 93, 465, 23, 15, 11, 27, 50, 75, 120, 465
INVAR-8, Run: 040, P, 0, 0, 1, 0, 0, 29, 29, 0, 0, 150, 0, 8, 50, 226, 1031, 21, 21, 7, 29, 50, 75, 255, 1031
INVAR-8, Run: 041, P, 0, 0, 1, 0, 0, 32, 32, 0, 0, 150, 0, 14, 50, 159, 497, 18, 17, 14, 32, 50, 75, 191, 497
INVAR-8, Run: 042, P, 0, 0, 1, 0, 0, 30, 30, 0, 0, 150, 0, 10, 50, 147, 374, 20, 12, 17, 30, 50, 75, 177, 374
INVAR-8, Run: 043, P, 0, 0, 1, 0, 0, 31, 31, 0, 0, 150, 0, 12, 50, 195, 740, 19, 14, 16, 31, 50, 75, 226, 740
INVAR-8, Run: 044, P, 0, 0, 1, 0, 0, 32, 32, 0, 0, 150, 0, 14, 50, 157, 525, 18, 20, 11, 32, 50, 75, 189, 525
INVAR-8, Run: 045, P, 0, 0, 1, 0, 0, 32, 32, 0, 0, 150, 0, 14, 50, 89, 520, 18, 16, 15, 32, 50, 75, 121, 520
INVAR-8, Run: 046, P, 0, 0, 1, 0, 0, 30, 30, 0, 0, 150, 0, 10, 50, 103, 317, 20, 13, 16, 30, 50, 75, 133, 317
INVAR-8, Run: 047, P, 0, 0, 1, 0, 0, 31, 31, 0, 0, 150, 0, 12, 50, 149, 508, 19, 17, 13, 31, 50, 75, 180, 508
INVAR-8, Run: 048, P, 0, 0, 1, 0, 0, 32, 32, 0, 0, 150, 0, 14, 50, 131, 487, 18, 20, 11, 32, 50, 75, 163, 487
INVAR-8, Run: 049, P, 0, 0, 1, 0, 0, 31, 31, 0, 0, 150, 0, 12, 50, 111, 436, 19, 20, 10, 31, 50, 75, 142, 436
INVAR-8, Run: 050, P, 0, 0, 1, 0, 0, 30, 30, 0, 0, 150, 0, 10, 50, 129, 492, 20, 16, 13, 30, 50, 75, 159, 492
INVAR-8, Run: 051, P, 0, 0, 1, 0, 0, 30, 30, 0, 0, 150, 0, 10, 50, 146, 421, 20, 18, 11, 30, 50, 75, 176, 421
INVAR-8, Run: 052, P, 0, 0, 1, 0, 0, 30, 30, 0, 0, 150, 0, 10, 50, 146, 448, 20, 14, 15, 30, 50, 75, 176, 448
INVAR-8, Run: 053, P, 0, 0, 1, 0, 0, 28, 28, 0, 0, 150, 0, 6, 50, 73, 246, 22, 13, 14, 28, 50, 75, 101, 246
INVAR-8, Run: 054, P, 0, 0, 1, 0, 0, 32, 32, 0, 0, 150, 0, 14, 50, 166, 446, 18, 14, 17, 32, 50, 75, 198, 446
INVAR-8, Run: 055, P, 0, 0, 1, 0, 0, 31, 31, 0, 0, 150, 0, 12, 50, 100, 606, 19, 17, 13, 31, 50, 75, 131, 606
INVAR-8, Run: 056, P, 0, 0, 1, 0, 0, 30, 30, 0, 0, 150, 0, 10, 50, 181, 485, 20, 14, 15, 30, 50, 75, 211, 485
INVAR-8, Run: 057, P, 0, 0, 1, 0, 0, 30, 30, 0, 0, 150, 0, 10, 50, 71, 348, 20, 16, 13, 30, 50, 75, 101, 348
INVAR-8, Run: 058, P, 0, 0, 1, 0, 0, 29, 29, 0, 0, 150, 0, 8, 50, 71, 488, 21, 19, 9, 29, 50, 75, 100, 488
INVAR-8, Run: 059, P, 0, 0, 1, 0, 0, 28, 28, 0, 0, 150, 0, 6, 50, 166, 856, 22, 17, 10, 28, 50, 75, 194, 856
INVAR-8, Run: 060, P, 0, 0, 1, 0, 0, 29, 29, 0, 0, 150, 0, 8, 50, 118, 798, 21, 19, 9, 29, 50, 75, 147, 798
INVAR-8, Run: 061, P, 0, 0, 1, 0, 0, 29, 29, 0, 0, 150, 0, 8, 50, 151, 515, 21, 16, 12, 29, 50, 75, 180, 515
INVAR-8, Run: 062, P, 0, 0, 1, 0, 0, 29, 29, 0, 0, 150, 0, 8, 50, 115, 339, 21, 10, 18, 29, 50, 75, 144, 339
INVAR-8, Run: 063, P, 0, 0, 1, 0, 0, 30, 30, 0, 0, 150, 0, 10, 50, 159, 483, 20, 17, 12, 30, 50, 75, 189, 483
INVAR-8, Run: 064, P, 0, 0, 1, 0, 0, 31, 31, 0, 0, 150, 0, 12, 50, 148, 424, 19, 17, 13, 31, 50, 75, 179, 424
INVAR-8, Run: 065, P, 0, 0, 1, 0, 0, 29, 29, 0, 0, 150, 0, 8, 50, 160, 573, 21, 13, 15, 29, 50, 75, 189, 573
INVAR-8, Run: 066, P, 0, 0, 1, 0, 0, 29, 29, 0, 0, 150, 0, 8, 50, 120, 390, 21, 18, 10, 29, 50, 75, 149, 390
INVAR-8, Run: 067, P, 0, 0, 1, 0, 0, 30, 30, 0, 0, 150, 0, 10, 50, 140, 668, 20, 18, 11, 30, 50, 75, 170, 668
INVAR-8, Run: 068, P, 0, 0, 1, 0, 0, 31, 31, 0, 0, 150, 0, 12, 50, 129, 487, 19, 19, 11, 31, 50, 75, 160, 487
INVAR-8, Run: 069, P, 0, 0, 1, 0, 0, 31, 31, 0, 0, 150, 0, 12, 50, 129, 483, 19, 15, 15, 31, 50, 75, 160, 483
INVAR-8, Run: 070, P, 0, 0, 1, 0, 0, 30, 30, 0, 0, 150, 0, 10, 50, 98, 477, 20, 19, 10, 30, 50, 75, 128, 477
INVAR-8, Run: 071, P, 0, 0, 1, 0, 0, 30, 30, 0, 0, 150, 0, 10, 50, 95, 290, 20, 19, 10, 30, 50, 75, 125, 290
INVAR-8, Run: 072, P, 0, 0, 1, 0, 0, 31, 31, 0, 0, 150, 0, 12, 50, 129, 477, 19, 20, 10, 31, 50, 75, 160, 477
INVAR-8, Run: 073, P, 0, 0, 1, 0, 0, 31, 31, 0, 0, 150, 0, 12, 50, 134, 589, 19, 18, 12, 31, 50, 75, 165, 589
INVAR-8, Run: 074, P, 0, 0, 1, 0, 0, 33, 33, 0, 0, 150, 0, 16, 50, 163, 443, 17, 26, 6, 33, 50, 75, 196, 443
INVAR-8, Run: 075, P, 0, 0, 1, 0, 0, 30, 30, 0, 0, 150, 0, 10, 50, 130, 363, 20, 19, 10, 30, 50, 75, 160, 363
INVAR-8, Run: 076, P, 0, 0, 1, 0, 0, 32, 32, 0, 0, 150, 0, 14, 50, 134, 545, 18, 18, 13, 32, 50, 75, 166, 545
INVAR-8, Run: 077, P, 0, 0, 1, 0, 0, 29, 29, 0, 0, 150, 0, 8, 50, 120, 617, 21, 14, 14, 29, 50, 75, 149, 617
INVAR-8, Run: 078, P, 0, 0, 1, 0, 0, 29, 29, 0, 0, 150, 0, 8, 50, 62, 405, 21, 21, 7, 29, 50, 75, 91, 405
INVAR-8, Run: 079, P, 0, 0, 1, 0, 0, 28, 28, 0, 0, 150, 0, 6, 50, 101, 365, 22, 17, 10, 28, 50, 75, 129, 365
INVAR-8, Run: 080, P, 0, 0, 1, 0, 0, 29, 29, 0, 0, 150, 0, 8, 50, 138, 767, 21, 13, 15, 29, 50, 75, 167, 767
INVAR-8, Run: 081, P, 0, 0, 1, 0, 0, 31, 31, 0, 0, 150, 0, 12, 50, 195, 579, 19, 12, 18, 31, 50, 75, 226, 579
INVAR-8, Run: 082, P, 0, 0, 1, 0, 0, 29, 29, 0, 0, 150, 0, 8, 50, 135, 562, 21, 15, 13, 29, 50, 75, 164, 562
INVAR-8, Run: 083, P, 0, 0, 1, 0, 0, 28, 28, 0, 0, 150, 0, 6, 50, 105, 339, 22, 15, 12, 28, 50, 75, 133, 339
INVAR-8, Run: 084, P, 0, 0, 1, 0, 0, 30, 30, 0, 0, 150, 0, 10, 50, 150, 576, 20, 17, 12, 30, 50, 75, 180, 576
INVAR-8, Run: 085, P, 0, 0, 1, 0, 0, 30, 30, 0, 0, 150, 0, 10, 50, 124, 545, 20, 15, 14, 30, 50, 75, 154, 545
INVAR-8, Run: 086, P, 0, 0, 1, 0, 0, 29, 29, 0, 0, 150, 0, 8, 50, 114, 460, 21, 13, 15, 29, 50, 75, 143, 460
INVAR-8, Run: 087, P, 0, 0, 1, 0, 0, 30, 30, 0, 0, 150, 0, 10, 50, 100, 507, 20, 14, 15, 30, 50, 75, 130, 507
INVAR-8, Run: 088, P, 0, 0, 1, 0, 0, 28, 28, 0, 0, 150, 0, 6, 50, 108, 582, 22, 14, 13, 28, 50, 75, 136, 582
INVAR-8, Run: 089, P, 0, 0, 1, 0, 0, 28, 28, 0, 0, 150, 0, 6, 50, 92, 465, 22, 15, 12, 28, 50, 75, 120, 465
INVAR-8, Run: 090, P, 0, 0, 1, 0, 0, 31, 31, 0, 0, 150, 0, 12, 50, 77, 444, 19, 23, 7, 31, 50, 75, 108, 444
INVAR-8, Run: 091, P, 0, 0, 1, 0, 0, 28, 28, 0, 0, 150, 0, 6, 50, 155, 470, 22, 12, 15, 28, 50, 75, 183, 470
INVAR-8, Run: 092, P, 0, 0, 1, 0, 0, 30, 30, 0, 0, 150, 0, 10, 50, 101, 431, 20, 16, 13, 30, 50, 75, 131, 431
INVAR-8, Run: 093, P, 0, 0, 1, 0, 0, 28, 28, 0, 0, 150, 0, 6, 50, 115, 375, 22, 11, 16, 28, 50, 75, 143, 375
INVAR-8, Run: 094, P, 0, 0, 1, 0, 0, 30, 30, 0, 0, 150, 0, 10, 50, 122, 471, 20, 15, 14, 30, 50, 75, 152, 471
INVAR-8, Run: 095, P, 0, 0, 1, 0, 0, 29, 29, 0, 0, 150, 0, 8, 50, 172, 580, 21, 20, 8, 29, 50, 75, 201, 580
INVAR-8, Run: 096, P, 0, 0, 1, 0, 0, 32, 32, 0, 0, 150, 0, 14, 50, 184, 438, 18, 14, 17, 32, 50, 75, 216, 438
INVAR-8, Run: 097, P, 0, 0, 1, 0, 0, 34, 34, 0, 0, 150, 0, 18, 50, 158, 639, 16, 15, 18, 34, 50, 75, 192, 639
INVAR-8, Run: 098, P, 0, 0, 1, 0, 0, 29, 29, 0, 0, 150, 0, 8, 50, 122, 820, 21, 17, 11, 29, 50, 75, 151, 820
INVAR-8, Run: 099, P, 0, 0, 1, 0, 0, 31, 31, 0, 0, 150, 0, 12, 50, 135, 632, 19, 17, 13, 31, 50, 75, 166, 632
INVAR-8, Run: 100, P, 0, 0, 1, 0, 0, 30, 30, 0, 0, 150, 0, 10, 50, 185, 610, 20, 18, 11, 30, 50, 75, 215, 610
INVAR-9, Run: 001, P, 0, 0, 1, 0, 0, 55, 55, 0, 0, 300, 0, 10, 100, 315, 1507, 45, 32, 22, 55, 100, 150, 370, 1507
INVAR-9, Run: 002, P, 0, 0, 1, 0, 0, 56, 56, 0, 0, 300, 0, 12, 100, 360, 1435, 44, 24, 31, 56, 100, 150, 416, 1435
INVAR-9, Run: 003, P, 0, 0, 1, 0, 0, 54, 54, 0, 0, 300, 0, 8, 100, 260, 1437, 46, 36, 17, 54, 100, 150, 314, 1437
INVAR-9, Run: 004, P, 0, 0, 1, 0, 0, 60, 60, 0, 0, 300, 0, 20, 100, 433, 1298, 40, 30, 29, 60, 100, 150, 493, 1298
INVAR-9, Run: 005, P, 0, 0, 1, 0, 0, 56, 56, 0, 0, 300, 0, 12, 100, 430, 1711, 44, 30, 25, 56, 100, 150, 486, 1711
INVAR-9, Run: 006, P, 0, 0, 1, 0, 0, 57, 57, 0, 0, 300, 0, 14, 100, 321, 1084, 43, 32, 24, 57, 100, 150, 378, 1084
INVAR-9, Run: 007, P, 0, 0, 1, 0, 0, 57, 57, 0, 0, 300, 0, 14, 100, 377, 2331, 43, 35, 21, 57, 100, 150, 434, 2331
INVAR-9, Run: 008, P, 0, 0, 1, 0, 0, 56, 56, 0, 0, 300, 0, 12, 100, 440, 1629, 44, 35, 20, 56, 100, 150, 496, 1629
INVAR-9, Run: 009, P, 0, 0, 1, 0, 0, 57, 57, 0, 0, 300, 0, 14, 100, 293, 2137, 43, 38, 18, 57, 100, 150, 350, 2137
INVAR-9, Run: 010, P, 0, 0, 1, 0, 0, 56, 56, 0, 0, 300, 0, 12, 100, 329, 1279, 44, 29, 26, 56, 100, 150, 385, 1279
INVAR-9, Run: 011, P, 0, 0, 1, 0, 0, 60, 60, 0, 0, 300, 0, 20, 100, 360, 1933, 40, 37, 22, 60, 100, 150, 420, 1933
INVAR-9, Run: 012, P, 0, 0, 1, 0, 0, 56, 56, 0, 0, 300, 0, 12, 100, 393, 1656, 44, 34, 21, 56, 100, 150, 449, 1656
INVAR-9, Run: 013, P, 0, 0, 1, 0, 0, 59, 59, 0, 0, 300, 0, 18, 100, 308, 1712, 41, 39, 19, 59, 100, 150, 367, 1712
INVAR-9, Run: 014, P, 0, 0, 1, 0, 0, 57, 57, 0, 0, 300, 0, 14, 100, 225, 1063, 43, 35, 21, 57, 100, 150, 282, 1063
INVAR-9, Run: 015, P, 0, 0, 1, 0, 0, 56, 56, 0, 0, 300, 0, 12, 100, 316, 1512, 44, 28, 27, 56, 100, 150, 372, 1512
INVAR-9, Run: 016, P, 0, 0, 1, 0, 0, 56, 56, 0, 0, 300, 0, 12, 100, 321, 1244, 44, 32, 23, 56, 100, 150, 377, 1244
INVAR-9, Run: 017, P, 0, 0, 1, 0, 0, 58, 58, 0, 0, 300, 0, 16, 100, 354, 1415, 42, 39, 18, 58, 100, 150, 412, 1415
INVAR-9, Run: 018, P, 0, 0, 1, 0, 0, 59, 59, 0, 0, 300, 0, 18, 100, 316, 997, 41, 34, 24, 59, 100, 150, 375, 997
INVAR-9, Run: 019, P, 0, 0, 1, 0, 0, 54, 54, 0, 0, 300, 0, 8, 100, 390, 1655, 46, 26, 27, 54, 100, 150, 444, 1655
INVAR-9, Run: 020, P, 0, 0, 1, 0, 0, 55, 55, 0, 0, 300, 0, 10, 100, 345, 1458, 45, 26, 28, 55, 100, 150, 400, 1458
INVAR-9, Run: 021, P, 0, 0, 1, 0, 0, 57, 57, 0, 0, 300, 0, 14, 100, 406, 2162, 43, 34, 22, 57, 100, 150, 463, 2162
INVAR-9, Run: 022, P, 0, 0, 1, 0, 0, 59, 59, 0, 0, 300, 0, 18, 100, 520, 1484, 41, 22, 36, 59, 100, 150, 579, 1484
INVAR-9, Run: 023, P, 0, 0, 1, 0, 0, 58, 58, 0, 0, 300, 0, 16, 100, 414, 1480, 42, 32, 25, 58, 100, 150, 472, 1480
INVAR-9, Run: 024, P, 0, 0, 1, 0, 0, 59, 59, 0, 0, 300, 0, 18, 100, 449, 1083, 41, 33, 25, 59, 100, 150, 508, 1083
INVAR-9, Run: 025, P, 0, 0, 1, 0, 0, 57, 57, 0, 0, 300, 0, 14, 100, 329, 1586, 43, 33, 23, 57, 100, 150, 386, 1586
INVAR-9, Run: 026, P, 0, 0, 1, 0, 0, 54, 54, 0, 0, 300, 0, 8, 100, 327, 1231, 46, 30, 23, 54, 100, 150, 381, 1231
INVAR-9, Run: 027, P, 0, 0, 1, 0, 0, 57, 57, 0, 0, 300, 0, 14, 100, 399, 1681, 43, 31, 25, 57, 100, 150, 456, 1681
INVAR-9, Run: 028, P, 0, 0, 1, 0, 0, 55, 55, 0, 0, 300, 0, 10, 100, 286, 1469, 45, 34, 20, 55, 100, 150, 341, 1469
INVAR-9, Run: 029, P, 0, 0, 1, 0, 0, 57, 57, 0, 0, 300, 0, 14, 100, 325, 1361, 43, 38, 18, 57, 100, 150, 382, 1361
INVAR-9, Run: 030, P, 0, 0, 1, 0, 0, 54, 54, 0, 0, 300, 0, 8, 100, 318, 1423, 46, 26, 27, 54, 100, 150, 372, 1423
INVAR-9, Run: 031, P, 0, 0, 1, 0, 0, 58, 58, 0, 0, 300, 0, 16, 100, 485, 1626, 42, 25, 32, 58, 100, 150, 543, 1626
INVAR-9, Run: 032, P, 0, 0, 1, 0, 0, 63, 63, 0, 0, 300, 0, 26, 100, 532, 2216, 37, 36, 26, 63, 100, 150, 595, 2216
INVAR-9, Run: 033, P, 0, 0, 1, 0, 0, 59, 59, 0, 0, 300, 0, 18, 100, 296, 1899, 41, 30, 28, 59, 100, 150, 355, 1899
INVAR-9, Run: 034, P, 0, 0, 1, 0, 0, 54, 54, 0, 0, 300, 0, 8, 100, 382, 1367, 46, 28, 25, 54, 100, 150, 436, 1367
INVAR-9, Run: 035, P, 0, 0, 1, 0, 0, 58, 58, 0, 0, 300, 0, 16, 100, 413, 1287, 42, 34, 23, 58, 100, 150, 471, 1287
INVAR-9, Run: 036, P, 0, 0, 1, 0, 0, 59, 59, 0, 0, 300, 0, 18, 100, 538, 2059, 41, 37, 21, 59, 100, 150, 597, 2059
INVAR-9, Run: 037, P, 0, 0, 1, 0, 0, 58, 58, 0, 0, 300, 0, 16, 100, 387, 1251, 42, 26, 31, 58, 100, 150, 445, 1251
INVAR-9, Run: 038, P, 0, 0, 1, 0, 0, 56, 56, 0, 0, 300, 0, 12, 100, 273, 1241, 44, 27, 28, 56, 100, 150, 329, 1241
INVAR-9, Run: 039, P, 0, 0, 1, 0, 0, 56, 56, 0, 0, 300, 0, 12, 100, 433, 1800, 44, 28, 27, 56, 100, 150, 489, 1800
INVAR-9, Run: 040, P, 0, 0, 1, 0, 0, 59, 59, 0, 0, 300, 0, 18, 100, 333, 1826, 41, 35, 23, 59, 100, 150, 392, 1826
INVAR-9, Run: 041, P, 0, 0, 1, 0, 0, 56, 56, 0, 0, 300, 0, 12, 100, 432, 1296, 44, 32, 23, 56, 100, 150, 488, 1296
INVAR-9, Run: 042, P, 0, 0, 1, 0, 0, 58, 58, 0, 0, 300, 0, 16, 100, 307, 1280, 42, 34, 23, 58, 100, 150, 365, 1280
INVAR-9, Run: 043, P, 0, 0, 1, 0, 0, 57, 57, 0, 0, 300, 0, 14, 100, 370, 1463, 43, 27, 29, 57, 100, 150, 427, 1463
INVAR-9, Run: 044, P, 0, 0, 1, 0, 0, 58, 58, 0, 0, 300, 0, 16, 100, 314, 1390, 42, 42, 15, 58, 100, 150, 372, 1390
INVAR-9, Run: 045, P, 0, 0, 1, 0, 0, 56, 56, 0, 0, 300, 0, 12, 100, 305, 1212, 44, 33, 22, 56, 100, 150, 361, 1212
INVAR-9, Run: 046, P, 0, 0, 1, 0, 0, 56, 56, 0, 0, 300, 0, 12, 100, 390, 1136, 44, 25, 30, 56, 100, 150, 446, 1136
INVAR-9, Run: 047, P, 0, 0, 1, 0, 0, 56, 56, 0, 0, 300, 0, 12, 100, 435, 1564, 44, 34, 21, 56, 100, 150, 491, 1564
INVAR-9, Run: 048, P, 0, 0, 1, 0, 0, 57, 57, 0, 0, 300, 0, 14, 100, 292, 1587, 43, 31, 25, 57, 100, 150, 349, 1587
INVAR-9, Run: 049, P, 0, 0, 1, 0, 0, 60, 60, 0, 0, 300, 0, 20, 100, 375, 1298, 40, 40, 19, 60, 100, 150, 435, 1298
INVAR-9, Run: 050, P, 0, 0, 1, 0, 0, 60, 60, 0, 0, 300, 0, 20, 100, 383, 1454, 40, 27, 32, 60, 100, 150, 443, 1454
INVAR-9, Run: 051, P, 0, 0, 1, 0, 0, 57, 57, 0, 0, 300, 0, 14, 100, 294, 1230, 43, 33, 23, 57, 100, 150, 351, 1230
INVAR-9, Run: 052, P, 0, 0, 1, 0, 0, 55, 55, 0, 0, 300, 0, 10, 100, 386, 1361, 45, 29, 25, 55, 100, 150, 441, 1361
INVAR-9, Run: 053, P, 0, 0, 1, 0, 0, 59, 59, 0, 0, 300, 0, 18, 100, 431, 1458, 41, 31, 27, 59, 100, 150, 490, 1458
INVAR-9, Run: 054, P, 0, 0, 1, 0, 0, 54, 54, 0, 0, 300, 0, 8, 100, 311, 1293, 46, 31, 22, 54, 100, 150, 365, 1293
INVAR-9, Run: 055, P, 0, 0, 1, 0, 0, 55, 55, 0, 0, 300, 0, 10, 100, 413, 1760, 45, 35, 19, 55, 100, 150, 468, 1760
INVAR-9, Run: 056, P, 0, 0, 1, 0, 0, 62, 62, 0, 0, 300, 0, 24, 100, 527, 1979, 38, 33, 28, 62, 100, 150, 589, 1979
INVAR-9, Run: 057, P, 0, 0, 1, 0, 0, 59, 59, 0, 0, 300, 0, 18, 100, 429, 1799, 41, 25, 33, 59, 100, 150, 488, 1799
INVAR-9, Run: 058, P, 0, 0, 1, 0, 0, 58, 58, 0, 0, 300, 0, 16, 100, 321, 1283, 42, 37, 20, 58, 100, 150, 379, 1283
INVAR-9, Run: 059, P, 0, 0, 1, 0, 0, 61, 61, 0, 0, 300, 0, 22, 100, 336, 1512, 39, 32, 28, 61, 100, 150, 397, 1512
INVAR-9, Run: 060, P, 0, 0, 1, 0, 0, 58, 58, 0, 0, 300, 0, 16, 100, 419, 1616, 42, 30, 27, 58, 100, 150, 477, 1616
INVAR-9, Run: 061, P, 0, 0, 1, 0, 0, 57, 57, 0, 0, 300, 0, 14, 100, 390, 1182, 43, 34, 22, 57, 100, 150, 447, 1182
INVAR-9, Run: 062, P, 0, 0, 1, 0, 0, 58, 58, 0, 0, 300, 0, 16, 100, 503, 1679, 42, 23, 34, 58, 100, 150, 561, 1679
INVAR-9, Run: 063, P, 0, 0, 1, 0, 0, 56, 56, 0, 0, 300, 0, 12, 100, 405, 1289, 44, 30, 25, 56, 100, 150, 461, 1289
INVAR-9, Run: 064, P, 0, 0, 1, 0, 0, 56, 56, 0, 0, 300, 0, 12, 100, 354, 1633, 44, 30, 25, 56, 100, 150, 410, 1633
INVAR-9, Run: 065, P, 0, 0, 1, 0, 0, 53, 53, 0, 0, 300, 0, 6, 100, 408, 1258, 47, 30, 22, 53, 100, 150, 461, 1258
INVAR-9, Run: 066, P, 0, 0, 1, 0, 0, 56, 56, 0, 0, 300, 0, 12, 100, 379, 1440, 44, 36, 19, 56, 100, 150, 435, 1440
INVAR-9, Run: 067, P, 0, 0, 1, 0, 0, 61, 61, 0, 0, 300, 0, 22, 100, 348, 1358, 39, 37, 23, 61, 100, 150, 409, 1358
INVAR-9, Run: 068, P, 0, 0, 1, 0, 0, 60, 60, 0, 0, 300, 0, 20, 100, 451, 1767, 40, 34, 25, 60, 100, 150, 511, 1767
INVAR-9, Run: 069, P, 0, 0, 1, 0, 0, 57, 57, 0, 0, 300, 0, 14, 100, 349, 1189, 43, 27, 29, 57, 100, 150, 406, 1189
INVAR-9, Run: 070, P, 0, 0, 1, 0, 0, 56, 56, 0, 0, 300, 0, 12, 100, 363, 1636, 44, 33, 22, 56, 100, 150, 419, 1636
INVAR-9, Run: 071, P, 0, 0, 1, 0, 0, 57, 57, 0, 0, 300, 0, 14, 100, 348, 1329, 43, 33, 23, 57, 100, 150, 405, 1329
INVAR-9, Run: 072, P, 0, 0, 1, 0, 0, 55, 55, 0, 0, 300, 0, 10, 100, 200, 1443, 45, 34, 20, 55, 100, 150, 255, 1443
INVAR-9, Run: 073, P, 0, 0, 1, 0, 0, 56, 56, 0, 0, 300, 0, 12, 100, 424, 1534, 44, 28, 27, 56, 100, 150, 480, 1534
INVAR-9, Run: 074, P, 0, 0, 1, 0, 0, 56, 56, 0, 0, 300, 0, 12, 100, 214, 1081, 44, 38, 17, 56, 100, 150, 270, 1081
INVAR-9, Run: 075, P, 0, 0, 1, 0, 0, 58, 58, 0, 0, 300, 0, 16, 100, 353, 1541, 42, 34, 23, 58, 100, 150, 411, 1541
INVAR-9, Run: 076, P, 0, 0, 1, 0, 0, 56, 56, 0, 0, 300, 0, 12, 100, 226, 1426, 44, 36, 19, 56, 100, 150, 282, 1426
INVAR-9, Run: 077, P, 0, 0, 1, 0, 0, 60, 60, 0, 0, 300, 0, 20, 100, 505, 1359, 40, 29, 30, 60, 100, 150, 565, 1359
INVAR-9, Run: 078, P, 0, 0, 1, 0, 0, 57, 57, 0, 0, 300, 0, 14, 100, 383, 1822, 43, 27, 29, 57, 100, 150, 440, 1822
INVAR-9, Run: 079, P, 0, 0, 1, 0, 0, 56, 56, 0, 0, 300, 0, 12, 100, 321, 1459, 44, 29, 26, 56, 100, 150, 377, 1459
INVAR-9, Run: 080, P, 0, 0, 1, 0, 0, 61, 61, 0, 0, 300, 0, 22, 100, 365, 1292, 39, 29, 31, 61, 100, 150, 426, 1292
INVAR-9, Run: 081, P, 0, 0, 1, 0, 0, 57, 57, 0, 0, 300, 0, 14, 100, 435, 1712, 43, 28, 28, 57, 100, 150, 492, 1712
INVAR-9, Run: 082, P, 0, 0, 1, 0, 0, 57, 57, 0, 0, 300, 0, 14, 100, 439, 1939, 43, 35, 21, 57, 100, 150, 496, 1939
INVAR-9, Run: 083, P, 0, 0, 1, 0, 0, 56, 56, 0, 0, 300, 0, 12, 100, 339, 1564, 44, 32, 23, 56, 100, 150, 395, 1564
INVAR-9, Run: 084, P, 0, 0, 1, 0, 0, 58, 58, 0, 0, 300, 0, 16, 100, 388, 1619, 42, 33, 24, 58, 100, 150, 446, 1619
INVAR-9, Run: 085, P, 0, 0, 1, 0, 0, 56, 56, 0, 0, 300, 0, 12, 100, 321, 1720, 44, 27, 28, 56, 100, 150, 377, 1720
INVAR-9, Run: 086, P, 0, 0, 1, 0, 0, 56, 56, 0, 0, 300, 0, 12, 100, 274, 1506, 44, 36, 19, 56, 100, 150, 330, 1506
INVAR-9, Run: 087, P, 0, 0, 1, 0, 0, 58, 58, 0, 0, 300, 0, 16, 100, 316, 1357, 42, 29, 28, 58, 100, 150, 374, 1357
INVAR-9, Run: 088, P, 0, 0, 1, 0, 0, 55, 55, 0, 0, 300, 0, 10, 100, 414, 1884, 45, 32, 22, 55, 100, 150, 469, 1884
INVAR-9, Run: 089, P, 0, 0, 1, 0, 0, 56, 56, 0, 0, 300, 0, 12, 100, 418, 1820, 44, 37, 18, 56, 100, 150, 474, 1820
INVAR-9, Run: 090, P, 0, 0, 1, 0, 0, 57, 57, 0, 0, 300, 0, 14, 100, 490, 1569, 43, 28, 28, 57, 100, 150, 547, 1569
INVAR-9, Run: 091, P, 0, 0, 1, 0, 0, 57, 57, 0, 0, 300, 0, 14, 100, 344, 1540, 43, 33, 23, 57, 100, 150, 401, 1540
INVAR-9, Run: 092, P, 0, 0, 1, 0, 0, 56, 56, 0, 0, 300, 0, 12, 100, 347, 1370, 44, 31, 24, 56, 100, 150, 403, 1370
INVAR-9, Run: 093, P, 0, 0, 1, 0, 0, 60, 60, 0, 0, 300, 0, 20, 100, 396, 1972, 40, 31, 28, 60, 100, 150, 456, 1972
INVAR-9, Run: 094, P, 0, 0, 1, 0, 0, 58, 58, 0, 0, 300, 0, 16, 100, 394, 1353, 42, 31, 26, 58, 100, 150, 452, 1353
INVAR-9, Run: 095, P, 0, 0, 1, 0, 0, 58, 58, 0, 0, 300, 0, 16, 100, 360, 1858, 42, 37, 20, 58, 100, 150, 418, 1858
INVAR-9, Run: 096, P, 0, 0, 1, 0, 0, 58, 58, 0, 0, 300, 0, 16, 100, 350, 1519, 42, 28, 29, 58, 100, 150, 408, 1519
INVAR-9, Run: 097, P, 0, 0, 1, 0, 0, 56, 56, 0, 0, 300, 0, 12, 100, 386, 2190, 44, 39, 16, 56, 100, 150, 442, 2190
INVAR-9, Run: 098, P, 0, 0, 1, 0, 0, 56, 56, 0, 0, 300, 0, 12, 100, 297, 1370, 44, 27, 28, 56, 100, 150, 353, 1370
INVAR-9, Run: 099, P, 0, 0, 1, 0, 0, 59, 59, 0, 0, 300, 0, 18, 100, 308, 1189, 41, 31, 27, 59, 100, 150, 367, 1189
INVAR-9, Run: 100, P, 0, 0, 1, 0, 0, 57, 57, 0, 0, 300, 0, 14, 100, 392, 1839, 43, 33, 23, 57, 100, 150, 449, 1839
