Input Number, Run_Number, Result@ 100, Y, A, X1, B, C, PO, D, CO, PE, CE, E, F, NEW_REACTION, Reaction1, Reaction10, Reaction11, Reaction12, Reaction13, Reaction2, Reaction3, Reaction4, Reaction5, Reaction6, Reaction7, Reaction8, Reaction9
INVAR-1, Run: 001, P, 0, 0, 0, 0, 0, 0, 22, 32, 1, 3, 25, 0, 35, 18, 234, 14, 11, 202, 9, 6, 2, 25, 9, 18, 194, 97
INVAR-1, Run: 002, P, 0, 0, 0, 0, 0, 0, 38, 16, 1, 1, 17, 0, 17, 18, 52, 6, 5, 36, 9, 6, 2, 17, 9, 18, 214, 107
INVAR-1, Run: 003, P, 0, 0, 0, 0, 0, 0, 42, 12, 1, 1, 15, 0, 13, 18, 99, 5, 4, 87, 9, 7, 1, 15, 9, 18, 88, 44
INVAR-1, Run: 004, P, 0, 0, 0, 0, 0, 0, 34, 20, 1, 1, 19, 0, 21, 18, 89, 4, 3, 69, 9, 6, 2, 19, 9, 18, 112, 56
INVAR-1, Run: 005, P, 0, 0, 0, 0, 0, 0, 48, 6, 1, 3, 12, 0, 9, 18, 54, 8, 5, 48, 9, 4, 4, 12, 9, 18, 90, 45
INVAR-1, Run: 006, P, 0, 0, 0, 0, 0, 0, 28, 26, 1, 2, 22, 0, 28, 18, 106, 10, 8, 80, 9, 6, 2, 22, 9, 18, 48, 24
INVAR-1, Run: 007, P, 0, 0, 0, 0, 0, 0, 46, 8, 1, 1, 13, 0, 9, 18, 105, 6, 5, 97, 9, 6, 2, 13, 9, 18, 150, 75
INVAR-1, Run: 008, P, 0, 0, 0, 0, 0, 0, 36, 18, 1, 1, 18, 0, 19, 18, 141, 7, 6, 123, 9, 6, 2, 18, 9, 18, 64, 32
INVAR-1, Run: 009, P, 0, 0, 0, 0, 0, 0, 46, 8, 1, 1, 13, 0, 9, 18, 84, 8, 7, 76, 9, 5, 3, 13, 9, 18, 300, 150
INVAR-1, Run: 010, P, 0, 0, 0, 0, 0, 0, 52, 2, 1, 3, 10, 0, 5, 18, 52, 8, 5, 50, 9, 4, 4, 10, 9, 18, 170, 85
INVAR-1, Run: 011, P, 0, 0, 0, 0, 0, 0, 38, 16, 1, 1, 17, 0, 17, 18, 145, 20, 19, 129, 9, 5, 3, 17, 9, 18, 122, 61
INVAR-1, Run: 012, P, 0, 0, 0, 0, 0, 0, 30, 24, 1, 2, 21, 0, 26, 18, 100, 10, 8, 76, 9, 7, 1, 21, 9, 18, 252, 126
INVAR-1, Run: 013, P, 0, 0, 0, 0, 0, 0, 38, 16, 1, 1, 17, 0, 17, 18, 91, 14, 13, 75, 9, 3, 5, 17, 9, 18, 118, 59
INVAR-1, Run: 014, P, 0, 0, 0, 0, 0, 0, 48, 6, 1, 4, 12, 0, 10, 18, 84, 13, 9, 78, 9, 4, 4, 12, 9, 18, 120, 60
INVAR-1, Run: 015, P, 0, 0, 0, 0, 0, 0, 42, 12, 1, 2, 15, 0, 14, 18, 93, 4, 2, 81, 9, 6, 2, 15, 9, 18, 140, 70
INVAR-1, Run: 016, P, 0, 0, 0, 0, 0, 0, 10, 44, 1, 1, 31, 0, 45, 18, 92, 8, 7, 48, 9, 7, 1, 31, 9, 18, 60, 30
INVAR-1, Run: 017, P, 0, 0, 0, 0, 0, 0, 38, 16, 1, 2, 17, 0, 18, 18, 68, 12, 10, 52, 9, 3, 5, 17, 9, 18, 240, 120
INVAR-1, Run: 018, P, 0, 0, 0, 0, 0, 0, 38, 16, 1, 1, 17, 0, 17, 18, 57, 6, 5, 41, 9, 6, 2, 17, 9, 18, 256, 128
INVAR-1, Run: 019, P, 0, 0, 0, 0, 0, 0, 48, 6, 1, 1, 12, 0, 7, 18, 87, 11, 10, 81, 9, 3, 5, 12, 9, 18, 104, 52
INVAR-1, Run: 020, P, 0, 0, 0, 0, 0, 0, 50, 4, 1, 3, 11, 0, 7, 18, 85, 7, 4, 81, 9, 3, 5, 11, 9, 18, 138, 69
INVAR-1, Run: 021, P, 0, 0, 0, 0, 0, 0, 40, 14, 1, 5, 16, 0, 19, 18, 120, 8, 3, 106, 9, 6, 2, 16, 9, 18, 82, 41
INVAR-1, Run: 022, P, 0, 0, 0, 0, 0, 0, 50, 4, 1, 2, 11, 0, 6, 18, 36, 9, 7, 32, 9, 3, 5, 11, 9, 18, 228, 114
INVAR-1, Run: 023, P, 0, 0, 0, 0, 0, 0, 42, 12, 1, 3, 15, 0, 15, 18, 97, 14, 11, 85, 9, 5, 3, 15, 9, 18, 104, 52
INVAR-1, Run: 024, P, 0, 0, 0, 0, 0, 0, 22, 32, 1, 0, 25, 0, 32, 18, 156, 5, 5, 124, 9, 8, 0, 25, 9, 18, 118, 59
INVAR-1, Run: 025, P, 0, 0, 0, 0, 0, 0, 50, 4, 1, 2, 11, 0, 6, 18, 75, 9, 7, 71, 9, 2, 6, 11, 9, 18, 126, 63
INVAR-1, Run: 026, P, 0, 0, 0, 0, 0, 0, 28, 26, 1, 0, 22, 0, 26, 18, 131, 16, 16, 105, 9, 3, 5, 22, 9, 18, 172, 86
INVAR-1, Run: 027, P, 0, 0, 0, 0, 0, 0, 30, 24, 1, 1, 21, 0, 25, 18, 135, 11, 10, 111, 9, 4, 4, 21, 9, 18, 108, 54
INVAR-1, Run: 028, P, 0, 0, 0, 0, 0, 0, 48, 6, 1, 1, 12, 0, 7, 18, 54, 3, 2, 48, 9, 2, 6, 12, 9, 18, 124, 62
INVAR-1, Run: 029, P, 0, 0, 0, 0, 0, 0, 52, 2, 1, 3, 10, 0, 5, 18, 54, 5, 2, 52, 9, 5, 3, 10, 9, 18, 84, 42
INVAR-1, Run: 030, P, 0, 0, 0, 0, 0, 0, 40, 14, 1, 1, 16, 0, 15, 18, 167, 12, 11, 153, 9, 5, 3, 16, 9, 18, 86, 43
INVAR-1, Run: 031, P, 0, 0, 0, 0, 0, 0, 36, 18, 1, 3, 18, 0, 21, 18, 83, 11, 8, 65, 9, 7, 1, 18, 9, 18, 104, 52
INVAR-1, Run: 032, P, 0, 0, 0, 0, 0, 0, 50, 4, 1, 0, 11, 0, 4, 18, 65, 9, 9, 61, 9, 6, 2, 11, 9, 18, 134, 67
INVAR-1, Run: 033, P, 0, 0, 0, 0, 0, 0, 46, 8, 1, 1, 13, 0, 9, 18, 118, 8, 7, 110, 9, 6, 2, 13, 9, 18, 48, 24
INVAR-1, Run: 034, P, 0, 0, 0, 0, 0, 0, 14, 40, 1, 1, 29, 0, 41, 18, 75, 2, 1, 35, 9, 7, 1, 29, 9, 18, 48, 24
INVAR-1, Run: 035, P, 0, 0, 0, 0, 0, 0, 40, 14, 1, 0, 16, 0, 14, 18, 132, 12, 12, 118, 9, 6, 2, 16, 9, 18, 158, 79
INVAR-1, Run: 036, P, 0, 0, 0, 0, 0, 0, 18, 36, 1, 0, 27, 0, 36, 18, 89, 10, 10, 53, 9, 6, 2, 27, 9, 18, 52, 26
INVAR-1, Run: 037, P, 0, 0, 0, 0, 0, 0, 42, 12, 1, 0, 15, 0, 12, 18, 52, 3, 3, 40, 9, 4, 4, 15, 9, 18, 108, 54
INVAR-1, Run: 038, P, 0, 0, 0, 0, 0, 0, 24, 30, 1, 0, 24, 0, 30, 18, 153, 6, 6, 123, 9, 7, 1, 24, 9, 18, 202, 101
INVAR-1, Run: 039, P, 0, 0, 0, 0, 0, 0, 44, 10, 1, 2, 14, 0, 12, 18, 105, 10, 8, 95, 9, 5, 3, 14, 9, 18, 62, 31
INVAR-1, Run: 040, P, 0, 0, 0, 0, 0, 0, 48, 6, 1, 2, 12, 0, 8, 18, 92, 8, 6, 86, 9, 3, 5, 12, 9, 18, 34, 17
INVAR-1, Run: 041, P, 0, 0, 0, 0, 0, 0, 44, 10, 1, 1, 14, 0, 11, 18, 40, 6, 5, 30, 9, 7, 1, 14, 9, 18, 194, 97
INVAR-1, Run: 042, P, 0, 0, 0, 0, 0, 0, 32, 22, 1, 1, 20, 0, 23, 18, 78, 11, 10, 56, 9, 8, 0, 20, 9, 18, 220, 110
INVAR-1, Run: 043, P, 0, 0, 0, 0, 0, 0, 42, 12, 1, 1, 15, 0, 13, 18, 125, 7, 6, 113, 9, 6, 2, 15, 9, 18, 204, 102
INVAR-1, Run: 044, P, 0, 0, 0, 0, 0, 0, 38, 16, 1, 3, 17, 0, 19, 18, 102, 13, 10, 86, 9, 6, 2, 17, 9, 18, 304, 152
INVAR-1, Run: 045, P, 0, 0, 0, 0, 0, 0, 44, 10, 1, 1, 14, 0, 11, 18, 108, 9, 8, 98, 9, 4, 4, 14, 9, 18, 170, 85
INVAR-1, Run: 046, P, 0, 0, 0, 0, 0, 0, 48, 6, 1, 2, 12, 0, 8, 18, 62, 5, 3, 56, 9, 6, 2, 12, 9, 18, 278, 139
INVAR-1, Run: 047, P, 0, 0, 0, 0, 0, 0, 50, 4, 1, 3, 11, 0, 7, 18, 59, 12, 9, 55, 9, 5, 3, 11, 9, 18, 48, 24
INVAR-1, Run: 048, P, 0, 0, 0, 0, 0, 0, 30, 24, 1, 2, 21, 0, 26, 18, 92, 10, 8, 68, 9, 6, 2, 21, 9, 18, 328, 164
INVAR-1, Run: 049, P, 0, 0, 0, 0, 0, 0, 46, 8, 1, 0, 13, 0, 8, 18, 63, 4, 4, 55, 9, 6, 2, 13, 9, 18, 70, 35
INVAR-1, Run: 050, P, 0, 0, 0, 0, 0, 0, 42, 12, 1, 2, 15, 0, 14, 18, 65, 9, 7, 53, 9, 3, 5, 15, 9, 18, 152, 76
INVAR-1, Run: 051, P, 0, 0, 0, 0, 0, 0, 52, 2, 1, 2, 10, 0, 4, 18, 30, 2, 0, 28, 9, 6, 2, 10, 9, 18, 170, 85
INVAR-1, Run: 052, P, 0, 0, 0, 0, 0, 0, 42, 12, 1, 1, 15, 0, 13, 18, 71, 9, 8, 59, 9, 6, 2, 15, 9, 18, 68, 34
INVAR-1, Run: 053, P, 0, 0, 0, 0, 0, 0, 38, 16, 1, 2, 17, 0, 18, 18, 92, 6, 4, 76, 9, 6, 2, 17, 9, 18, 124, 62
INVAR-1, Run: 054, P, 0, 0, 0, 0, 0, 0, 48, 6, 1, 4, 12, 0, 10, 18, 57, 7, 3, 51, 9, 4, 4, 12, 9, 18, 40, 20
INVAR-1, Run: 055, P, 0, 0, 0, 0, 0, 0, 50, 4, 1, 5, 11, 0, 9, 18, 67, 16, 11, 63, 9, 6, 2, 11, 9, 18, 192, 96
INVAR-1, Run: 056, P, 0, 0, 0, 0, 0, 0, 34, 20, 1, 2, 19, 0, 22, 18, 145, 6, 4, 125, 9, 5, 3, 19, 9, 18, 84, 42
INVAR-1, Run: 057, P, 0, 0, 0, 0, 0, 0, 46, 8, 1, 3, 13, 0, 11, 18, 76, 10, 7, 68, 9, 6, 2, 13, 9, 18, 110, 55
INVAR-1, Run: 058, P, 0, 0, 0, 0, 0, 0, 14, 40, 1, 1, 29, 0, 41, 18, 97, 12, 11, 57, 9, 7, 1, 29, 9, 18, 32, 16
INVAR-1, Run: 059, P, 0, 0, 0, 0, 0, 0, 36, 18, 1, 3, 18, 0, 21, 18, 81, 13, 10, 63, 9, 4, 4, 18, 9, 18, 80, 40
INVAR-1, Run: 060, P, 0, 0, 0, 0, 0, 0, 4, 50, 1, 0, 34, 0, 50, 18, 125, 6, 6, 75, 9, 7, 1, 34, 9, 18, 36, 18
INVAR-1, Run: 061, P, 0, 0, 0, 0, 0, 0, 36, 18, 1, 1, 18, 0, 19, 18, 81, 10, 9, 63, 9, 3, 5, 18, 9, 18, 94, 47
INVAR-1, Run: 062, P, 0, 0, 0, 0, 0, 0, 40, 14, 1, 0, 16, 0, 14, 18, 50, 6, 6, 36, 9, 6, 2, 16, 9, 18, 70, 35
INVAR-1, Run: 063, P, 0, 0, 0, 0, 0, 0, 18, 36, 1, 2, 27, 0, 38, 18, 140, 10, 8, 104, 9, 6, 2, 27, 9, 18, 108, 54
INVAR-1, Run: 064, P, 0, 0, 0, 0, 0, 0, 36, 18, 1, 1, 18, 0, 19, 18, 78, 10, 9, 60, 9, 4, 4, 18, 9, 18, 62, 31
INVAR-1, Run: 065, P, 0, 0, 0, 0, 0, 0, 44, 10, 1, 4, 14, 0, 14, 18, 44, 12, 8, 34, 9, 4, 4, 14, 9, 18, 60, 30
INVAR-1, Run: 066, P, 0, 0, 0, 0, 0, 0, 46, 8, 1, 2, 13, 0, 10, 18, 58, 5, 3, 50, 9, 5, 3, 13, 9, 18, 156, 78
INVAR-1, Run: 067, P, 0, 0, 0, 0, 0, 0, 46, 8, 1, 1, 13, 0, 9, 18, 86, 15, 14, 78, 9, 5, 3, 13, 9, 18, 266, 133
INVAR-1, Run: 068, P, 0, 0, 0, 0, 0, 0, 24, 30, 1, 3, 24, 0, 33, 18, 218, 24, 21, 188, 9, 6, 2, 24, 9, 18, 120, 60
INVAR-1, Run: 069, P, 0, 0, 0, 0, 0, 0, 48, 6, 1, 1, 12, 0, 7, 18, 119, 14, 13, 113, 9, 6, 2, 12, 9, 18, 84, 42
INVAR-1, Run: 070, P, 0, 0, 0, 0, 0, 0, 14, 40, 1, 2, 29, 0, 42, 18, 95, 2, 0, 55, 9, 6, 2, 29, 9, 18, 44, 22
INVAR-1, Run: 071, P, 0, 0, 0, 0, 0, 0, 6, 48, 1, 0, 33, 0, 48, 18, 105, 6, 6, 57, 9, 5, 3, 33, 9, 18, 74, 37
INVAR-1, Run: 072, P, 0, 0, 0, 0, 0, 0, 46, 8, 1, 0, 13, 0, 8, 18, 50, 4, 4, 42, 9, 5, 3, 13, 9, 18, 22, 11
INVAR-1, Run: 073, P, 0, 0, 0, 0, 0, 0, 42, 12, 1, 4, 15, 0, 16, 18, 66, 10, 6, 54, 9, 5, 3, 15, 9, 18, 54, 27
INVAR-1, Run: 074, P, 0, 0, 0, 0, 0, 0, 42, 12, 1, 1, 15, 0, 13, 18, 143, 8, 7, 131, 9, 6, 2, 15, 9, 18, 62, 31
INVAR-1, Run: 075, P, 0, 0, 0, 0, 0, 0, 42, 12, 1, 0, 15, 0, 12, 18, 110, 6, 6, 98, 9, 7, 1, 15, 9, 18, 230, 115
INVAR-1, Run: 076, P, 0, 0, 0, 0, 0, 0, 54, 0, 1, 1, 9, 0, 1, 18, 42, 9, 8, 42, 9, 4, 4, 9, 9, 18, 50, 25
INVAR-1, Run: 077, P, 0, 0, 0, 0, 0, 0, 46, 8, 1, 0, 13, 0, 8, 18, 94, 7, 7, 86, 9, 5, 3, 13, 9, 18, 48, 24
INVAR-1, Run: 078, P, 0, 0, 0, 0, 0, 0, 32, 22, 1, 1, 20, 0, 23, 18, 87, 6, 5, 65, 9, 6, 2, 20, 9, 18, 176, 88
INVAR-1, Run: 079, P, 0, 0, 0, 0, 0, 0, 16, 38, 1, 3, 28, 0, 41, 18, 77, 5, 2, 39, 9, 8, 0, 28, 9, 18, 24, 12
INVAR-1, Run: 080, P, 0, 0, 0, 0, 0, 0, 34, 20, 1, 2, 19, 0, 22, 18, 71, 8, 6, 51, 9, 3, 5, 19, 9, 18, 202, 101
INVAR-1, Run: 081, P, 0, 0, 0, 0, 0, 0, 50, 4, 1, 1, 11, 0, 5, 18, 59, 7, 6, 55, 9, 5, 3, 11, 9, 18, 108, 54
INVAR-1, Run: 082, P, 0, 0, 0, 0, 0, 0, 44, 10, 1, 2, 14, 0, 12, 18, 168, 8, 6, 158, 9, 6, 2, 14, 9, 18, 92, 46
INVAR-1, Run: 083, P, 0, 0, 0, 0, 0, 0, 44, 10, 1, 3, 14, 0, 13, 18, 102, 9, 6, 92, 9, 4, 4, 14, 9, 18, 132, 66
INVAR-1, Run: 084, P, 0, 0, 0, 0, 0, 0, 26, 28, 1, 2, 23, 0, 30, 18, 116, 12, 10, 88, 9, 7, 1, 23, 9, 18, 64, 32
INVAR-1, Run: 085, P, 0, 0, 0, 0, 0, 0, 10, 44, 1, 1, 31, 0, 45, 18, 140, 4, 3, 96, 9, 5, 3, 31, 9, 18, 108, 54
INVAR-1, Run: 086, P, 0, 0, 0, 0, 0, 0, 22, 32, 1, 0, 25, 0, 32, 18, 129, 5, 5, 97, 9, 6, 2, 25, 9, 18, 60, 30
INVAR-1, Run: 087, P, 0, 0, 0, 0, 0, 0, 22, 32, 1, 0, 25, 0, 32, 18, 118, 18, 18, 86, 9, 3, 5, 25, 9, 18, 120, 60
INVAR-1, Run: 088, P, 0, 0, 0, 0, 0, 0, 34, 20, 1, 0, 19, 0, 20, 18, 87, 7, 7, 67, 9, 3, 5, 19, 9, 18, 114, 57
INVAR-1, Run: 089, P, 0, 0, 0, 0, 0, 0, 48, 6, 1, 2, 12, 0, 8, 18, 48, 7, 5, 42, 9, 8, 0, 12, 9, 18, 56, 28
INVAR-1, Run: 090, P, 0, 0, 0, 0, 0, 0, 20, 34, 1, 0, 26, 0, 34, 18, 108, 7, 7, 74, 9, 6, 2, 26, 9, 18, 136, 68
INVAR-1, Run: 091, P, 0, 0, 0, 0, 0, 0, 44, 10, 1, 2, 14, 0, 12, 18, 72, 8, 6, 62, 9, 3, 5, 14, 9, 18, 290, 145
INVAR-1, Run: 092, P, 0, 0, 0, 0, 0, 0, 28, 26, 1, 2, 22, 0, 28, 18, 94, 7, 5, 68, 9, 8, 0, 22, 9, 18, 70, 35
INVAR-1, Run: 093, P, 0, 0, 0, 0, 0, 0, 14, 40, 1, 1, 29, 0, 41, 18, 89, 5, 4, 49, 9, 6, 2, 29, 9, 18, 46, 23
INVAR-1, Run: 094, P, 0, 0, 0, 0, 0, 0, 44, 10, 1, 2, 14, 0, 12, 18, 86, 16, 14, 76, 9, 3, 5, 14, 9, 18, 110, 55
INVAR-1, Run: 095, P, 0, 0, 0, 0, 0, 0, 22, 32, 1, 1, 25, 0, 33, 18, 103, 6, 5, 71, 9, 6, 2, 25, 9, 18, 206, 103
INVAR-1, Run: 096, P, 0, 0, 0, 0, 0, 0, 36, 18, 1, 1, 18, 0, 19, 18, 112, 7, 6, 94, 9, 6, 2, 18, 9, 18, 76, 38
INVAR-1, Run: 097, P, 0, 0, 0, 0, 0, 0, 48, 6, 1, 2, 12, 0, 8, 18, 43, 5, 3, 37, 9, 7, 1, 12, 9, 18, 98, 49
INVAR-1, Run: 098, P, 0, 0, 0, 0, 0, 0, 48, 6, 1, 2, 12, 0, 8, 18, 95, 12, 10, 89, 9, 5, 3, 12, 9, 18, 186, 93
INVAR-1, Run: 099, P, 0, 0, 0, 0, 0, 0, 40, 14, 1, 1, 16, 0, 15, 18, 94, 8, 7, 80, 9, 6, 2, 16, 9, 18, 28, 14
INVAR-1, Run: 100, P, 0, 0, 0, 0, 0, 0, 36, 18, 1, 2, 18, 0, 20, 18, 74, 17, 15, 56, 9, 3, 5, 18, 9, 18, 78, 39
INVAR-10, Run: 001, P, 0, 0, 0, 0, 0, 0, 478, 122, 1, 1, 161, 0, 123, 200, 5075, 65, 64, 4953, 100, 63, 36, 161, 100, 200, 7090, 3545
INVAR-10, Run: 002, P, 0, 0, 0, 0, 0, 0, 444, 156, 1, 2, 178, 0, 158, 200, 4654, 49, 47, 4498, 100, 55, 44, 178, 100, 200, 4086, 2043
INVAR-10, Run: 003, P, 0, 0, 0, 0, 0, 0, 354, 246, 1, 0, 223, 0, 246, 200, 4734, 72, 72, 4488, 100, 64, 35, 223, 100, 200, 3496, 1748
INVAR-10, Run: 004, P, 0, 0, 0, 0, 0, 0, 504, 96, 1, 2, 148, 0, 98, 200, 4034, 79, 77, 3938, 100, 60, 39, 148, 100, 200, 3614, 1807
INVAR-10, Run: 005, P, 0, 0, 0, 0, 0, 0, 92, 508, 1, 3, 354, 0, 511, 200, 6397, 92, 89, 5889, 100, 63, 36, 354, 100, 200, 4542, 2271
INVAR-10, Run: 006, P, 0, 0, 0, 0, 0, 0, 248, 352, 1, 3, 276, 0, 355, 200, 5117, 62, 59, 4765, 100, 69, 30, 276, 100, 200, 4252, 2126
INVAR-10, Run: 007, P, 0, 0, 0, 0, 0, 0, 536, 64, 1, 0, 132, 0, 64, 200, 5141, 83, 83, 5077, 100, 69, 30, 132, 100, 200, 5402, 2701
INVAR-10, Run: 008, P, 0, 0, 0, 0, 0, 0, 470, 130, 1, 3, 165, 0, 133, 200, 4556, 76, 73, 4426, 100, 57, 42, 165, 100, 200, 4390, 2195
INVAR-10, Run: 009, P, 0, 0, 0, 0, 0, 0, 386, 214, 1, 1, 207, 0, 215, 200, 4750, 82, 81, 4536, 100, 54, 45, 207, 100, 200, 4648, 2324
INVAR-10, Run: 010, P, 0, 0, 0, 0, 0, 0, 56, 544, 1, 4, 372, 0, 548, 200, 4306, 74, 70, 3762, 100, 66, 33, 372, 100, 200, 3728, 1864
INVAR-10, Run: 011, P, 0, 0, 0, 0, 0, 0, 184, 416, 1, 1, 308, 0, 417, 200, 5802, 75, 74, 5386, 100, 62, 37, 308, 100, 200, 4350, 2175
INVAR-10, Run: 012, P, 0, 0, 0, 0, 0, 0, 396, 204, 1, 3, 202, 0, 207, 200, 4207, 92, 89, 4003, 100, 66, 33, 202, 100, 200, 4700, 2350
INVAR-10, Run: 013, P, 0, 0, 0, 0, 0, 0, 442, 158, 1, 1, 179, 0, 159, 200, 4049, 66, 65, 3891, 100, 69, 30, 179, 100, 200, 5108, 2554
INVAR-10, Run: 014, P, 0, 0, 0, 0, 0, 0, 506, 94, 1, 1, 147, 0, 95, 200, 4047, 56, 55, 3953, 100, 57, 42, 147, 100, 200, 6038, 3019
INVAR-10, Run: 015, P, 0, 0, 0, 0, 0, 0, 424, 176, 1, 0, 188, 0, 176, 200, 4234, 74, 74, 4058, 100, 57, 42, 188, 100, 200, 6498, 3249
INVAR-10, Run: 016, P, 0, 0, 0, 0, 0, 0, 240, 360, 1, 1, 280, 0, 361, 200, 4897, 89, 88, 4537, 100, 58, 41, 280, 100, 200, 4468, 2234
INVAR-10, Run: 017, P, 0, 0, 0, 0, 0, 0, 202, 398, 1, 3, 299, 0, 401, 200, 5452, 63, 60, 5054, 100, 70, 29, 299, 100, 200, 4910, 2455
INVAR-10, Run: 018, P, 0, 0, 0, 0, 0, 0, 532, 68, 1, 0, 134, 0, 68, 200, 4982, 68, 68, 4914, 100, 60, 39, 134, 100, 200, 5234, 2617
INVAR-10, Run: 019, P, 0, 0, 0, 0, 0, 0, 520, 80, 1, 2, 140, 0, 82, 200, 5008, 65, 63, 4928, 100, 68, 31, 140, 100, 200, 5466, 2733
INVAR-10, Run: 020, P, 0, 0, 0, 0, 0, 0, 450, 150, 1, 0, 175, 0, 150, 200, 4532, 56, 56, 4382, 100, 58, 41, 175, 100, 200, 5862, 2931
INVAR-10, Run: 021, P, 0, 0, 0, 0, 0, 0, 246, 354, 1, 2, 277, 0, 356, 200, 4030, 64, 62, 3676, 100, 62, 37, 277, 100, 200, 3718, 1859
INVAR-10, Run: 022, P, 0, 0, 0, 0, 0, 0, 404, 196, 1, 2, 198, 0, 198, 200, 5290, 64, 62, 5094, 100, 66, 33, 198, 100, 200, 3344, 1672
INVAR-10, Run: 023, P, 0, 0, 0, 0, 0, 0, 436, 164, 1, 0, 182, 0, 164, 200, 4431, 64, 64, 4267, 100, 67, 32, 182, 100, 200, 5184, 2592
INVAR-10, Run: 024, P, 0, 0, 0, 0, 0, 0, 440, 160, 1, 1, 180, 0, 161, 200, 3432, 80, 79, 3272, 100, 61, 38, 180, 100, 200, 3734, 1867
INVAR-10, Run: 025, P, 0, 0, 0, 0, 0, 0, 114, 486, 1, 1, 343, 0, 487, 200, 4630, 65, 64, 4144, 100, 65, 34, 343, 100, 200, 3944, 1972
INVAR-10, Run: 026, P, 0, 0, 0, 0, 0, 0, 338, 262, 1, 2, 231, 0, 264, 200, 5480, 89, 87, 5218, 100, 57, 42, 231, 100, 200, 4746, 2373
INVAR-10, Run: 027, P, 0, 0, 0, 0, 0, 0, 346, 254, 1, 3, 227, 0, 257, 200, 4899, 63, 60, 4645, 100, 72, 27, 227, 100, 200, 3716, 1858
INVAR-10, Run: 028, P, 0, 0, 0, 0, 0, 0, 522, 78, 1, 0, 139, 0, 78, 200, 4651, 69, 69, 4573, 100, 64, 35, 139, 100, 200, 4802, 2401
INVAR-10, Run: 029, P, 0, 0, 0, 0, 0, 0, 516, 84, 1, 3, 142, 0, 87, 200, 3727, 82, 79, 3643, 100, 55, 44, 142, 100, 200, 5466, 2733
INVAR-10, Run: 030, P, 0, 0, 0, 0, 0, 0, 358, 242, 1, 3, 221, 0, 245, 200, 4757, 96, 93, 4515, 100, 61, 38, 221, 100, 200, 6590, 3295
INVAR-10, Run: 031, P, 0, 0, 0, 0, 0, 0, 284, 316, 1, 4, 258, 0, 320, 200, 5097, 90, 86, 4781, 100, 73, 26, 258, 100, 200, 4200, 2100
INVAR-10, Run: 032, P, 0, 0, 0, 0, 0, 0, 398, 202, 1, 1, 201, 0, 203, 200, 4742, 72, 71, 4540, 100, 67, 32, 201, 100, 200, 4324, 2162
INVAR-10, Run: 033, P, 0, 0, 0, 0, 0, 0, 424, 176, 1, 2, 188, 0, 178, 200, 5643, 71, 69, 5467, 100, 65, 34, 188, 100, 200, 4508, 2254
INVAR-10, Run: 034, P, 0, 0, 0, 0, 0, 0, 372, 228, 1, 0, 214, 0, 228, 200, 4625, 70, 70, 4397, 100, 55, 44, 214, 100, 200, 4040, 2020
INVAR-10, Run: 035, P, 0, 0, 0, 0, 0, 0, 502, 98, 1, 3, 149, 0, 101, 200, 4627, 83, 80, 4529, 100, 67, 32, 149, 100, 200, 4804, 2402
INVAR-10, Run: 036, P, 0, 0, 0, 0, 0, 0, 464, 136, 1, 2, 168, 0, 138, 200, 5088, 75, 73, 4952, 100, 67, 32, 168, 100, 200, 7690, 3845
INVAR-10, Run: 037, P, 0, 0, 0, 0, 0, 0, 400, 200, 1, 2, 200, 0, 202, 200, 4785, 65, 63, 4585, 100, 62, 37, 200, 100, 200, 5334, 2667
INVAR-10, Run: 038, P, 0, 0, 0, 0, 0, 0, 446, 154, 1, 2, 177, 0, 156, 200, 7041, 84, 82, 6887, 100, 67, 32, 177, 100, 200, 4660, 2330
INVAR-10, Run: 039, P, 0, 0, 0, 0, 0, 0, 282, 318, 1, 4, 259, 0, 322, 200, 5965, 77, 73, 5647, 100, 51, 48, 259, 100, 200, 6868, 3434
INVAR-10, Run: 040, P, 0, 0, 0, 0, 0, 0, 342, 258, 1, 1, 229, 0, 259, 200, 3556, 67, 66, 3298, 100, 67, 32, 229, 100, 200, 4012, 2006
INVAR-10, Run: 041, P, 0, 0, 0, 0, 0, 0, 320, 280, 1, 4, 240, 0, 284, 200, 4817, 79, 75, 4537, 100, 63, 36, 240, 100, 200, 4302, 2151
INVAR-10, Run: 042, P, 0, 0, 0, 0, 0, 0, 392, 208, 1, 3, 204, 0, 211, 200, 4471, 73, 70, 4263, 100, 61, 38, 204, 100, 200, 5158, 2579
INVAR-10, Run: 043, P, 0, 0, 0, 0, 0, 0, 506, 94, 1, 3, 147, 0, 97, 200, 3850, 102, 99, 3756, 100, 57, 42, 147, 100, 200, 4360, 2180
INVAR-10, Run: 044, P, 0, 0, 0, 0, 0, 0, 228, 372, 1, 1, 286, 0, 373, 200, 4309, 82, 81, 3937, 100, 62, 37, 286, 100, 200, 3336, 1668
INVAR-10, Run: 045, P, 0, 0, 0, 0, 0, 0, 244, 356, 1, 2, 278, 0, 358, 200, 4326, 79, 77, 3970, 100, 59, 40, 278, 100, 200, 4108, 2054
INVAR-10, Run: 046, P, 0, 0, 0, 0, 0, 0, 418, 182, 1, 1, 191, 0, 183, 200, 4969, 82, 81, 4787, 100, 54, 45, 191, 100, 200, 6324, 3162
INVAR-10, Run: 047, P, 0, 0, 0, 0, 0, 0, 520, 80, 1, 2, 140, 0, 82, 200, 4737, 74, 72, 4657, 100, 59, 40, 140, 100, 200, 6680, 3340
INVAR-10, Run: 048, P, 0, 0, 0, 0, 0, 0, 32, 568, 1, 2, 384, 0, 570, 200, 4474, 68, 66, 3906, 100, 60, 39, 384, 100, 200, 3798, 1899
INVAR-10, Run: 049, P, 0, 0, 0, 0, 0, 0, 232, 368, 1, 1, 284, 0, 369, 200, 4995, 59, 58, 4627, 100, 67, 32, 284, 100, 200, 4652, 2326
INVAR-10, Run: 050, P, 0, 0, 0, 0, 0, 0, 354, 246, 1, 4, 223, 0, 250, 200, 4192, 78, 74, 3946, 100, 68, 31, 223, 100, 200, 4916, 2458
INVAR-10, Run: 051, P, 0, 0, 0, 0, 0, 0, 514, 86, 1, 2, 143, 0, 88, 200, 4650, 81, 79, 4564, 100, 59, 40, 143, 100, 200, 4716, 2358
INVAR-10, Run: 052, P, 0, 0, 0, 0, 0, 0, 492, 108, 1, 2, 154, 0, 110, 200, 4245, 61, 59, 4137, 100, 65, 34, 154, 100, 200, 4306, 2153
INVAR-10, Run: 053, P, 0, 0, 0, 0, 0, 0, 424, 176, 1, 2, 188, 0, 178, 200, 5495, 103, 101, 5319, 100, 66, 33, 188, 100, 200, 5386, 2693
INVAR-10, Run: 054, P, 0, 0, 0, 0, 0, 0, 438, 162, 1, 1, 181, 0, 163, 200, 5565, 71, 70, 5403, 100, 64, 35, 181, 100, 200, 5690, 2845
INVAR-10, Run: 055, P, 0, 0, 0, 0, 0, 0, 324, 276, 1, 0, 238, 0, 276, 200, 4993, 74, 74, 4717, 100, 60, 39, 238, 100, 200, 3150, 1575
INVAR-10, Run: 056, P, 0, 0, 0, 0, 0, 0, 250, 350, 1, 2, 275, 0, 352, 200, 5065, 59, 57, 4715, 100, 62, 37, 275, 100, 200, 3606, 1803
INVAR-10, Run: 057, P, 0, 0, 0, 0, 0, 0, 184, 416, 1, 3, 308, 0, 419, 200, 5129, 71, 68, 4713, 100, 65, 34, 308, 100, 200, 4190, 2095
INVAR-10, Run: 058, P, 0, 0, 0, 0, 0, 0, 320, 280, 1, 3, 240, 0, 283, 200, 5489, 83, 80, 5209, 100, 68, 31, 240, 100, 200, 6136, 3068
INVAR-10, Run: 059, P, 0, 0, 0, 0, 0, 0, 484, 116, 1, 1, 158, 0, 117, 200, 5135, 65, 64, 5019, 100, 66, 33, 158, 100, 200, 3584, 1792
INVAR-10, Run: 060, P, 0, 0, 0, 0, 0, 0, 224, 376, 1, 1, 288, 0, 377, 200, 4689, 89, 88, 4313, 100, 54, 45, 288, 100, 200, 3642, 1821
INVAR-10, Run: 061, P, 0, 0, 0, 0, 0, 0, 508, 92, 1, 1, 146, 0, 93, 200, 3951, 57, 56, 3859, 100, 64, 35, 146, 100, 200, 5612, 2806
INVAR-10, Run: 062, P, 0, 0, 0, 0, 0, 0, 330, 270, 1, 2, 235, 0, 272, 200, 4042, 70, 68, 3772, 100, 70, 29, 235, 100, 200, 4498, 2249
INVAR-10, Run: 063, P, 0, 0, 0, 0, 0, 0, 438, 162, 1, 0, 181, 0, 162, 200, 4028, 64, 64, 3866, 100, 71, 28, 181, 100, 200, 3504, 1752
INVAR-10, Run: 064, P, 0, 0, 0, 0, 0, 0, 542, 58, 1, 1, 129, 0, 59, 200, 3711, 71, 70, 3653, 100, 62, 37, 129, 100, 200, 5418, 2709
INVAR-10, Run: 065, P, 0, 0, 0, 0, 0, 0, 402, 198, 1, 3, 199, 0, 201, 200, 4786, 81, 78, 4588, 100, 73, 26, 199, 100, 200, 6068, 3034
INVAR-10, Run: 066, P, 0, 0, 0, 0, 0, 0, 438, 162, 1, 2, 181, 0, 164, 200, 4604, 72, 70, 4442, 100, 52, 47, 181, 100, 200, 4946, 2473
INVAR-10, Run: 067, P, 0, 0, 0, 0, 0, 0, 438, 162, 1, 2, 181, 0, 164, 200, 5425, 75, 73, 5263, 100, 55, 44, 181, 100, 200, 3774, 1887
INVAR-10, Run: 068, P, 0, 0, 0, 0, 0, 0, 66, 534, 1, 2, 367, 0, 536, 200, 5136, 55, 53, 4602, 100, 64, 35, 367, 100, 200, 5772, 2886
INVAR-10, Run: 069, P, 0, 0, 0, 0, 0, 0, 276, 324, 1, 2, 262, 0, 326, 200, 5324, 68, 66, 5000, 100, 61, 38, 262, 100, 200, 5434, 2717
INVAR-10, Run: 070, P, 0, 0, 0, 0, 0, 0, 356, 244, 1, 2, 222, 0, 246, 200, 3866, 82, 80, 3622, 100, 51, 48, 222, 100, 200, 5638, 2819
INVAR-10, Run: 071, P, 0, 0, 0, 0, 0, 0, 406, 194, 1, 4, 197, 0, 198, 200, 5181, 75, 71, 4987, 100, 62, 37, 197, 100, 200, 5062, 2531
INVAR-10, Run: 072, P, 0, 0, 0, 0, 0, 0, 376, 224, 1, 4, 212, 0, 228, 200, 4391, 89, 85, 4167, 100, 61, 38, 212, 100, 200, 4516, 2258
INVAR-10, Run: 073, P, 0, 0, 0, 0, 0, 0, 502, 98, 1, 2, 149, 0, 100, 200, 4424, 88, 86, 4326, 100, 58, 41, 149, 100, 200, 3370, 1685
INVAR-10, Run: 074, P, 0, 0, 0, 0, 0, 0, 530, 70, 1, 1, 135, 0, 71, 200, 4257, 61, 60, 4187, 100, 59, 40, 135, 100, 200, 4270, 2135
INVAR-10, Run: 075, P, 0, 0, 0, 0, 0, 0, 498, 102, 1, 1, 151, 0, 103, 200, 4180, 64, 63, 4078, 100, 64, 35, 151, 100, 200, 5240, 2620
INVAR-10, Run: 076, P, 0, 0, 0, 0, 0, 0, 480, 120, 1, 4, 160, 0, 124, 200, 4336, 82, 78, 4216, 100, 54, 45, 160, 100, 200, 5420, 2710
INVAR-10, Run: 077, P, 0, 0, 0, 0, 0, 0, 458, 142, 1, 2, 171, 0, 144, 200, 4053, 92, 90, 3911, 100, 56, 43, 171, 100, 200, 3944, 1972
INVAR-10, Run: 078, P, 0, 0, 0, 0, 0, 0, 542, 58, 1, 1, 129, 0, 59, 200, 4624, 73, 72, 4566, 100, 64, 35, 129, 100, 200, 4174, 2087
INVAR-10, Run: 079, P, 0, 0, 0, 0, 0, 0, 332, 268, 1, 1, 234, 0, 269, 200, 5453, 71, 70, 5185, 100, 54, 45, 234, 100, 200, 5662, 2831
INVAR-10, Run: 080, P, 0, 0, 0, 0, 0, 0, 364, 236, 1, 4, 218, 0, 240, 200, 4013, 70, 66, 3777, 100, 68, 31, 218, 100, 200, 4446, 2223
INVAR-10, Run: 081, P, 0, 0, 0, 0, 0, 0, 548, 52, 1, 0, 126, 0, 52, 200, 5333, 64, 64, 5281, 100, 68, 31, 126, 100, 200, 4784, 2392
INVAR-10, Run: 082, P, 0, 0, 0, 0, 0, 0, 96, 504, 1, 3, 352, 0, 507, 200, 5118, 77, 74, 4614, 100, 67, 32, 352, 100, 200, 3732, 1866
INVAR-10, Run: 083, P, 0, 0, 0, 0, 0, 0, 456, 144, 1, 1, 172, 0, 145, 200, 5080, 58, 57, 4936, 100, 58, 41, 172, 100, 200, 7292, 3646
INVAR-10, Run: 084, P, 0, 0, 0, 0, 0, 0, 548, 52, 1, 1, 126, 0, 53, 200, 4092, 86, 85, 4040, 100, 49, 50, 126, 100, 200, 5720, 2860
INVAR-10, Run: 085, P, 0, 0, 0, 0, 0, 0, 142, 458, 1, 1, 329, 0, 459, 200, 5290, 75, 74, 4832, 100, 60, 39, 329, 100, 200, 4472, 2236
INVAR-10, Run: 086, P, 0, 0, 0, 0, 0, 0, 392, 208, 1, 2, 204, 0, 210, 200, 4574, 78, 76, 4366, 100, 60, 39, 204, 100, 200, 4416, 2208
INVAR-10, Run: 087, P, 0, 0, 0, 0, 0, 0, 524, 76, 1, 2, 138, 0, 78, 200, 5425, 77, 75, 5349, 100, 60, 39, 138, 100, 200, 4534, 2267
INVAR-10, Run: 088, P, 0, 0, 0, 0, 0, 0, 544, 56, 1, 2, 128, 0, 58, 200, 4611, 65, 63, 4555, 100, 62, 37, 128, 100, 200, 4650, 2325
INVAR-10, Run: 089, P, 0, 0, 0, 0, 0, 0, 284, 316, 1, 1, 258, 0, 317, 200, 4089, 59, 58, 3773, 100, 62, 37, 258, 100, 200, 4792, 2396
INVAR-10, Run: 090, P, 0, 0, 0, 0, 0, 0, 510, 90, 1, 1, 145, 0, 91, 200, 4005, 69, 68, 3915, 100, 60, 39, 145, 100, 200, 5676, 2838
INVAR-10, Run: 091, P, 0, 0, 0, 0, 0, 0, 538, 62, 1, 2, 131, 0, 64, 200, 4943, 93, 91, 4881, 100, 61, 38, 131, 100, 200, 4724, 2362
INVAR-10, Run: 092, P, 0, 0, 0, 0, 0, 0, 254, 346, 1, 2, 273, 0, 348, 200, 4395, 102, 100, 4049, 100, 60, 39, 273, 100, 200, 4202, 2101
INVAR-10, Run: 093, P, 0, 0, 0, 0, 0, 0, 400, 200, 1, 4, 200, 0, 204, 200, 4479, 80, 76, 4279, 100, 58, 41, 200, 100, 200, 5036, 2518
INVAR-10, Run: 094, P, 0, 0, 0, 0, 0, 0, 400, 200, 1, 0, 200, 0, 200, 200, 4673, 57, 57, 4473, 100, 65, 34, 200, 100, 200, 5254, 2627
INVAR-10, Run: 095, P, 0, 0, 0, 0, 0, 0, 272, 328, 1, 1, 264, 0, 329, 200, 5171, 68, 67, 4843, 100, 68, 31, 264, 100, 200, 4798, 2399
INVAR-10, Run: 096, P, 0, 0, 0, 0, 0, 0, 458, 142, 1, 2, 171, 0, 144, 200, 4824, 74, 72, 4682, 100, 56, 43, 171, 100, 200, 6070, 3035
INVAR-10, Run: 097, P, 0, 0, 0, 0, 0, 0, 470, 130, 1, 2, 165, 0, 132, 200, 4629, 89, 87, 4499, 100, 60, 39, 165, 100, 200, 7222, 3611
INVAR-10, Run: 098, P, 0, 0, 0, 0, 0, 0, 132, 468, 1, 4, 334, 0, 472, 200, 4250, 86, 82, 3782, 100, 61, 38, 334, 100, 200, 3028, 1514
INVAR-10, Run: 099, P, 0, 0, 0, 0, 0, 0, 446, 154, 1, 2, 177, 0, 156, 200, 3862, 77, 75, 3708, 100, 60, 39, 177, 100, 200, 4518, 2259
INVAR-10, Run: 100, P, 0, 0, 0, 0, 0, 0, 398, 202, 1, 1, 201, 0, 203, 200, 4900, 76, 75, 4698, 100, 47, 52, 201, 100, 200, 7448, 3724
INVAR-2, Run: 001, P, 0, 0, 0, 0, 0, 0, 106, 62, 1, 2, 59, 0, 64, 56, 704, 24, 22, 642, 28, 18, 9, 59, 28, 56, 456, 228
INVAR-2, Run: 002, P, 0, 0, 0, 0, 0, 0, 70, 98, 1, 1, 77, 0, 99, 56, 502, 22, 21, 404, 28, 21, 6, 77, 28, 56, 362, 181
INVAR-2, Run: 003, P, 0, 0, 0, 0, 0, 0, 146, 22, 1, 3, 39, 0, 25, 56, 751, 25, 22, 729, 28, 20, 7, 39, 28, 56, 1016, 508
INVAR-2, Run: 004, P, 0, 0, 0, 0, 0, 0, 128, 40, 1, 1, 48, 0, 41, 56, 542, 18, 17, 502, 28, 19, 8, 48, 28, 56, 474, 237
INVAR-2, Run: 005, P, 0, 0, 0, 0, 0, 0, 62, 106, 1, 1, 81, 0, 107, 56, 543, 26, 25, 437, 28, 21, 6, 81, 28, 56, 470, 235
INVAR-2, Run: 006, P, 0, 0, 0, 0, 0, 0, 126, 42, 1, 0, 49, 0, 42, 56, 626, 24, 24, 584, 28, 16, 11, 49, 28, 56, 474, 237
INVAR-2, Run: 007, P, 0, 0, 0, 0, 0, 0, 128, 40, 1, 0, 48, 0, 40, 56, 449, 26, 26, 409, 28, 15, 12, 48, 28, 56, 1450, 725
INVAR-2, Run: 008, P, 0, 0, 0, 0, 0, 0, 50, 118, 1, 1, 87, 0, 119, 56, 742, 21, 20, 624, 28, 19, 8, 87, 28, 56, 612, 306
INVAR-2, Run: 009, P, 0, 0, 0, 0, 0, 0, 136, 32, 1, 2, 44, 0, 34, 56, 746, 27, 25, 714, 28, 20, 7, 44, 28, 56, 578, 289
INVAR-2, Run: 010, P, 0, 0, 0, 0, 0, 0, 124, 44, 1, 1, 50, 0, 45, 56, 766, 19, 18, 722, 28, 24, 3, 50, 28, 56, 840, 420
INVAR-2, Run: 011, P, 0, 0, 0, 0, 0, 0, 146, 22, 1, 1, 39, 0, 23, 56, 398, 19, 18, 376, 28, 18, 9, 39, 28, 56, 286, 143
INVAR-2, Run: 012, P, 0, 0, 0, 0, 0, 0, 108, 60, 1, 1, 58, 0, 61, 56, 546, 21, 20, 486, 28, 17, 10, 58, 28, 56, 630, 315
INVAR-2, Run: 013, P, 0, 0, 0, 0, 0, 0, 78, 90, 1, 2, 73, 0, 92, 56, 654, 23, 21, 564, 28, 20, 7, 73, 28, 56, 342, 171
INVAR-2, Run: 014, P, 0, 0, 0, 0, 0, 0, 72, 96, 1, 1, 76, 0, 97, 56, 718, 20, 19, 622, 28, 17, 10, 76, 28, 56, 592, 296
INVAR-2, Run: 015, P, 0, 0, 0, 0, 0, 0, 80, 88, 1, 3, 72, 0, 91, 56, 448, 35, 32, 360, 28, 16, 11, 72, 28, 56, 594, 297
INVAR-2, Run: 016, P, 0, 0, 0, 0, 0, 0, 46, 122, 1, 1, 89, 0, 123, 56, 476, 12, 11, 354, 28, 21, 6, 89, 28, 56, 358, 179
INVAR-2, Run: 017, P, 0, 0, 0, 0, 0, 0, 128, 40, 1, 4, 48, 0, 44, 56, 482, 23, 19, 442, 28, 19, 8, 48, 28, 56, 384, 192
INVAR-2, Run: 018, P, 0, 0, 0, 0, 0, 0, 122, 46, 1, 0, 51, 0, 46, 56, 564, 29, 29, 518, 28, 17, 10, 51, 28, 56, 850, 425
INVAR-2, Run: 019, P, 0, 0, 0, 0, 0, 0, 92, 76, 1, 2, 66, 0, 78, 56, 537, 26, 24, 461, 28, 16, 11, 66, 28, 56, 490, 245
INVAR-2, Run: 020, P, 0, 0, 0, 0, 0, 0, 128, 40, 1, 1, 48, 0, 41, 56, 541, 20, 19, 501, 28, 19, 8, 48, 28, 56, 458, 229
INVAR-2, Run: 021, P, 0, 0, 0, 0, 0, 0, 126, 42, 1, 1, 49, 0, 43, 56, 578, 18, 17, 536, 28, 22, 5, 49, 28, 56, 886, 443
INVAR-2, Run: 022, P, 0, 0, 0, 0, 0, 0, 112, 56, 1, 0, 56, 0, 56, 56, 681, 17, 17, 625, 28, 19, 8, 56, 28, 56, 1414, 707
INVAR-2, Run: 023, P, 0, 0, 0, 0, 0, 0, 134, 34, 1, 1, 45, 0, 35, 56, 487, 31, 30, 453, 28, 14, 13, 45, 28, 56, 594, 297
INVAR-2, Run: 024, P, 0, 0, 0, 0, 0, 0, 116, 52, 1, 3, 54, 0, 55, 56, 547, 23, 20, 495, 28, 22, 5, 54, 28, 56, 646, 323
INVAR-2, Run: 025, P, 0, 0, 0, 0, 0, 0, 110, 58, 1, 0, 57, 0, 58, 56, 910, 40, 40, 852, 28, 18, 9, 57, 28, 56, 640, 320
INVAR-2, Run: 026, P, 0, 0, 0, 0, 0, 0, 138, 30, 1, 1, 43, 0, 31, 56, 624, 30, 29, 594, 28, 14, 13, 43, 28, 56, 406, 203
INVAR-2, Run: 027, P, 0, 0, 0, 0, 0, 0, 142, 26, 1, 1, 41, 0, 27, 56, 551, 25, 24, 525, 28, 13, 14, 41, 28, 56, 1024, 512
INVAR-2, Run: 028, P, 0, 0, 0, 0, 0, 0, 66, 102, 1, 2, 79, 0, 104, 56, 601, 24, 22, 499, 28, 16, 11, 79, 28, 56, 516, 258
INVAR-2, Run: 029, P, 0, 0, 0, 0, 0, 0, 102, 66, 1, 3, 61, 0, 69, 56, 780, 29, 26, 714, 28, 20, 7, 61, 28, 56, 1068, 534
INVAR-2, Run: 030, P, 0, 0, 0, 0, 0, 0, 114, 54, 1, 2, 55, 0, 56, 56, 825, 20, 18, 771, 28, 19, 8, 55, 28, 56, 242, 121
INVAR-2, Run: 031, P, 0, 0, 0, 0, 0, 0, 52, 116, 1, 3, 86, 0, 119, 56, 458, 20, 17, 342, 28, 15, 12, 86, 28, 56, 524, 262
INVAR-2, Run: 032, P, 0, 0, 0, 0, 0, 0, 138, 30, 1, 2, 43, 0, 32, 56, 614, 23, 21, 584, 28, 18, 9, 43, 28, 56, 688, 344
INVAR-2, Run: 033, P, 0, 0, 0, 0, 0, 0, 148, 20, 1, 1, 38, 0, 21, 56, 402, 22, 21, 382, 28, 15, 12, 38, 28, 56, 870, 435
INVAR-2, Run: 034, P, 0, 0, 0, 0, 0, 0, 148, 20, 1, 0, 38, 0, 20, 56, 506, 22, 22, 486, 28, 18, 9, 38, 28, 56, 1406, 703
INVAR-2, Run: 035, P, 0, 0, 0, 0, 0, 0, 144, 24, 1, 4, 40, 0, 28, 56, 584, 26, 22, 560, 28, 16, 11, 40, 28, 56, 788, 394
INVAR-2, Run: 036, P, 0, 0, 0, 0, 0, 0, 74, 94, 1, 2, 75, 0, 96, 56, 517, 26, 24, 423, 28, 18, 9, 75, 28, 56, 462, 231
INVAR-2, Run: 037, P, 0, 0, 0, 0, 0, 0, 146, 22, 1, 3, 39, 0, 25, 56, 584, 28, 25, 562, 28, 22, 5, 39, 28, 56, 542, 271
INVAR-2, Run: 038, P, 0, 0, 0, 0, 0, 0, 146, 22, 1, 2, 39, 0, 24, 56, 399, 21, 19, 377, 28, 16, 11, 39, 28, 56, 1010, 505
INVAR-2, Run: 039, P, 0, 0, 0, 0, 0, 0, 120, 48, 1, 2, 52, 0, 50, 56, 528, 26, 24, 480, 28, 18, 9, 52, 28, 56, 676, 338
INVAR-2, Run: 040, P, 0, 0, 0, 0, 0, 0, 6, 162, 1, 1, 109, 0, 163, 56, 820, 24, 23, 658, 28, 16, 11, 109, 28, 56, 578, 289
INVAR-2, Run: 041, P, 0, 0, 0, 0, 0, 0, 14, 154, 1, 0, 105, 0, 154, 56, 599, 30, 30, 445, 28, 14, 13, 105, 28, 56, 508, 254
INVAR-2, Run: 042, P, 0, 0, 0, 0, 0, 0, 62, 106, 1, 0, 81, 0, 106, 56, 502, 26, 26, 396, 28, 15, 12, 81, 28, 56, 1374, 687
INVAR-2, Run: 043, P, 0, 0, 0, 0, 0, 0, 18, 150, 1, 0, 103, 0, 150, 56, 772, 13, 13, 622, 28, 20, 7, 103, 28, 56, 502, 251
INVAR-2, Run: 044, P, 0, 0, 0, 0, 0, 0, 72, 96, 1, 3, 76, 0, 99, 56, 591, 23, 20, 495, 28, 18, 9, 76, 28, 56, 352, 176
INVAR-2, Run: 045, P, 0, 0, 0, 0, 0, 0, 116, 52, 1, 1, 54, 0, 53, 56, 656, 19, 18, 604, 28, 24, 3, 54, 28, 56, 584, 292
INVAR-2, Run: 046, P, 0, 0, 0, 0, 0, 0, 146, 22, 1, 0, 39, 0, 22, 56, 519, 18, 18, 497, 28, 10, 17, 39, 28, 56, 498, 249
INVAR-2, Run: 047, P, 0, 0, 0, 0, 0, 0, 124, 44, 1, 2, 50, 0, 46, 56, 839, 37, 35, 795, 28, 16, 11, 50, 28, 56, 840, 420
INVAR-2, Run: 048, P, 0, 0, 0, 0, 0, 0, 152, 16, 1, 4, 36, 0, 20, 56, 515, 21, 17, 499, 28, 21, 6, 36, 28, 56, 734, 367
INVAR-2, Run: 049, P, 0, 0, 0, 0, 0, 0, 130, 38, 1, 1, 47, 0, 39, 56, 566, 25, 24, 528, 28, 19, 8, 47, 28, 56, 770, 385
INVAR-2, Run: 050, P, 0, 0, 0, 0, 0, 0, 146, 22, 1, 1, 39, 0, 23, 56, 575, 22, 21, 553, 28, 16, 11, 39, 28, 56, 876, 438
INVAR-2, Run: 051, P, 0, 0, 0, 0, 0, 0, 148, 20, 1, 3, 38, 0, 23, 56, 388, 27, 24, 368, 28, 16, 11, 38, 28, 56, 1090, 545
INVAR-2, Run: 052, P, 0, 0, 0, 0, 0, 0, 142, 26, 1, 1, 41, 0, 27, 56, 742, 25, 24, 716, 28, 15, 12, 41, 28, 56, 668, 334
INVAR-2, Run: 053, P, 0, 0, 0, 0, 0, 0, 2, 166, 1, 1, 111, 0, 167, 56, 684, 18, 17, 518, 28, 20, 7, 111, 28, 56, 654, 327
INVAR-2, Run: 054, P, 0, 0, 0, 0, 0, 0, 28, 140, 1, 1, 98, 0, 141, 56, 544, 24, 23, 404, 28, 23, 4, 98, 28, 56, 310, 155
INVAR-2, Run: 055, P, 0, 0, 0, 0, 0, 0, 36, 132, 1, 2, 94, 0, 134, 56, 627, 19, 17, 495, 28, 12, 15, 94, 28, 56, 354, 177
INVAR-2, Run: 056, P, 0, 0, 0, 0, 0, 0, 74, 94, 1, 1, 75, 0, 95, 56, 759, 17, 16, 665, 28, 15, 12, 75, 28, 56, 936, 468
INVAR-2, Run: 057, P, 0, 0, 0, 0, 0, 0, 102, 66, 1, 2, 61, 0, 68, 56, 613, 27, 25, 547, 28, 15, 12, 61, 28, 56, 408, 204
INVAR-2, Run: 058, P, 0, 0, 0, 0, 0, 0, 130, 38, 1, 1, 47, 0, 39, 56, 698, 27, 26, 660, 28, 18, 9, 47, 28, 56, 394, 197
INVAR-2, Run: 059, P, 0, 0, 0, 0, 0, 0, 124, 44, 1, 0, 50, 0, 44, 56, 686, 22, 22, 642, 28, 19, 8, 50, 28, 56, 636, 318
INVAR-2, Run: 060, P, 0, 0, 0, 0, 0, 0, 152, 16, 1, 1, 36, 0, 17, 56, 392, 25, 24, 376, 28, 15, 12, 36, 28, 56, 864, 432
INVAR-2, Run: 061, P, 0, 0, 0, 0, 0, 0, 112, 56, 1, 2, 56, 0, 58, 56, 514, 22, 20, 458, 28, 15, 12, 56, 28, 56, 490, 245
INVAR-2, Run: 062, P, 0, 0, 0, 0, 0, 0, 42, 126, 1, 1, 91, 0, 127, 56, 552, 13, 12, 426, 28, 14, 13, 91, 28, 56, 660, 330
INVAR-2, Run: 063, P, 0, 0, 0, 0, 0, 0, 126, 42, 1, 2, 49, 0, 44, 56, 572, 25, 23, 530, 28, 13, 14, 49, 28, 56, 916, 458
INVAR-2, Run: 064, P, 0, 0, 0, 0, 0, 0, 112, 56, 1, 3, 56, 0, 59, 56, 566, 23, 20, 510, 28, 11, 16, 56, 28, 56, 442, 221
INVAR-2, Run: 065, P, 0, 0, 0, 0, 0, 0, 144, 24, 1, 0, 40, 0, 24, 56, 556, 22, 22, 532, 28, 16, 11, 40, 28, 56, 462, 231
INVAR-2, Run: 066, P, 0, 0, 0, 0, 0, 0, 96, 72, 1, 1, 64, 0, 73, 56, 475, 15, 14, 403, 28, 18, 9, 64, 28, 56, 432, 216
INVAR-2, Run: 067, P, 0, 0, 0, 0, 0, 0, 126, 42, 1, 0, 49, 0, 42, 56, 719, 29, 29, 677, 28, 16, 11, 49, 28, 56, 412, 206
INVAR-2, Run: 068, P, 0, 0, 0, 0, 0, 0, 118, 50, 1, 2, 53, 0, 52, 56, 683, 20, 18, 633, 28, 16, 11, 53, 28, 56, 596, 298
INVAR-2, Run: 069, P, 0, 0, 0, 0, 0, 0, 66, 102, 1, 2, 79, 0, 104, 56, 579, 20, 18, 477, 28, 18, 9, 79, 28, 56, 432, 216
INVAR-2, Run: 070, P, 0, 0, 0, 0, 0, 0, 142, 26, 1, 2, 41, 0, 28, 56, 440, 26, 24, 414, 28, 20, 7, 41, 28, 56, 1484, 742
INVAR-2, Run: 071, P, 0, 0, 0, 0, 0, 0, 124, 44, 1, 2, 50, 0, 46, 56, 623, 20, 18, 579, 28, 18, 9, 50, 28, 56, 562, 281
INVAR-2, Run: 072, P, 0, 0, 0, 0, 0, 0, 136, 32, 1, 3, 44, 0, 35, 56, 579, 23, 20, 547, 28, 19, 8, 44, 28, 56, 522, 261
INVAR-2, Run: 073, P, 0, 0, 0, 0, 0, 0, 118, 50, 1, 1, 53, 0, 51, 56, 733, 30, 29, 683, 28, 21, 6, 53, 28, 56, 468, 234
INVAR-2, Run: 074, P, 0, 0, 0, 0, 0, 0, 144, 24, 1, 1, 40, 0, 25, 56, 550, 22, 21, 526, 28, 22, 5, 40, 28, 56, 542, 271
INVAR-2, Run: 075, P, 0, 0, 0, 0, 0, 0, 136, 32, 1, 1, 44, 0, 33, 56, 767, 24, 23, 735, 28, 16, 11, 44, 28, 56, 880, 440
INVAR-2, Run: 076, P, 0, 0, 0, 0, 0, 0, 140, 28, 1, 0, 42, 0, 28, 56, 458, 17, 17, 430, 28, 21, 6, 42, 28, 56, 618, 309
INVAR-2, Run: 077, P, 0, 0, 0, 0, 0, 0, 112, 56, 1, 2, 56, 0, 58, 56, 553, 19, 17, 497, 28, 14, 13, 56, 28, 56, 894, 447
INVAR-2, Run: 078, P, 0, 0, 0, 0, 0, 0, 104, 64, 1, 1, 60, 0, 65, 56, 419, 26, 25, 355, 28, 20, 7, 60, 28, 56, 222, 111
INVAR-2, Run: 079, P, 0, 0, 0, 0, 0, 0, 144, 24, 1, 2, 40, 0, 26, 56, 680, 18, 16, 656, 28, 15, 12, 40, 28, 56, 674, 337
INVAR-2, Run: 080, P, 0, 0, 0, 0, 0, 0, 20, 148, 1, 2, 102, 0, 150, 56, 618, 22, 20, 470, 28, 21, 6, 102, 28, 56, 532, 266
INVAR-2, Run: 081, P, 0, 0, 0, 0, 0, 0, 122, 46, 1, 2, 51, 0, 48, 56, 531, 19, 17, 485, 28, 17, 10, 51, 28, 56, 614, 307
INVAR-2, Run: 082, P, 0, 0, 0, 0, 0, 0, 114, 54, 1, 0, 55, 0, 54, 56, 524, 18, 18, 470, 28, 21, 6, 55, 28, 56, 480, 240
INVAR-2, Run: 083, P, 0, 0, 0, 0, 0, 0, 70, 98, 1, 3, 77, 0, 101, 56, 700, 28, 25, 602, 28, 17, 10, 77, 28, 56, 712, 356
INVAR-2, Run: 084, P, 0, 0, 0, 0, 0, 0, 132, 36, 1, 0, 46, 0, 36, 56, 782, 22, 22, 746, 28, 18, 9, 46, 28, 56, 440, 220
INVAR-2, Run: 085, P, 0, 0, 0, 0, 0, 0, 30, 138, 1, 0, 97, 0, 138, 56, 699, 25, 25, 561, 28, 16, 11, 97, 28, 56, 606, 303
INVAR-2, Run: 086, P, 0, 0, 0, 0, 0, 0, 150, 18, 1, 2, 37, 0, 20, 56, 498, 26, 24, 480, 28, 16, 11, 37, 28, 56, 534, 267
INVAR-2, Run: 087, P, 0, 0, 0, 0, 0, 0, 150, 18, 1, 2, 37, 0, 20, 56, 567, 24, 22, 549, 28, 16, 11, 37, 28, 56, 428, 214
INVAR-2, Run: 088, P, 0, 0, 0, 0, 0, 0, 84, 84, 1, 1, 70, 0, 85, 56, 721, 25, 24, 637, 28, 22, 5, 70, 28, 56, 692, 346
INVAR-2, Run: 089, P, 0, 0, 0, 0, 0, 0, 130, 38, 1, 4, 47, 0, 42, 56, 454, 26, 22, 416, 28, 15, 12, 47, 28, 56, 822, 411
INVAR-2, Run: 090, P, 0, 0, 0, 0, 0, 0, 136, 32, 1, 1, 44, 0, 33, 56, 598, 26, 25, 566, 28, 16, 11, 44, 28, 56, 992, 496
INVAR-2, Run: 091, P, 0, 0, 0, 0, 0, 0, 64, 104, 1, 1, 80, 0, 105, 56, 640, 20, 19, 536, 28, 17, 10, 80, 28, 56, 816, 408
INVAR-2, Run: 092, P, 0, 0, 0, 0, 0, 0, 110, 58, 1, 1, 57, 0, 59, 56, 706, 23, 22, 648, 28, 13, 14, 57, 28, 56, 896, 448
INVAR-2, Run: 093, P, 0, 0, 0, 0, 0, 0, 132, 36, 1, 0, 46, 0, 36, 56, 645, 20, 20, 609, 28, 19, 8, 46, 28, 56, 468, 234
INVAR-2, Run: 094, P, 0, 0, 0, 0, 0, 0, 110, 58, 1, 1, 57, 0, 59, 56, 747, 26, 25, 689, 28, 18, 9, 57, 28, 56, 684, 342
INVAR-2, Run: 095, P, 0, 0, 0, 0, 0, 0, 84, 84, 1, 2, 70, 0, 86, 56, 488, 16, 14, 404, 28, 17, 10, 70, 28, 56, 454, 227
INVAR-2, Run: 096, P, 0, 0, 0, 0, 0, 0, 152, 16, 1, 2, 36, 0, 18, 56, 554, 23, 21, 538, 28, 15, 12, 36, 28, 56, 506, 253
INVAR-2, Run: 097, P, 0, 0, 0, 0, 0, 0, 142, 26, 1, 2, 41, 0, 28, 56, 573, 23, 21, 547, 28, 17, 10, 41, 28, 56, 578, 289
INVAR-2, Run: 098, P, 0, 0, 0, 0, 0, 0, 132, 36, 1, 0, 46, 0, 36, 56, 675, 17, 17, 639, 28, 15, 12, 46, 28, 56, 610, 305
INVAR-2, Run: 099, P, 0, 0, 0, 0, 0, 0, 146, 22, 1, 1, 39, 0, 23, 56, 395, 23, 22, 373, 28, 13, 14, 39, 28, 56, 434, 217
INVAR-2, Run: 100, P, 0, 0, 0, 0, 0, 0, 124, 44, 1, 2, 50, 0, 46, 56, 443, 29, 27, 399, 28, 17, 10, 50, 28, 56, 734, 367
INVAR-3, Run: 001, P, 0, 0, 0, 0, 0, 0, 204, 288, 1, 2, 226, 0, 290, 164, 3028, 75, 73, 2740, 82, 54, 27, 226, 82, 164, 3034, 1517
INVAR-3, Run: 002, P, 0, 0, 0, 0, 0, 0, 306, 186, 1, 1, 175, 0, 187, 164, 2667, 66, 65, 2481, 82, 45, 36, 175, 82, 164, 4104, 2052
INVAR-3, Run: 003, P, 0, 0, 0, 0, 0, 0, 314, 178, 1, 5, 171, 0, 183, 164, 3506, 60, 55, 3328, 82, 55, 26, 171, 82, 164, 2472, 1236
INVAR-3, Run: 004, P, 0, 0, 0, 0, 0, 0, 374, 118, 1, 1, 141, 0, 119, 164, 3141, 58, 57, 3023, 82, 48, 33, 141, 82, 164, 3152, 1576
INVAR-3, Run: 005, P, 0, 0, 0, 0, 0, 0, 98, 394, 1, 1, 279, 0, 395, 164, 3899, 84, 83, 3505, 82, 59, 22, 279, 82, 164, 4022, 2011
INVAR-3, Run: 006, P, 0, 0, 0, 0, 0, 0, 358, 134, 1, 3, 149, 0, 137, 164, 4203, 59, 56, 4069, 82, 53, 28, 149, 82, 164, 3772, 1886
INVAR-3, Run: 007, P, 0, 0, 0, 0, 0, 0, 436, 56, 1, 2, 110, 0, 58, 164, 2723, 65, 63, 2667, 82, 45, 36, 110, 82, 164, 3530, 1765
INVAR-3, Run: 008, P, 0, 0, 0, 0, 0, 0, 404, 88, 1, 1, 126, 0, 89, 164, 2832, 57, 56, 2744, 82, 46, 35, 126, 82, 164, 3502, 1751
INVAR-3, Run: 009, P, 0, 0, 0, 0, 0, 0, 370, 122, 1, 1, 143, 0, 123, 164, 3769, 62, 61, 3647, 82, 52, 29, 143, 82, 164, 4458, 2229
INVAR-3, Run: 010, P, 0, 0, 0, 0, 0, 0, 308, 184, 1, 2, 174, 0, 186, 164, 2737, 52, 50, 2553, 82, 56, 25, 174, 82, 164, 3516, 1758
INVAR-3, Run: 011, P, 0, 0, 0, 0, 0, 0, 438, 54, 1, 0, 109, 0, 54, 164, 3166, 53, 53, 3112, 82, 46, 35, 109, 82, 164, 3208, 1604
INVAR-3, Run: 012, P, 0, 0, 0, 0, 0, 0, 246, 246, 1, 2, 205, 0, 248, 164, 3532, 42, 40, 3286, 82, 50, 31, 205, 82, 164, 3692, 1846
INVAR-3, Run: 013, P, 0, 0, 0, 0, 0, 0, 288, 204, 1, 3, 184, 0, 207, 164, 3549, 47, 44, 3345, 82, 49, 32, 184, 82, 164, 3860, 1930
INVAR-3, Run: 014, P, 0, 0, 0, 0, 0, 0, 224, 268, 1, 2, 216, 0, 270, 164, 3219, 74, 72, 2951, 82, 51, 30, 216, 82, 164, 2862, 1431
INVAR-3, Run: 015, P, 0, 0, 0, 0, 0, 0, 158, 334, 1, 2, 249, 0, 336, 164, 2945, 54, 52, 2611, 82, 49, 32, 249, 82, 164, 4446, 2223
INVAR-3, Run: 016, P, 0, 0, 0, 0, 0, 0, 442, 50, 1, 1, 107, 0, 51, 164, 3419, 59, 58, 3369, 82, 50, 31, 107, 82, 164, 4526, 2263
INVAR-3, Run: 017, P, 0, 0, 0, 0, 0, 0, 448, 44, 1, 1, 104, 0, 45, 164, 3133, 53, 52, 3089, 82, 51, 30, 104, 82, 164, 3820, 1910
INVAR-3, Run: 018, P, 0, 0, 0, 0, 0, 0, 322, 170, 1, 1, 167, 0, 171, 164, 3300, 47, 46, 3130, 82, 57, 24, 167, 82, 164, 2250, 1125
INVAR-3, Run: 019, P, 0, 0, 0, 0, 0, 0, 134, 358, 1, 1, 261, 0, 359, 164, 4146, 76, 75, 3788, 82, 50, 31, 261, 82, 164, 3228, 1614
INVAR-3, Run: 020, P, 0, 0, 0, 0, 0, 0, 410, 82, 1, 3, 123, 0, 85, 164, 3549, 64, 61, 3467, 82, 60, 21, 123, 82, 164, 2628, 1314
INVAR-3, Run: 021, P, 0, 0, 0, 0, 0, 0, 132, 360, 1, 0, 262, 0, 360, 164, 3447, 62, 62, 3087, 82, 54, 27, 262, 82, 164, 3018, 1509
INVAR-3, Run: 022, P, 0, 0, 0, 0, 0, 0, 446, 46, 1, 3, 105, 0, 49, 164, 2916, 60, 57, 2870, 82, 39, 42, 105, 82, 164, 3746, 1873
INVAR-3, Run: 023, P, 0, 0, 0, 0, 0, 0, 268, 224, 1, 3, 194, 0, 227, 164, 3012, 61, 58, 2788, 82, 48, 33, 194, 82, 164, 3310, 1655
INVAR-3, Run: 024, P, 0, 0, 0, 0, 0, 0, 364, 128, 1, 2, 146, 0, 130, 164, 3245, 63, 61, 3117, 82, 57, 24, 146, 82, 164, 5694, 2847
INVAR-3, Run: 025, P, 0, 0, 0, 0, 0, 0, 74, 418, 1, 1, 291, 0, 419, 164, 3680, 63, 62, 3262, 82, 50, 31, 291, 82, 164, 2634, 1317
INVAR-3, Run: 026, P, 0, 0, 0, 0, 0, 0, 328, 164, 1, 1, 164, 0, 165, 164, 3041, 57, 56, 2877, 82, 51, 30, 164, 82, 164, 2756, 1378
INVAR-3, Run: 027, P, 0, 0, 0, 0, 0, 0, 400, 92, 1, 4, 128, 0, 96, 164, 2992, 63, 59, 2900, 82, 50, 31, 128, 82, 164, 3294, 1647
INVAR-3, Run: 028, P, 0, 0, 0, 0, 0, 0, 4, 488, 1, 1, 326, 0, 489, 164, 3021, 72, 71, 2533, 82, 48, 33, 326, 82, 164, 2502, 1251
INVAR-3, Run: 029, P, 0, 0, 0, 0, 0, 0, 50, 442, 1, 1, 303, 0, 443, 164, 3251, 70, 69, 2809, 82, 49, 32, 303, 82, 164, 2696, 1348
INVAR-3, Run: 030, P, 0, 0, 0, 0, 0, 0, 424, 68, 1, 2, 116, 0, 70, 164, 2953, 66, 64, 2885, 82, 51, 30, 116, 82, 164, 2874, 1437
INVAR-3, Run: 031, P, 0, 0, 0, 0, 0, 0, 154, 338, 1, 2, 251, 0, 340, 164, 3314, 45, 43, 2976, 82, 60, 21, 251, 82, 164, 3464, 1732
INVAR-3, Run: 032, P, 0, 0, 0, 0, 0, 0, 344, 148, 1, 3, 156, 0, 151, 164, 3564, 61, 58, 3416, 82, 44, 37, 156, 82, 164, 2820, 1410
INVAR-3, Run: 033, P, 0, 0, 0, 0, 0, 0, 362, 130, 1, 2, 147, 0, 132, 164, 3767, 62, 60, 3637, 82, 44, 37, 147, 82, 164, 3700, 1850
INVAR-3, Run: 034, P, 0, 0, 0, 0, 0, 0, 396, 96, 1, 4, 130, 0, 100, 164, 3679, 79, 75, 3583, 82, 52, 29, 130, 82, 164, 6578, 3289
INVAR-3, Run: 035, P, 0, 0, 0, 0, 0, 0, 354, 138, 1, 4, 151, 0, 142, 164, 4071, 63, 59, 3933, 82, 54, 27, 151, 82, 164, 6072, 3036
INVAR-3, Run: 036, P, 0, 0, 0, 0, 0, 0, 220, 272, 1, 1, 218, 0, 273, 164, 3948, 52, 51, 3676, 82, 51, 30, 218, 82, 164, 2890, 1445
INVAR-3, Run: 037, P, 0, 0, 0, 0, 0, 0, 446, 46, 1, 2, 105, 0, 48, 164, 3124, 76, 74, 3078, 82, 43, 38, 105, 82, 164, 2116, 1058
INVAR-3, Run: 038, P, 0, 0, 0, 0, 0, 0, 434, 58, 1, 1, 111, 0, 59, 164, 3392, 56, 55, 3334, 82, 56, 25, 111, 82, 164, 3416, 1708
INVAR-3, Run: 039, P, 0, 0, 0, 0, 0, 0, 432, 60, 1, 1, 112, 0, 61, 164, 3419, 61, 60, 3359, 82, 49, 32, 112, 82, 164, 5422, 2711
INVAR-3, Run: 040, P, 0, 0, 0, 0, 0, 0, 268, 224, 1, 2, 194, 0, 226, 164, 3093, 59, 57, 2869, 82, 49, 32, 194, 82, 164, 3908, 1954
INVAR-3, Run: 041, P, 0, 0, 0, 0, 0, 0, 414, 78, 1, 3, 121, 0, 81, 164, 3276, 69, 66, 3198, 82, 52, 29, 121, 82, 164, 3082, 1541
INVAR-3, Run: 042, P, 0, 0, 0, 0, 0, 0, 202, 290, 1, 1, 227, 0, 291, 164, 3361, 56, 55, 3071, 82, 47, 34, 227, 82, 164, 3820, 1910
INVAR-3, Run: 043, P, 0, 0, 0, 0, 0, 0, 444, 48, 1, 0, 106, 0, 48, 164, 3979, 68, 68, 3931, 82, 45, 36, 106, 82, 164, 3814, 1907
INVAR-3, Run: 044, P, 0, 0, 0, 0, 0, 0, 326, 166, 1, 2, 165, 0, 168, 164, 2967, 54, 52, 2801, 82, 49, 32, 165, 82, 164, 3126, 1563
INVAR-3, Run: 045, P, 0, 0, 0, 0, 0, 0, 222, 270, 1, 2, 217, 0, 272, 164, 3434, 55, 53, 3164, 82, 51, 30, 217, 82, 164, 4434, 2217
INVAR-3, Run: 046, P, 0, 0, 0, 0, 0, 0, 92, 400, 1, 2, 282, 0, 402, 164, 3486, 53, 51, 3086, 82, 51, 30, 282, 82, 164, 2726, 1363
INVAR-3, Run: 047, P, 0, 0, 0, 0, 0, 0, 248, 244, 1, 2, 204, 0, 246, 164, 3660, 61, 59, 3416, 82, 57, 24, 204, 82, 164, 3074, 1537
INVAR-3, Run: 048, P, 0, 0, 0, 0, 0, 0, 304, 188, 1, 2, 176, 0, 190, 164, 4376, 73, 71, 4188, 82, 44, 37, 176, 82, 164, 2758, 1379
INVAR-3, Run: 049, P, 0, 0, 0, 0, 0, 0, 184, 308, 1, 0, 236, 0, 308, 164, 3054, 59, 59, 2746, 82, 47, 34, 236, 82, 164, 3852, 1926
INVAR-3, Run: 050, P, 0, 0, 0, 0, 0, 0, 436, 56, 1, 2, 110, 0, 58, 164, 3681, 62, 60, 3625, 82, 49, 32, 110, 82, 164, 2706, 1353
INVAR-3, Run: 051, P, 0, 0, 0, 0, 0, 0, 164, 328, 1, 4, 246, 0, 332, 164, 3612, 56, 52, 3284, 82, 52, 29, 246, 82, 164, 4006, 2003
INVAR-3, Run: 052, P, 0, 0, 0, 0, 0, 0, 422, 70, 1, 0, 117, 0, 70, 164, 4805, 63, 63, 4735, 82, 47, 34, 117, 82, 164, 4586, 2293
INVAR-3, Run: 053, P, 0, 0, 0, 0, 0, 0, 332, 160, 1, 2, 162, 0, 162, 164, 3468, 64, 62, 3308, 82, 40, 41, 162, 82, 164, 4498, 2249
INVAR-3, Run: 054, P, 0, 0, 0, 0, 0, 0, 410, 82, 1, 2, 123, 0, 84, 164, 3396, 62, 60, 3314, 82, 49, 32, 123, 82, 164, 2690, 1345
INVAR-3, Run: 055, P, 0, 0, 0, 0, 0, 0, 456, 36, 1, 3, 100, 0, 39, 164, 3228, 70, 67, 3192, 82, 50, 31, 100, 82, 164, 2850, 1425
INVAR-3, Run: 056, P, 0, 0, 0, 0, 0, 0, 370, 122, 1, 4, 143, 0, 126, 164, 3029, 66, 62, 2907, 82, 55, 26, 143, 82, 164, 2980, 1490
INVAR-3, Run: 057, P, 0, 0, 0, 0, 0, 0, 450, 42, 1, 0, 103, 0, 42, 164, 2496, 62, 62, 2454, 82, 46, 35, 103, 82, 164, 3320, 1660
INVAR-3, Run: 058, P, 0, 0, 0, 0, 0, 0, 232, 260, 1, 1, 212, 0, 261, 164, 3292, 75, 74, 3032, 82, 48, 33, 212, 82, 164, 3282, 1641
INVAR-3, Run: 059, P, 0, 0, 0, 0, 0, 0, 178, 314, 1, 1, 239, 0, 315, 164, 3601, 78, 77, 3287, 82, 45, 36, 239, 82, 164, 2230, 1115
INVAR-3, Run: 060, P, 0, 0, 0, 0, 0, 0, 406, 86, 1, 0, 125, 0, 86, 164, 3572, 71, 71, 3486, 82, 58, 23, 125, 82, 164, 2756, 1378
INVAR-3, Run: 061, P, 0, 0, 0, 0, 0, 0, 316, 176, 1, 1, 170, 0, 177, 164, 3772, 61, 60, 3596, 82, 52, 29, 170, 82, 164, 3656, 1828
INVAR-3, Run: 062, P, 0, 0, 0, 0, 0, 0, 282, 210, 1, 3, 187, 0, 213, 164, 3350, 63, 60, 3140, 82, 57, 24, 187, 82, 164, 2788, 1394
INVAR-3, Run: 063, P, 0, 0, 0, 0, 0, 0, 428, 64, 1, 2, 114, 0, 66, 164, 3485, 68, 66, 3421, 82, 34, 47, 114, 82, 164, 3378, 1689
INVAR-3, Run: 064, P, 0, 0, 0, 0, 0, 0, 146, 346, 1, 4, 255, 0, 350, 164, 3866, 76, 72, 3520, 82, 49, 32, 255, 82, 164, 2456, 1228
INVAR-3, Run: 065, P, 0, 0, 0, 0, 0, 0, 68, 424, 1, 1, 294, 0, 425, 164, 4133, 59, 58, 3709, 82, 62, 19, 294, 82, 164, 3658, 1829
INVAR-3, Run: 066, P, 0, 0, 0, 0, 0, 0, 438, 54, 1, 3, 109, 0, 57, 164, 3749, 59, 56, 3695, 82, 46, 35, 109, 82, 164, 3330, 1665
INVAR-3, Run: 067, P, 0, 0, 0, 0, 0, 0, 198, 294, 1, 1, 229, 0, 295, 164, 3799, 52, 51, 3505, 82, 53, 28, 229, 82, 164, 3100, 1550
INVAR-3, Run: 068, P, 0, 0, 0, 0, 0, 0, 390, 102, 1, 2, 133, 0, 104, 164, 3080, 55, 53, 2978, 82, 51, 30, 133, 82, 164, 3412, 1706
INVAR-3, Run: 069, P, 0, 0, 0, 0, 0, 0, 308, 184, 1, 4, 174, 0, 188, 164, 3771, 74, 70, 3587, 82, 54, 27, 174, 82, 164, 3422, 1711
INVAR-3, Run: 070, P, 0, 0, 0, 0, 0, 0, 430, 62, 1, 0, 113, 0, 62, 164, 3402, 69, 69, 3340, 82, 56, 25, 113, 82, 164, 2926, 1463
INVAR-3, Run: 071, P, 0, 0, 0, 0, 0, 0, 432, 60, 1, 5, 112, 0, 65, 164, 2646, 77, 72, 2586, 82, 49, 32, 112, 82, 164, 4020, 2010
INVAR-3, Run: 072, P, 0, 0, 0, 0, 0, 0, 336, 156, 1, 3, 160, 0, 159, 164, 3642, 55, 52, 3486, 82, 54, 27, 160, 82, 164, 2960, 1480
INVAR-3, Run: 073, P, 0, 0, 0, 0, 0, 0, 240, 252, 1, 2, 208, 0, 254, 164, 3323, 60, 58, 3071, 82, 51, 30, 208, 82, 164, 3680, 1840
INVAR-3, Run: 074, P, 0, 0, 0, 0, 0, 0, 290, 202, 1, 3, 183, 0, 205, 164, 3711, 49, 46, 3509, 82, 50, 31, 183, 82, 164, 3696, 1848
INVAR-3, Run: 075, P, 0, 0, 0, 0, 0, 0, 380, 112, 1, 4, 138, 0, 116, 164, 3493, 69, 65, 3381, 82, 43, 38, 138, 82, 164, 3680, 1840
INVAR-3, Run: 076, P, 0, 0, 0, 0, 0, 0, 12, 480, 1, 2, 322, 0, 482, 164, 3475, 75, 73, 2995, 82, 53, 28, 322, 82, 164, 3096, 1548
INVAR-3, Run: 077, P, 0, 0, 0, 0, 0, 0, 404, 88, 1, 1, 126, 0, 89, 164, 3935, 53, 52, 3847, 82, 55, 26, 126, 82, 164, 3894, 1947
INVAR-3, Run: 078, P, 0, 0, 0, 0, 0, 0, 384, 108, 1, 2, 136, 0, 110, 164, 3311, 71, 69, 3203, 82, 52, 29, 136, 82, 164, 3586, 1793
INVAR-3, Run: 079, P, 0, 0, 0, 0, 0, 0, 82, 410, 1, 1, 287, 0, 411, 164, 3291, 49, 48, 2881, 82, 52, 29, 287, 82, 164, 2386, 1193
INVAR-3, Run: 080, P, 0, 0, 0, 0, 0, 0, 416, 76, 1, 1, 120, 0, 77, 164, 3199, 70, 69, 3123, 82, 50, 31, 120, 82, 164, 3552, 1776
INVAR-3, Run: 081, P, 0, 0, 0, 0, 0, 0, 440, 52, 1, 5, 108, 0, 57, 164, 3329, 80, 75, 3277, 82, 43, 38, 108, 82, 164, 6786, 3393
INVAR-3, Run: 082, P, 0, 0, 0, 0, 0, 0, 438, 54, 1, 0, 109, 0, 54, 164, 3447, 58, 58, 3393, 82, 52, 29, 109, 82, 164, 3926, 1963
INVAR-3, Run: 083, P, 0, 0, 0, 0, 0, 0, 180, 312, 1, 5, 238, 0, 317, 164, 4339, 71, 66, 4027, 82, 48, 33, 238, 82, 164, 3588, 1794
INVAR-3, Run: 084, P, 0, 0, 0, 0, 0, 0, 182, 310, 1, 2, 237, 0, 312, 164, 3813, 77, 75, 3503, 82, 53, 28, 237, 82, 164, 3964, 1982
INVAR-3, Run: 085, P, 0, 0, 0, 0, 0, 0, 108, 384, 1, 2, 274, 0, 386, 164, 3543, 69, 67, 3159, 82, 51, 30, 274, 82, 164, 4046, 2023
INVAR-3, Run: 086, P, 0, 0, 0, 0, 0, 0, 286, 206, 1, 2, 185, 0, 208, 164, 4200, 76, 74, 3994, 82, 43, 38, 185, 82, 164, 2968, 1484
INVAR-3, Run: 087, P, 0, 0, 0, 0, 0, 0, 416, 76, 1, 2, 120, 0, 78, 164, 4054, 72, 70, 3978, 82, 53, 28, 120, 82, 164, 2888, 1444
INVAR-3, Run: 088, P, 0, 0, 0, 0, 0, 0, 428, 64, 1, 2, 114, 0, 66, 164, 3826, 62, 60, 3762, 82, 41, 40, 114, 82, 164, 3642, 1821
INVAR-3, Run: 089, P, 0, 0, 0, 0, 0, 0, 388, 104, 1, 2, 134, 0, 106, 164, 3277, 55, 53, 3173, 82, 57, 24, 134, 82, 164, 3426, 1713
INVAR-3, Run: 090, P, 0, 0, 0, 0, 0, 0, 224, 268, 1, 2, 216, 0, 270, 164, 2897, 69, 67, 2629, 82, 54, 27, 216, 82, 164, 2496, 1248
INVAR-3, Run: 091, P, 0, 0, 0, 0, 0, 0, 400, 92, 1, 5, 128, 0, 97, 164, 2513, 73, 68, 2421, 82, 48, 33, 128, 82, 164, 4504, 2252
INVAR-3, Run: 092, P, 0, 0, 0, 0, 0, 0, 378, 114, 1, 2, 139, 0, 116, 164, 3587, 51, 49, 3473, 82, 51, 30, 139, 82, 164, 4610, 2305
INVAR-3, Run: 093, P, 0, 0, 0, 0, 0, 0, 290, 202, 1, 4, 183, 0, 206, 164, 3393, 45, 41, 3191, 82, 47, 34, 183, 82, 164, 3252, 1626
INVAR-3, Run: 094, P, 0, 0, 0, 0, 0, 0, 384, 108, 1, 0, 136, 0, 108, 164, 3343, 61, 61, 3235, 82, 48, 33, 136, 82, 164, 4190, 2095
INVAR-3, Run: 095, P, 0, 0, 0, 0, 0, 0, 378, 114, 1, 1, 139, 0, 115, 164, 3516, 54, 53, 3402, 82, 45, 36, 139, 82, 164, 2676, 1338
INVAR-3, Run: 096, P, 0, 0, 0, 0, 0, 0, 300, 192, 1, 3, 178, 0, 195, 164, 3510, 50, 47, 3318, 82, 43, 38, 178, 82, 164, 2994, 1497
INVAR-3, Run: 097, P, 0, 0, 0, 0, 0, 0, 140, 352, 1, 2, 258, 0, 354, 164, 3465, 62, 60, 3113, 82, 52, 29, 258, 82, 164, 2482, 1241
INVAR-3, Run: 098, P, 0, 0, 0, 0, 0, 0, 54, 438, 1, 0, 301, 0, 438, 164, 2714, 71, 71, 2276, 82, 54, 27, 301, 82, 164, 2604, 1302
INVAR-3, Run: 099, P, 0, 0, 0, 0, 0, 0, 428, 64, 1, 1, 114, 0, 65, 164, 3997, 79, 78, 3933, 82, 49, 32, 114, 82, 164, 6574, 3287
INVAR-3, Run: 100, P, 0, 0, 0, 0, 0, 0, 216, 276, 1, 1, 220, 0, 277, 164, 3510, 60, 59, 3234, 82, 55, 26, 220, 82, 164, 2954, 1477
INVAR-4, Run: 001, P, 0, 1, 0, 0, 0, 1, 0, 118, 0, 0, 78, 1, 118, 39, 408, 18, 18, 290, 19, 13, 6, 78, 19, 39, 345, 172
INVAR-4, Run: 002, P, 0, 1, 0, 0, 0, 1, 0, 118, 0, 0, 78, 1, 118, 39, 479, 27, 27, 361, 19, 14, 5, 78, 19, 39, 491, 245
INVAR-4, Run: 003, P, 0, 1, 0, 0, 0, 1, 0, 118, 0, 0, 78, 1, 118, 39, 337, 23, 23, 219, 19, 13, 6, 78, 19, 39, 277, 138
INVAR-4, Run: 004, P, 0, 1, 0, 0, 0, 1, 0, 118, 0, 0, 78, 1, 118, 39, 407, 9, 9, 289, 19, 14, 5, 78, 19, 39, 199, 99
INVAR-4, Run: 005, P, 0, 1, 0, 0, 0, 1, 0, 118, 0, 0, 78, 1, 118, 39, 413, 17, 17, 295, 19, 13, 6, 78, 19, 39, 331, 165
INVAR-4, Run: 006, P, 0, 1, 0, 0, 0, 1, 0, 118, 0, 0, 78, 1, 118, 39, 369, 25, 25, 251, 19, 8, 11, 78, 19, 39, 301, 150
INVAR-4, Run: 007, P, 0, 1, 0, 0, 0, 1, 0, 118, 0, 0, 78, 1, 118, 39, 499, 18, 18, 381, 19, 11, 8, 78, 19, 39, 379, 189
INVAR-4, Run: 008, P, 0, 1, 0, 0, 0, 1, 0, 118, 0, 0, 78, 1, 118, 39, 371, 17, 17, 253, 19, 12, 7, 78, 19, 39, 183, 91
INVAR-4, Run: 009, P, 0, 1, 0, 0, 0, 1, 0, 118, 0, 0, 78, 1, 118, 39, 412, 17, 17, 294, 19, 14, 5, 78, 19, 39, 377, 188
INVAR-4, Run: 010, P, 0, 1, 0, 0, 0, 1, 0, 118, 0, 0, 78, 1, 118, 39, 298, 17, 17, 180, 19, 12, 7, 78, 19, 39, 305, 152
INVAR-4, Run: 011, P, 0, 1, 0, 0, 0, 1, 0, 118, 0, 0, 78, 1, 118, 39, 491, 15, 15, 373, 19, 11, 8, 78, 19, 39, 171, 85
INVAR-4, Run: 012, P, 0, 1, 0, 0, 0, 1, 0, 118, 0, 0, 78, 1, 118, 39, 669, 16, 16, 551, 19, 8, 11, 78, 19, 39, 383, 191
INVAR-4, Run: 013, P, 0, 1, 0, 0, 0, 1, 0, 118, 0, 0, 78, 1, 118, 39, 488, 19, 19, 370, 19, 15, 4, 78, 19, 39, 329, 164
INVAR-4, Run: 014, P, 0, 1, 0, 0, 0, 1, 0, 118, 0, 0, 78, 1, 118, 39, 401, 11, 11, 283, 19, 13, 6, 78, 19, 39, 131, 65
INVAR-4, Run: 015, P, 0, 1, 0, 0, 0, 1, 0, 118, 0, 0, 78, 1, 118, 39, 409, 14, 14, 291, 19, 12, 7, 78, 19, 39, 273, 136
INVAR-4, Run: 016, P, 0, 1, 0, 0, 0, 1, 0, 118, 0, 0, 78, 1, 118, 39, 400, 22, 22, 282, 19, 14, 5, 78, 19, 39, 373, 186
INVAR-4, Run: 017, P, 0, 1, 0, 0, 0, 1, 0, 118, 0, 0, 78, 1, 118, 39, 530, 18, 18, 412, 19, 15, 4, 78, 19, 39, 561, 280
INVAR-4, Run: 018, P, 0, 1, 0, 0, 0, 1, 0, 118, 0, 0, 78, 1, 118, 39, 336, 20, 20, 218, 19, 17, 2, 78, 19, 39, 455, 227
INVAR-4, Run: 019, P, 0, 1, 0, 0, 0, 1, 0, 118, 0, 0, 78, 1, 118, 39, 363, 15, 15, 245, 19, 15, 4, 78, 19, 39, 281, 140
INVAR-4, Run: 020, P, 0, 1, 0, 0, 0, 1, 0, 118, 0, 0, 78, 1, 118, 39, 604, 14, 14, 486, 19, 13, 6, 78, 19, 39, 553, 276
INVAR-4, Run: 021, P, 0, 1, 0, 0, 0, 1, 0, 118, 0, 0, 78, 1, 118, 39, 513, 13, 13, 395, 19, 14, 5, 78, 19, 39, 475, 237
INVAR-4, Run: 022, P, 0, 1, 0, 0, 0, 1, 0, 118, 0, 0, 78, 1, 118, 39, 394, 13, 13, 276, 19, 12, 7, 78, 19, 39, 329, 164
INVAR-4, Run: 023, P, 0, 1, 0, 0, 0, 1, 0, 118, 0, 0, 78, 1, 118, 39, 398, 16, 16, 280, 19, 11, 8, 78, 19, 39, 277, 138
INVAR-4, Run: 024, P, 0, 1, 0, 0, 0, 1, 0, 118, 0, 0, 78, 1, 118, 39, 335, 22, 22, 217, 19, 11, 8, 78, 19, 39, 195, 97
INVAR-4, Run: 025, P, 0, 1, 0, 0, 0, 1, 0, 118, 0, 0, 78, 1, 118, 39, 315, 15, 15, 197, 19, 14, 5, 78, 19, 39, 261, 130
INVAR-4, Run: 026, P, 0, 1, 0, 0, 0, 1, 0, 118, 0, 0, 78, 1, 118, 39, 360, 13, 13, 242, 19, 10, 9, 78, 19, 39, 143, 71
INVAR-4, Run: 027, P, 0, 1, 0, 0, 0, 1, 0, 118, 0, 0, 78, 1, 118, 39, 335, 17, 17, 217, 19, 12, 7, 78, 19, 39, 257, 128
INVAR-4, Run: 028, P, 0, 1, 0, 0, 0, 1, 0, 118, 0, 0, 78, 1, 118, 39, 468, 12, 12, 350, 19, 15, 4, 78, 19, 39, 263, 131
INVAR-4, Run: 029, P, 0, 1, 0, 0, 0, 1, 0, 118, 0, 0, 78, 1, 118, 39, 416, 21, 21, 298, 19, 13, 6, 78, 19, 39, 317, 158
INVAR-4, Run: 030, P, 0, 1, 0, 0, 0, 1, 0, 118, 0, 0, 78, 1, 118, 39, 266, 13, 13, 148, 19, 11, 8, 78, 19, 39, 317, 158
INVAR-4, Run: 031, P, 0, 1, 0, 0, 0, 1, 0, 118, 0, 0, 78, 1, 118, 39, 424, 23, 23, 306, 19, 14, 5, 78, 19, 39, 301, 150
INVAR-4, Run: 032, P, 0, 1, 0, 0, 0, 1, 0, 118, 0, 0, 78, 1, 118, 39, 527, 15, 15, 409, 19, 16, 3, 78, 19, 39, 337, 168
INVAR-4, Run: 033, P, 0, 1, 0, 0, 0, 1, 0, 118, 0, 0, 78, 1, 118, 39, 508, 13, 13, 390, 19, 16, 3, 78, 19, 39, 345, 172
INVAR-4, Run: 034, P, 0, 1, 0, 0, 0, 1, 0, 118, 0, 0, 78, 1, 118, 39, 393, 9, 9, 275, 19, 15, 4, 78, 19, 39, 251, 125
INVAR-4, Run: 035, P, 0, 1, 0, 0, 0, 1, 0, 118, 0, 0, 78, 1, 118, 39, 415, 15, 15, 297, 19, 14, 5, 78, 19, 39, 593, 296
INVAR-4, Run: 036, P, 0, 1, 0, 0, 0, 1, 0, 118, 0, 0, 78, 1, 118, 39, 352, 15, 15, 234, 19, 15, 4, 78, 19, 39, 437, 218
INVAR-4, Run: 037, P, 0, 1, 0, 0, 0, 1, 0, 118, 0, 0, 78, 1, 118, 39, 510, 23, 23, 392, 19, 9, 10, 78, 19, 39, 409, 204
INVAR-4, Run: 038, P, 0, 1, 0, 0, 0, 1, 0, 118, 0, 0, 78, 1, 118, 39, 404, 13, 13, 286, 19, 17, 2, 78, 19, 39, 485, 242
INVAR-4, Run: 039, P, 0, 1, 0, 0, 0, 1, 0, 118, 0, 0, 78, 1, 118, 39, 422, 22, 22, 304, 19, 13, 6, 78, 19, 39, 349, 174
INVAR-4, Run: 040, P, 0, 1, 0, 0, 0, 1, 0, 118, 0, 0, 78, 1, 118, 39, 455, 13, 13, 337, 19, 12, 7, 78, 19, 39, 517, 258
INVAR-4, Run: 041, P, 0, 1, 0, 0, 0, 1, 0, 118, 0, 0, 78, 1, 118, 39, 326, 7, 7, 208, 19, 16, 3, 78, 19, 39, 153, 76
INVAR-4, Run: 042, P, 0, 1, 0, 0, 0, 1, 0, 118, 0, 0, 78, 1, 118, 39, 451, 19, 19, 333, 19, 17, 2, 78, 19, 39, 227, 113
INVAR-4, Run: 043, P, 0, 1, 0, 0, 0, 1, 0, 118, 0, 0, 78, 1, 118, 39, 486, 13, 13, 368, 19, 14, 5, 78, 19, 39, 235, 117
INVAR-4, Run: 044, P, 0, 1, 0, 0, 0, 1, 0, 118, 0, 0, 78, 1, 118, 39, 411, 19, 19, 293, 19, 15, 4, 78, 19, 39, 295, 147
INVAR-4, Run: 045, P, 0, 1, 0, 0, 0, 1, 0, 118, 0, 0, 78, 1, 118, 39, 342, 15, 15, 224, 19, 15, 4, 78, 19, 39, 261, 130
INVAR-4, Run: 046, P, 0, 1, 0, 0, 0, 1, 0, 118, 0, 0, 78, 1, 118, 39, 447, 14, 14, 329, 19, 18, 1, 78, 19, 39, 401, 200
INVAR-4, Run: 047, P, 0, 1, 0, 0, 0, 1, 0, 118, 0, 0, 78, 1, 118, 39, 466, 20, 20, 348, 19, 14, 5, 78, 19, 39, 431, 215
INVAR-4, Run: 048, P, 0, 1, 0, 0, 0, 1, 0, 118, 0, 0, 78, 1, 118, 39, 504, 20, 20, 386, 19, 11, 8, 78, 19, 39, 215, 107
INVAR-4, Run: 049, P, 0, 1, 0, 0, 0, 1, 0, 118, 0, 0, 78, 1, 118, 39, 451, 22, 22, 333, 19, 12, 7, 78, 19, 39, 293, 146
INVAR-4, Run: 050, P, 0, 1, 0, 0, 0, 1, 0, 118, 0, 0, 78, 1, 118, 39, 336, 17, 17, 218, 19, 9, 10, 78, 19, 39, 363, 181
INVAR-4, Run: 051, P, 0, 1, 0, 0, 0, 1, 0, 118, 0, 0, 78, 1, 118, 39, 572, 20, 20, 454, 19, 10, 9, 78, 19, 39, 333, 166
INVAR-4, Run: 052, P, 0, 1, 0, 0, 0, 1, 0, 118, 0, 0, 78, 1, 118, 39, 675, 14, 14, 557, 19, 12, 7, 78, 19, 39, 353, 176
INVAR-4, Run: 053, P, 0, 1, 0, 0, 0, 1, 0, 118, 0, 0, 78, 1, 118, 39, 445, 23, 23, 327, 19, 15, 4, 78, 19, 39, 319, 159
INVAR-4, Run: 054, P, 0, 1, 0, 0, 0, 1, 0, 118, 0, 0, 78, 1, 118, 39, 329, 6, 6, 211, 19, 13, 6, 78, 19, 39, 235, 117
INVAR-4, Run: 055, P, 0, 1, 0, 0, 0, 1, 0, 118, 0, 0, 78, 1, 118, 39, 415, 11, 11, 297, 19, 13, 6, 78, 19, 39, 351, 175
INVAR-4, Run: 056, P, 0, 1, 0, 0, 0, 1, 0, 118, 0, 0, 78, 1, 118, 39, 326, 14, 14, 208, 19, 13, 6, 78, 19, 39, 249, 124
INVAR-4, Run: 057, P, 0, 1, 0, 0, 0, 1, 0, 118, 0, 0, 78, 1, 118, 39, 764, 16, 16, 646, 19, 9, 10, 78, 19, 39, 337, 168
INVAR-4, Run: 058, P, 0, 1, 0, 0, 0, 1, 0, 118, 0, 0, 78, 1, 118, 39, 454, 19, 19, 336, 19, 12, 7, 78, 19, 39, 477, 238
INVAR-4, Run: 059, P, 0, 1, 0, 0, 0, 1, 0, 118, 0, 0, 78, 1, 118, 39, 706, 21, 21, 588, 19, 10, 9, 78, 19, 39, 395, 197
INVAR-4, Run: 060, P, 0, 1, 0, 0, 0, 1, 0, 118, 0, 0, 78, 1, 118, 39, 387, 23, 23, 269, 19, 11, 8, 78, 19, 39, 195, 97
INVAR-4, Run: 061, P, 0, 1, 0, 0, 0, 1, 0, 118, 0, 0, 78, 1, 118, 39, 440, 13, 13, 322, 19, 14, 5, 78, 19, 39, 311, 155
INVAR-4, Run: 062, P, 0, 1, 0, 0, 0, 1, 0, 118, 0, 0, 78, 1, 118, 39, 527, 15, 15, 409, 19, 12, 7, 78, 19, 39, 151, 75
INVAR-4, Run: 063, P, 0, 1, 0, 0, 0, 1, 0, 118, 0, 0, 78, 1, 118, 39, 352, 13, 13, 234, 19, 9, 10, 78, 19, 39, 191, 95
INVAR-4, Run: 064, P, 0, 1, 0, 0, 0, 1, 0, 118, 0, 0, 78, 1, 118, 39, 345, 20, 20, 227, 19, 11, 8, 78, 19, 39, 237, 118
INVAR-4, Run: 065, P, 0, 1, 0, 0, 0, 1, 0, 118, 0, 0, 78, 1, 118, 39, 444, 20, 20, 326, 19, 11, 8, 78, 19, 39, 207, 103
INVAR-4, Run: 066, P, 0, 1, 0, 0, 0, 1, 0, 118, 0, 0, 78, 1, 118, 39, 701, 29, 29, 583, 19, 12, 7, 78, 19, 39, 345, 172
INVAR-4, Run: 067, P, 0, 1, 0, 0, 0, 1, 0, 118, 0, 0, 78, 1, 118, 39, 267, 8, 8, 149, 19, 14, 5, 78, 19, 39, 331, 165
INVAR-4, Run: 068, P, 0, 1, 0, 0, 0, 1, 0, 118, 0, 0, 78, 1, 118, 39, 337, 17, 17, 219, 19, 9, 10, 78, 19, 39, 225, 112
INVAR-4, Run: 069, P, 0, 1, 0, 0, 0, 1, 0, 118, 0, 0, 78, 1, 118, 39, 404, 10, 10, 286, 19, 13, 6, 78, 19, 39, 161, 80
INVAR-4, Run: 070, P, 0, 1, 0, 0, 0, 1, 0, 118, 0, 0, 78, 1, 118, 39, 443, 13, 13, 325, 19, 12, 7, 78, 19, 39, 425, 212
INVAR-4, Run: 071, P, 0, 1, 0, 0, 0, 1, 0, 118, 0, 0, 78, 1, 118, 39, 347, 14, 14, 229, 19, 10, 9, 78, 19, 39, 193, 96
INVAR-4, Run: 072, P, 0, 1, 0, 0, 0, 1, 0, 118, 0, 0, 78, 1, 118, 39, 377, 13, 13, 259, 19, 16, 3, 78, 19, 39, 201, 100
INVAR-4, Run: 073, P, 0, 1, 0, 0, 0, 1, 0, 118, 0, 0, 78, 1, 118, 39, 524, 29, 29, 406, 19, 12, 7, 78, 19, 39, 353, 176
INVAR-4, Run: 074, P, 0, 1, 0, 0, 0, 1, 0, 118, 0, 0, 78, 1, 118, 39, 547, 21, 21, 429, 19, 15, 4, 78, 19, 39, 359, 179
INVAR-4, Run: 075, P, 0, 1, 0, 0, 0, 1, 0, 118, 0, 0, 78, 1, 118, 39, 538, 23, 23, 420, 19, 15, 4, 78, 19, 39, 441, 220
INVAR-4, Run: 076, P, 0, 1, 0, 0, 0, 1, 0, 118, 0, 0, 78, 1, 118, 39, 474, 19, 19, 356, 19, 12, 7, 78, 19, 39, 227, 113
INVAR-4, Run: 077, P, 0, 1, 0, 0, 0, 1, 0, 118, 0, 0, 78, 1, 118, 39, 477, 10, 10, 359, 19, 17, 2, 78, 19, 39, 271, 135
INVAR-4, Run: 078, P, 0, 1, 0, 0, 0, 1, 0, 118, 0, 0, 78, 1, 118, 39, 420, 17, 17, 302, 19, 16, 3, 78, 19, 39, 379, 189
INVAR-4, Run: 079, P, 0, 1, 0, 0, 0, 1, 0, 118, 0, 0, 78, 1, 118, 39, 287, 10, 10, 169, 19, 15, 4, 78, 19, 39, 147, 73
INVAR-4, Run: 080, P, 0, 1, 0, 0, 0, 1, 0, 118, 0, 0, 78, 1, 118, 39, 407, 15, 15, 289, 19, 15, 4, 78, 19, 39, 231, 115
INVAR-4, Run: 081, P, 0, 1, 0, 0, 0, 1, 0, 118, 0, 0, 78, 1, 118, 39, 389, 19, 19, 271, 19, 11, 8, 78, 19, 39, 415, 207
INVAR-4, Run: 082, P, 0, 1, 0, 0, 0, 1, 0, 118, 0, 0, 78, 1, 118, 39, 338, 16, 16, 220, 19, 12, 7, 78, 19, 39, 205, 102
INVAR-4, Run: 083, P, 0, 1, 0, 0, 0, 1, 0, 118, 0, 0, 78, 1, 118, 39, 560, 13, 13, 442, 19, 14, 5, 78, 19, 39, 497, 248
INVAR-4, Run: 084, P, 0, 1, 0, 0, 0, 1, 0, 118, 0, 0, 78, 1, 118, 39, 456, 9, 9, 338, 19, 17, 2, 78, 19, 39, 393, 196
INVAR-4, Run: 085, P, 0, 1, 0, 0, 0, 1, 0, 118, 0, 0, 78, 1, 118, 39, 538, 14, 14, 420, 19, 12, 7, 78, 19, 39, 227, 113
INVAR-4, Run: 086, P, 0, 1, 0, 0, 0, 1, 0, 118, 0, 0, 78, 1, 118, 39, 306, 11, 11, 188, 19, 13, 6, 78, 19, 39, 335, 167
INVAR-4, Run: 087, P, 0, 1, 0, 0, 0, 1, 0, 118, 0, 0, 78, 1, 118, 39, 465, 19, 19, 347, 19, 13, 6, 78, 19, 39, 303, 151
INVAR-4, Run: 088, P, 0, 1, 0, 0, 0, 1, 0, 118, 0, 0, 78, 1, 118, 39, 382, 15, 15, 264, 19, 13, 6, 78, 19, 39, 199, 99
INVAR-4, Run: 089, P, 0, 1, 0, 0, 0, 1, 0, 118, 0, 0, 78, 1, 118, 39, 322, 12, 12, 204, 19, 13, 6, 78, 19, 39, 325, 162
INVAR-4, Run: 090, P, 0, 1, 0, 0, 0, 1, 0, 118, 0, 0, 78, 1, 118, 39, 411, 17, 17, 293, 19, 12, 7, 78, 19, 39, 271, 135
INVAR-4, Run: 091, P, 0, 1, 0, 0, 0, 1, 0, 118, 0, 0, 78, 1, 118, 39, 381, 23, 23, 263, 19, 12, 7, 78, 19, 39, 263, 131
INVAR-4, Run: 092, P, 0, 1, 0, 0, 0, 1, 0, 118, 0, 0, 78, 1, 118, 39, 494, 15, 15, 376, 19, 15, 4, 78, 19, 39, 239, 119
INVAR-4, Run: 093, P, 0, 1, 0, 0, 0, 1, 0, 118, 0, 0, 78, 1, 118, 39, 411, 21, 21, 293, 19, 11, 8, 78, 19, 39, 445, 222
INVAR-4, Run: 094, P, 0, 1, 0, 0, 0, 1, 0, 118, 0, 0, 78, 1, 118, 39, 500, 22, 22, 382, 19, 13, 6, 78, 19, 39, 217, 108
INVAR-4, Run: 095, P, 0, 1, 0, 0, 0, 1, 0, 118, 0, 0, 78, 1, 118, 39, 353, 18, 18, 235, 19, 11, 8, 78, 19, 39, 131, 65
INVAR-4, Run: 096, P, 0, 1, 0, 0, 0, 1, 0, 118, 0, 0, 78, 1, 118, 39, 473, 22, 22, 355, 19, 14, 5, 78, 19, 39, 459, 229
INVAR-4, Run: 097, P, 0, 1, 0, 0, 0, 1, 0, 118, 0, 0, 78, 1, 118, 39, 433, 18, 18, 315, 19, 13, 6, 78, 19, 39, 221, 110
INVAR-4, Run: 098, P, 0, 1, 0, 0, 0, 1, 0, 118, 0, 0, 78, 1, 118, 39, 553, 19, 19, 435, 19, 14, 5, 78, 19, 39, 243, 121
INVAR-4, Run: 099, P, 0, 1, 0, 0, 0, 1, 0, 118, 0, 0, 78, 1, 118, 39, 572, 15, 15, 454, 19, 17, 2, 78, 19, 39, 209, 104
INVAR-4, Run: 100, P, 0, 1, 0, 0, 0, 1, 0, 118, 0, 0, 78, 1, 118, 39, 302, 14, 14, 184, 19, 13, 6, 78, 19, 39, 249, 124
INVAR-5, Run: 001, P, 0, 1, 0, 0, 0, 1, 0, 160, 0, 0, 106, 1, 160, 53, 594, 32, 32, 434, 26, 16, 10, 106, 26, 53, 561, 280
INVAR-5, Run: 002, P, 0, 1, 0, 0, 0, 1, 0, 160, 0, 0, 106, 1, 160, 53, 815, 33, 33, 655, 26, 15, 11, 106, 26, 53, 605, 302
INVAR-5, Run: 003, P, 0, 1, 0, 0, 0, 1, 0, 160, 0, 0, 106, 1, 160, 53, 536, 21, 21, 376, 26, 20, 6, 106, 26, 53, 533, 266
INVAR-5, Run: 004, P, 0, 1, 0, 0, 0, 1, 0, 160, 0, 0, 106, 1, 160, 53, 634, 25, 25, 474, 26, 18, 8, 106, 26, 53, 395, 197
INVAR-5, Run: 005, P, 0, 1, 0, 0, 0, 1, 0, 160, 0, 0, 106, 1, 160, 53, 830, 28, 28, 670, 26, 16, 10, 106, 26, 53, 493, 246
INVAR-5, Run: 006, P, 0, 1, 0, 0, 0, 1, 0, 160, 0, 0, 106, 1, 160, 53, 677, 19, 19, 517, 26, 15, 11, 106, 26, 53, 443, 221
INVAR-5, Run: 007, P, 0, 1, 0, 0, 0, 1, 0, 160, 0, 0, 106, 1, 160, 53, 775, 26, 26, 615, 26, 16, 10, 106, 26, 53, 441, 220
INVAR-5, Run: 008, P, 0, 1, 0, 0, 0, 1, 0, 160, 0, 0, 106, 1, 160, 53, 1076, 25, 25, 916, 26, 17, 9, 106, 26, 53, 831, 415
INVAR-5, Run: 009, P, 0, 1, 0, 0, 0, 1, 0, 160, 0, 0, 106, 1, 160, 53, 736, 30, 30, 576, 26, 16, 10, 106, 26, 53, 567, 283
INVAR-5, Run: 010, P, 0, 1, 0, 0, 0, 1, 0, 160, 0, 0, 106, 1, 160, 53, 741, 24, 24, 581, 26, 17, 9, 106, 26, 53, 673, 336
INVAR-5, Run: 011, P, 0, 1, 0, 0, 0, 1, 0, 160, 0, 0, 106, 1, 160, 53, 807, 28, 28, 647, 26, 17, 9, 106, 26, 53, 465, 232
INVAR-5, Run: 012, P, 0, 1, 0, 0, 0, 1, 0, 160, 0, 0, 106, 1, 160, 53, 735, 23, 23, 575, 26, 15, 11, 106, 26, 53, 489, 244
INVAR-5, Run: 013, P, 0, 1, 0, 0, 0, 1, 0, 160, 0, 0, 106, 1, 160, 53, 698, 16, 16, 538, 26, 21, 5, 106, 26, 53, 347, 173
INVAR-5, Run: 014, P, 0, 1, 0, 0, 0, 1, 0, 160, 0, 0, 106, 1, 160, 53, 569, 19, 19, 409, 26, 17, 9, 106, 26, 53, 685, 342
INVAR-5, Run: 015, P, 0, 1, 0, 0, 0, 1, 0, 160, 0, 0, 106, 1, 160, 53, 868, 18, 18, 708, 26, 16, 10, 106, 26, 53, 545, 272
INVAR-5, Run: 016, P, 0, 1, 0, 0, 0, 1, 0, 160, 0, 0, 106, 1, 160, 53, 757, 20, 20, 597, 26, 15, 11, 106, 26, 53, 989, 494
INVAR-5, Run: 017, P, 0, 1, 0, 0, 0, 1, 0, 160, 0, 0, 106, 1, 160, 53, 956, 23, 23, 796, 26, 21, 5, 106, 26, 53, 501, 250
INVAR-5, Run: 018, P, 0, 1, 0, 0, 0, 1, 0, 160, 0, 0, 106, 1, 160, 53, 702, 41, 41, 542, 26, 16, 10, 106, 26, 53, 669, 334
INVAR-5, Run: 019, P, 0, 1, 0, 0, 0, 1, 0, 160, 0, 0, 106, 1, 160, 53, 864, 32, 32, 704, 26, 15, 11, 106, 26, 53, 739, 369
INVAR-5, Run: 020, P, 0, 1, 0, 0, 0, 1, 0, 160, 0, 0, 106, 1, 160, 53, 538, 23, 23, 378, 26, 22, 4, 106, 26, 53, 275, 137
INVAR-5, Run: 021, P, 0, 1, 0, 0, 0, 1, 0, 160, 0, 0, 106, 1, 160, 53, 685, 30, 30, 525, 26, 13, 13, 106, 26, 53, 495, 247
INVAR-5, Run: 022, P, 0, 1, 0, 0, 0, 1, 0, 160, 0, 0, 106, 1, 160, 53, 614, 25, 25, 454, 26, 20, 6, 106, 26, 53, 695, 347
INVAR-5, Run: 023, P, 0, 1, 0, 0, 0, 1, 0, 160, 0, 0, 106, 1, 160, 53, 659, 21, 21, 499, 26, 14, 12, 106, 26, 53, 403, 201
INVAR-5, Run: 024, P, 0, 1, 0, 0, 0, 1, 0, 160, 0, 0, 106, 1, 160, 53, 1058, 24, 24, 898, 26, 14, 12, 106, 26, 53, 501, 250
INVAR-5, Run: 025, P, 0, 1, 0, 0, 0, 1, 0, 160, 0, 0, 106, 1, 160, 53, 632, 18, 18, 472, 26, 15, 11, 106, 26, 53, 499, 249
INVAR-5, Run: 026, P, 0, 1, 0, 0, 0, 1, 0, 160, 0, 0, 106, 1, 160, 53, 739, 16, 16, 579, 26, 21, 5, 106, 26, 53, 807, 403
INVAR-5, Run: 027, P, 0, 1, 0, 0, 0, 1, 0, 160, 0, 0, 106, 1, 160, 53, 608, 11, 11, 448, 26, 18, 8, 106, 26, 53, 391, 195
INVAR-5, Run: 028, P, 0, 1, 0, 0, 0, 1, 0, 160, 0, 0, 106, 1, 160, 53, 679, 15, 15, 519, 26, 18, 8, 106, 26, 53, 511, 255
INVAR-5, Run: 029, P, 0, 1, 0, 0, 0, 1, 0, 160, 0, 0, 106, 1, 160, 53, 644, 16, 16, 484, 26, 15, 11, 106, 26, 53, 691, 345
INVAR-5, Run: 030, P, 0, 1, 0, 0, 0, 1, 0, 160, 0, 0, 106, 1, 160, 53, 615, 33, 33, 455, 26, 15, 11, 106, 26, 53, 731, 365
INVAR-5, Run: 031, P, 0, 1, 0, 0, 0, 1, 0, 160, 0, 0, 106, 1, 160, 53, 701, 24, 24, 541, 26, 19, 7, 106, 26, 53, 481, 240
INVAR-5, Run: 032, P, 0, 1, 0, 0, 0, 1, 0, 160, 0, 0, 106, 1, 160, 53, 786, 15, 15, 626, 26, 19, 7, 106, 26, 53, 595, 297
INVAR-5, Run: 033, P, 0, 1, 0, 0, 0, 1, 0, 160, 0, 0, 106, 1, 160, 53, 699, 23, 23, 539, 26, 16, 10, 106, 26, 53, 741, 370
INVAR-5, Run: 034, P, 0, 1, 0, 0, 0, 1, 0, 160, 0, 0, 106, 1, 160, 53, 604, 25, 25, 444, 26, 23, 3, 106, 26, 53, 291, 145
INVAR-5, Run: 035, P, 0, 1, 0, 0, 0, 1, 0, 160, 0, 0, 106, 1, 160, 53, 679, 23, 23, 519, 26, 19, 7, 106, 26, 53, 381, 190
INVAR-5, Run: 036, P, 0, 1, 0, 0, 0, 1, 0, 160, 0, 0, 106, 1, 160, 53, 814, 36, 36, 654, 26, 14, 12, 106, 26, 53, 597, 298
INVAR-5, Run: 037, P, 0, 1, 0, 0, 0, 1, 0, 160, 0, 0, 106, 1, 160, 53, 782, 27, 27, 622, 26, 18, 8, 106, 26, 53, 549, 274
INVAR-5, Run: 038, P, 0, 1, 0, 0, 0, 1, 0, 160, 0, 0, 106, 1, 160, 53, 514, 25, 25, 354, 26, 16, 10, 106, 26, 53, 945, 472
INVAR-5, Run: 039, P, 0, 1, 0, 0, 0, 1, 0, 160, 0, 0, 106, 1, 160, 53, 721, 19, 19, 561, 26, 16, 10, 106, 26, 53, 353, 176
INVAR-5, Run: 040, P, 0, 1, 0, 0, 0, 1, 0, 160, 0, 0, 106, 1, 160, 53, 675, 25, 25, 515, 26, 20, 6, 106, 26, 53, 473, 236
INVAR-5, Run: 041, P, 0, 1, 0, 0, 0, 1, 0, 160, 0, 0, 106, 1, 160, 53, 670, 21, 21, 510, 26, 15, 11, 106, 26, 53, 333, 166
INVAR-5, Run: 042, P, 0, 1, 0, 0, 0, 1, 0, 160, 0, 0, 106, 1, 160, 53, 666, 20, 20, 506, 26, 17, 9, 106, 26, 53, 571, 285
INVAR-5, Run: 043, P, 0, 1, 0, 0, 0, 1, 0, 160, 0, 0, 106, 1, 160, 53, 989, 16, 16, 829, 26, 18, 8, 106, 26, 53, 639, 319
INVAR-5, Run: 044, P, 0, 1, 0, 0, 0, 1, 0, 160, 0, 0, 106, 1, 160, 53, 764, 23, 23, 604, 26, 22, 4, 106, 26, 53, 445, 222
INVAR-5, Run: 045, P, 0, 1, 0, 0, 0, 1, 0, 160, 0, 0, 106, 1, 160, 53, 665, 24, 24, 505, 26, 18, 8, 106, 26, 53, 551, 275
INVAR-5, Run: 046, P, 0, 1, 0, 0, 0, 1, 0, 160, 0, 0, 106, 1, 160, 53, 696, 32, 32, 536, 26, 15, 11, 106, 26, 53, 451, 225
INVAR-5, Run: 047, P, 0, 1, 0, 0, 0, 1, 0, 160, 0, 0, 106, 1, 160, 53, 530, 21, 21, 370, 26, 16, 10, 106, 26, 53, 369, 184
INVAR-5, Run: 048, P, 0, 1, 0, 0, 0, 1, 0, 160, 0, 0, 106, 1, 160, 53, 635, 17, 17, 475, 26, 17, 9, 106, 26, 53, 597, 298
INVAR-5, Run: 049, P, 0, 1, 0, 0, 0, 1, 0, 160, 0, 0, 106, 1, 160, 53, 878, 22, 22, 718, 26, 14, 12, 106, 26, 53, 409, 204
INVAR-5, Run: 050, P, 0, 1, 0, 0, 0, 1, 0, 160, 0, 0, 106, 1, 160, 53, 657, 18, 18, 497, 26, 18, 8, 106, 26, 53, 879, 439
INVAR-5, Run: 051, P, 0, 1, 0, 0, 0, 1, 0, 160, 0, 0, 106, 1, 160, 53, 694, 16, 16, 534, 26, 13, 13, 106, 26, 53, 553, 276
INVAR-5, Run: 052, P, 0, 1, 0, 0, 0, 1, 0, 160, 0, 0, 106, 1, 160, 53, 818, 19, 19, 658, 26, 20, 6, 106, 26, 53, 515, 257
INVAR-5, Run: 053, P, 0, 1, 0, 0, 0, 1, 0, 160, 0, 0, 106, 1, 160, 53, 765, 18, 18, 605, 26, 18, 8, 106, 26, 53, 403, 201
INVAR-5, Run: 054, P, 0, 1, 0, 0, 0, 1, 0, 160, 0, 0, 106, 1, 160, 53, 1034, 33, 33, 874, 26, 19, 7, 106, 26, 53, 875, 437
INVAR-5, Run: 055, P, 0, 1, 0, 0, 0, 1, 0, 160, 0, 0, 106, 1, 160, 53, 573, 13, 13, 413, 26, 19, 7, 106, 26, 53, 475, 237
INVAR-5, Run: 056, P, 0, 1, 0, 0, 0, 1, 0, 160, 0, 0, 106, 1, 160, 53, 800, 25, 25, 640, 26, 13, 13, 106, 26, 53, 265, 132
INVAR-5, Run: 057, P, 0, 1, 0, 0, 0, 1, 0, 160, 0, 0, 106, 1, 160, 53, 484, 30, 30, 324, 26, 12, 14, 106, 26, 53, 421, 210
INVAR-5, Run: 058, P, 0, 1, 0, 0, 0, 1, 0, 160, 0, 0, 106, 1, 160, 53, 863, 21, 21, 703, 26, 9, 17, 106, 26, 53, 701, 350
INVAR-5, Run: 059, P, 0, 1, 0, 0, 0, 1, 0, 160, 0, 0, 106, 1, 160, 53, 647, 38, 38, 487, 26, 12, 14, 106, 26, 53, 369, 184
INVAR-5, Run: 060, P, 0, 1, 0, 0, 0, 1, 0, 160, 0, 0, 106, 1, 160, 53, 706, 13, 13, 546, 26, 20, 6, 106, 26, 53, 419, 209
INVAR-5, Run: 061, P, 0, 1, 0, 0, 0, 1, 0, 160, 0, 0, 106, 1, 160, 53, 696, 29, 29, 536, 26, 16, 10, 106, 26, 53, 823, 411
INVAR-5, Run: 062, P, 0, 1, 0, 0, 0, 1, 0, 160, 0, 0, 106, 1, 160, 53, 735, 15, 15, 575, 26, 16, 10, 106, 26, 53, 327, 163
INVAR-5, Run: 063, P, 0, 1, 0, 0, 0, 1, 0, 160, 0, 0, 106, 1, 160, 53, 759, 27, 27, 599, 26, 20, 6, 106, 26, 53, 481, 240
INVAR-5, Run: 064, P, 0, 1, 0, 0, 0, 1, 0, 160, 0, 0, 106, 1, 160, 53, 658, 29, 29, 498, 26, 17, 9, 106, 26, 53, 399, 199
INVAR-5, Run: 065, P, 0, 1, 0, 0, 0, 1, 0, 160, 0, 0, 106, 1, 160, 53, 894, 23, 23, 734, 26, 18, 8, 106, 26, 53, 595, 297
INVAR-5, Run: 066, P, 0, 1, 0, 0, 0, 1, 0, 160, 0, 0, 106, 1, 160, 53, 603, 22, 22, 443, 26, 20, 6, 106, 26, 53, 405, 202
INVAR-5, Run: 067, P, 0, 1, 0, 0, 0, 1, 0, 160, 0, 0, 106, 1, 160, 53, 946, 27, 27, 786, 26, 17, 9, 106, 26, 53, 499, 249
INVAR-5, Run: 068, P, 0, 1, 0, 0, 0, 1, 0, 160, 0, 0, 106, 1, 160, 53, 988, 42, 42, 828, 26, 14, 12, 106, 26, 53, 403, 201
INVAR-5, Run: 069, P, 0, 1, 0, 0, 0, 1, 0, 160, 0, 0, 106, 1, 160, 53, 615, 28, 28, 455, 26, 21, 5, 106, 26, 53, 451, 225
INVAR-5, Run: 070, P, 0, 1, 0, 0, 0, 1, 0, 160, 0, 0, 106, 1, 160, 53, 835, 19, 19, 675, 26, 17, 9, 106, 26, 53, 769, 384
INVAR-5, Run: 071, P, 0, 1, 0, 0, 0, 1, 0, 160, 0, 0, 106, 1, 160, 53, 971, 31, 31, 811, 26, 16, 10, 106, 26, 53, 307, 153
INVAR-5, Run: 072, P, 0, 1, 0, 0, 0, 1, 0, 160, 0, 0, 106, 1, 160, 53, 698, 32, 32, 538, 26, 18, 8, 106, 26, 53, 473, 236
INVAR-5, Run: 073, P, 0, 1, 0, 0, 0, 1, 0, 160, 0, 0, 106, 1, 160, 53, 545, 13, 13, 385, 26, 15, 11, 106, 26, 53, 549, 274
INVAR-5, Run: 074, P, 0, 1, 0, 0, 0, 1, 0, 160, 0, 0, 106, 1, 160, 53, 762, 20, 20, 602, 26, 17, 9, 106, 26, 53, 339, 169
INVAR-5, Run: 075, P, 0, 1, 0, 0, 0, 1, 0, 160, 0, 0, 106, 1, 160, 53, 551, 17, 17, 391, 26, 17, 9, 106, 26, 53, 231, 115
INVAR-5, Run: 076, P, 0, 1, 0, 0, 0, 1, 0, 160, 0, 0, 106, 1, 160, 53, 757, 23, 23, 597, 26, 15, 11, 106, 26, 53, 949, 474
INVAR-5, Run: 077, P, 0, 1, 0, 0, 0, 1, 0, 160, 0, 0, 106, 1, 160, 53, 704, 26, 26, 544, 26, 21, 5, 106, 26, 53, 699, 349
INVAR-5, Run: 078, P, 0, 1, 0, 0, 0, 1, 0, 160, 0, 0, 106, 1, 160, 53, 850, 21, 21, 690, 26, 20, 6, 106, 26, 53, 367, 183
INVAR-5, Run: 079, P, 0, 1, 0, 0, 0, 1, 0, 160, 0, 0, 106, 1, 160, 53, 625, 17, 17, 465, 26, 16, 10, 106, 26, 53, 931, 465
INVAR-5, Run: 080, P, 0, 1, 0, 0, 0, 1, 0, 160, 0, 0, 106, 1, 160, 53, 582, 15, 15, 422, 26, 20, 6, 106, 26, 53, 243, 121
INVAR-5, Run: 081, P, 0, 1, 0, 0, 0, 1, 0, 160, 0, 0, 106, 1, 160, 53, 873, 26, 26, 713, 26, 13, 13, 106, 26, 53, 301, 150
INVAR-5, Run: 082, P, 0, 1, 0, 0, 0, 1, 0, 160, 0, 0, 106, 1, 160, 53, 1134, 22, 22, 974, 26, 18, 8, 106, 26, 53, 797, 398
INVAR-5, Run: 083, P, 0, 1, 0, 0, 0, 1, 0, 160, 0, 0, 106, 1, 160, 53, 655, 22, 22, 495, 26, 16, 10, 106, 26, 53, 423, 211
INVAR-5, Run: 084, P, 0, 1, 0, 0, 0, 1, 0, 160, 0, 0, 106, 1, 160, 53, 487, 15, 15, 327, 26, 20, 6, 106, 26, 53, 703, 351
INVAR-5, Run: 085, P, 0, 1, 0, 0, 0, 1, 0, 160, 0, 0, 106, 1, 160, 53, 652, 28, 28, 492, 26, 11, 15, 106, 26, 53, 615, 307
INVAR-5, Run: 086, P, 0, 1, 0, 0, 0, 1, 0, 160, 0, 0, 106, 1, 160, 53, 520, 21, 21, 360, 26, 16, 10, 106, 26, 53, 587, 293
INVAR-5, Run: 087, P, 0, 1, 0, 0, 0, 1, 0, 160, 0, 0, 106, 1, 160, 53, 988, 28, 28, 828, 26, 13, 13, 106, 26, 53, 299, 149
INVAR-5, Run: 088, P, 0, 1, 0, 0, 0, 1, 0, 160, 0, 0, 106, 1, 160, 53, 597, 29, 29, 437, 26, 15, 11, 106, 26, 53, 517, 258
INVAR-5, Run: 089, P, 0, 1, 0, 0, 0, 1, 0, 160, 0, 0, 106, 1, 160, 53, 590, 15, 15, 430, 26, 18, 8, 106, 26, 53, 605, 302
INVAR-5, Run: 090, P, 0, 1, 0, 0, 0, 1, 0, 160, 0, 0, 106, 1, 160, 53, 1234, 26, 26, 1074, 26, 21, 5, 106, 26, 53, 757, 378
INVAR-5, Run: 091, P, 0, 1, 0, 0, 0, 1, 0, 160, 0, 0, 106, 1, 160, 53, 460, 20, 20, 300, 26, 15, 11, 106, 26, 53, 339, 169
INVAR-5, Run: 092, P, 0, 1, 0, 0, 0, 1, 0, 160, 0, 0, 106, 1, 160, 53, 704, 17, 17, 544, 26, 18, 8, 106, 26, 53, 425, 212
INVAR-5, Run: 093, P, 0, 1, 0, 0, 0, 1, 0, 160, 0, 0, 106, 1, 160, 53, 618, 25, 25, 458, 26, 11, 15, 106, 26, 53, 527, 263
INVAR-5, Run: 094, P, 0, 1, 0, 0, 0, 1, 0, 160, 0, 0, 106, 1, 160, 53, 612, 15, 15, 452, 26, 19, 7, 106, 26, 53, 817, 408
INVAR-5, Run: 095, P, 0, 1, 0, 0, 0, 1, 0, 160, 0, 0, 106, 1, 160, 53, 888, 21, 21, 728, 26, 17, 9, 106, 26, 53, 593, 296
INVAR-5, Run: 096, P, 0, 1, 0, 0, 0, 1, 0, 160, 0, 0, 106, 1, 160, 53, 731, 20, 20, 571, 26, 17, 9, 106, 26, 53, 353, 176
INVAR-5, Run: 097, P, 0, 1, 0, 0, 0, 1, 0, 160, 0, 0, 106, 1, 160, 53, 734, 17, 17, 574, 26, 12, 14, 106, 26, 53, 385, 192
INVAR-5, Run: 098, P, 0, 1, 0, 0, 0, 1, 0, 160, 0, 0, 106, 1, 160, 53, 724, 19, 19, 564, 26, 16, 10, 106, 26, 53, 479, 239
INVAR-5, Run: 099, P, 0, 1, 0, 0, 0, 1, 0, 160, 0, 0, 106, 1, 160, 53, 606, 19, 19, 446, 26, 17, 9, 106, 26, 53, 419, 209
INVAR-5, Run: 100, P, 0, 1, 0, 0, 0, 1, 0, 160, 0, 0, 106, 1, 160, 53, 527, 22, 22, 367, 26, 13, 13, 106, 26, 53, 709, 354
INVAR-6, Run: 001, P, 0, 1, 0, 0, 0, 1, 0, 526, 0, 0, 350, 1, 526, 175, 4127, 79, 79, 3601, 87, 60, 27, 350, 87, 175, 3673, 1836
INVAR-6, Run: 002, P, 0, 1, 0, 0, 0, 1, 0, 526, 0, 0, 350, 1, 526, 175, 5754, 65, 65, 5228, 87, 59, 28, 350, 87, 175, 3001, 1500
INVAR-6, Run: 003, P, 0, 1, 0, 0, 0, 1, 0, 526, 0, 0, 350, 1, 526, 175, 3702, 71, 71, 3176, 87, 54, 33, 350, 87, 175, 3147, 1573
INVAR-6, Run: 004, P, 0, 1, 0, 0, 0, 1, 0, 526, 0, 0, 350, 1, 526, 175, 5497, 60, 60, 4971, 87, 58, 29, 350, 87, 175, 3519, 1759
INVAR-6, Run: 005, P, 0, 1, 0, 0, 0, 1, 0, 526, 0, 0, 350, 1, 526, 175, 4627, 53, 53, 4101, 87, 58, 29, 350, 87, 175, 3601, 1800
INVAR-6, Run: 006, P, 0, 1, 0, 0, 0, 1, 0, 526, 0, 0, 350, 1, 526, 175, 4038, 62, 62, 3512, 87, 52, 35, 350, 87, 175, 4903, 2451
INVAR-6, Run: 007, P, 0, 1, 0, 0, 0, 1, 0, 526, 0, 0, 350, 1, 526, 175, 4324, 67, 67, 3798, 87, 45, 42, 350, 87, 175, 5179, 2589
INVAR-6, Run: 008, P, 0, 1, 0, 0, 0, 1, 0, 526, 0, 0, 350, 1, 526, 175, 4105, 68, 68, 3579, 87, 54, 33, 350, 87, 175, 2883, 1441
INVAR-6, Run: 009, P, 0, 1, 0, 0, 0, 1, 0, 526, 0, 0, 350, 1, 526, 175, 4960, 61, 61, 4434, 87, 49, 38, 350, 87, 175, 3617, 1808
INVAR-6, Run: 010, P, 0, 1, 0, 0, 0, 1, 0, 526, 0, 0, 350, 1, 526, 175, 3938, 60, 60, 3412, 87, 55, 32, 350, 87, 175, 3501, 1750
INVAR-6, Run: 011, P, 0, 1, 0, 0, 0, 1, 0, 526, 0, 0, 350, 1, 526, 175, 3796, 50, 50, 3270, 87, 59, 28, 350, 87, 175, 2563, 1281
INVAR-6, Run: 012, P, 0, 1, 0, 0, 0, 1, 0, 526, 0, 0, 350, 1, 526, 175, 4460, 67, 67, 3934, 87, 54, 33, 350, 87, 175, 3457, 1728
INVAR-6, Run: 013, P, 0, 1, 0, 0, 0, 1, 0, 526, 0, 0, 350, 1, 526, 175, 3979, 78, 78, 3453, 87, 50, 37, 350, 87, 175, 2361, 1180
INVAR-6, Run: 014, P, 0, 1, 0, 0, 0, 1, 0, 526, 0, 0, 350, 1, 526, 175, 3265, 62, 62, 2739, 87, 54, 33, 350, 87, 175, 3161, 1580
INVAR-6, Run: 015, P, 0, 1, 0, 0, 0, 1, 0, 526, 0, 0, 350, 1, 526, 175, 5097, 68, 68, 4571, 87, 52, 35, 350, 87, 175, 3485, 1742
INVAR-6, Run: 016, P, 0, 1, 0, 0, 0, 1, 0, 526, 0, 0, 350, 1, 526, 175, 4636, 54, 54, 4110, 87, 51, 36, 350, 87, 175, 3433, 1716
INVAR-6, Run: 017, P, 0, 1, 0, 0, 0, 1, 0, 526, 0, 0, 350, 1, 526, 175, 5116, 75, 75, 4590, 87, 61, 26, 350, 87, 175, 3277, 1638
INVAR-6, Run: 018, P, 0, 1, 0, 0, 0, 1, 0, 526, 0, 0, 350, 1, 526, 175, 4530, 66, 66, 4004, 87, 48, 39, 350, 87, 175, 5175, 2587
INVAR-6, Run: 019, P, 0, 1, 0, 0, 0, 1, 0, 526, 0, 0, 350, 1, 526, 175, 3431, 63, 63, 2905, 87, 48, 39, 350, 87, 175, 3487, 1743
INVAR-6, Run: 020, P, 0, 1, 0, 0, 0, 1, 0, 526, 0, 0, 350, 1, 526, 175, 4515, 73, 73, 3989, 87, 52, 35, 350, 87, 175, 3327, 1663
INVAR-6, Run: 021, P, 0, 1, 0, 0, 0, 1, 0, 526, 0, 0, 350, 1, 526, 175, 4431, 83, 83, 3905, 87, 48, 39, 350, 87, 175, 3555, 1777
INVAR-6, Run: 022, P, 0, 1, 0, 0, 0, 1, 0, 526, 0, 0, 350, 1, 526, 175, 3918, 59, 59, 3392, 87, 58, 29, 350, 87, 175, 4247, 2123
INVAR-6, Run: 023, P, 0, 1, 0, 0, 0, 1, 0, 526, 0, 0, 350, 1, 526, 175, 3244, 55, 55, 2718, 87, 61, 26, 350, 87, 175, 2969, 1484
INVAR-6, Run: 024, P, 0, 1, 0, 0, 0, 1, 0, 526, 0, 0, 350, 1, 526, 175, 3867, 73, 73, 3341, 87, 61, 26, 350, 87, 175, 3385, 1692
INVAR-6, Run: 025, P, 0, 1, 0, 0, 0, 1, 0, 526, 0, 0, 350, 1, 526, 175, 3633, 77, 77, 3107, 87, 57, 30, 350, 87, 175, 4321, 2160
INVAR-6, Run: 026, P, 0, 1, 0, 0, 0, 1, 0, 526, 0, 0, 350, 1, 526, 175, 4140, 58, 58, 3614, 87, 54, 33, 350, 87, 175, 3735, 1867
INVAR-6, Run: 027, P, 0, 1, 0, 0, 0, 1, 0, 526, 0, 0, 350, 1, 526, 175, 3882, 78, 78, 3356, 87, 62, 25, 350, 87, 175, 3329, 1664
INVAR-6, Run: 028, P, 0, 1, 0, 0, 0, 1, 0, 526, 0, 0, 350, 1, 526, 175, 3995, 59, 59, 3469, 87, 58, 29, 350, 87, 175, 2979, 1489
INVAR-6, Run: 029, P, 0, 1, 0, 0, 0, 1, 0, 526, 0, 0, 350, 1, 526, 175, 4202, 65, 65, 3676, 87, 52, 35, 350, 87, 175, 3733, 1866
INVAR-6, Run: 030, P, 0, 1, 0, 0, 0, 1, 0, 526, 0, 0, 350, 1, 526, 175, 4712, 69, 69, 4186, 87, 62, 25, 350, 87, 175, 3281, 1640
INVAR-6, Run: 031, P, 0, 1, 0, 0, 0, 1, 0, 526, 0, 0, 350, 1, 526, 175, 4229, 82, 82, 3703, 87, 42, 45, 350, 87, 175, 3237, 1618
INVAR-6, Run: 032, P, 0, 1, 0, 0, 0, 1, 0, 526, 0, 0, 350, 1, 526, 175, 4433, 86, 86, 3907, 87, 58, 29, 350, 87, 175, 3963, 1981
INVAR-6, Run: 033, P, 0, 1, 0, 0, 0, 1, 0, 526, 0, 0, 350, 1, 526, 175, 4826, 81, 81, 4300, 87, 61, 26, 350, 87, 175, 3387, 1693
INVAR-6, Run: 034, P, 0, 1, 0, 0, 0, 1, 0, 526, 0, 0, 350, 1, 526, 175, 4296, 69, 69, 3770, 87, 53, 34, 350, 87, 175, 4107, 2053
INVAR-6, Run: 035, P, 0, 1, 0, 0, 0, 1, 0, 526, 0, 0, 350, 1, 526, 175, 4154, 56, 56, 3628, 87, 62, 25, 350, 87, 175, 5331, 2665
INVAR-6, Run: 036, P, 0, 1, 0, 0, 0, 1, 0, 526, 0, 0, 350, 1, 526, 175, 3860, 81, 81, 3334, 87, 56, 31, 350, 87, 175, 3485, 1742
INVAR-6, Run: 037, P, 0, 1, 0, 0, 0, 1, 0, 526, 0, 0, 350, 1, 526, 175, 3759, 62, 62, 3233, 87, 54, 33, 350, 87, 175, 2817, 1408
INVAR-6, Run: 038, P, 0, 1, 0, 0, 0, 1, 0, 526, 0, 0, 350, 1, 526, 175, 3488, 68, 68, 2962, 87, 55, 32, 350, 87, 175, 3685, 1842
INVAR-6, Run: 039, P, 0, 1, 0, 0, 0, 1, 0, 526, 0, 0, 350, 1, 526, 175, 4055, 54, 54, 3529, 87, 59, 28, 350, 87, 175, 4605, 2302
INVAR-6, Run: 040, P, 0, 1, 0, 0, 0, 1, 0, 526, 0, 0, 350, 1, 526, 175, 3877, 63, 63, 3351, 87, 58, 29, 350, 87, 175, 3735, 1867
INVAR-6, Run: 041, P, 0, 1, 0, 0, 0, 1, 0, 526, 0, 0, 350, 1, 526, 175, 3332, 78, 78, 2806, 87, 50, 37, 350, 87, 175, 3171, 1585
INVAR-6, Run: 042, P, 0, 1, 0, 0, 0, 1, 0, 526, 0, 0, 350, 1, 526, 175, 4193, 57, 57, 3667, 87, 54, 33, 350, 87, 175, 2591, 1295
INVAR-6, Run: 043, P, 0, 1, 0, 0, 0, 1, 0, 526, 0, 0, 350, 1, 526, 175, 3926, 60, 60, 3400, 87, 52, 35, 350, 87, 175, 3427, 1713
INVAR-6, Run: 044, P, 0, 1, 0, 0, 0, 1, 0, 526, 0, 0, 350, 1, 526, 175, 4177, 70, 70, 3651, 87, 63, 24, 350, 87, 175, 3237, 1618
INVAR-6, Run: 045, P, 0, 1, 0, 0, 0, 1, 0, 526, 0, 0, 350, 1, 526, 175, 4560, 67, 67, 4034, 87, 58, 29, 350, 87, 175, 3501, 1750
INVAR-6, Run: 046, P, 0, 1, 0, 0, 0, 1, 0, 526, 0, 0, 350, 1, 526, 175, 4623, 74, 74, 4097, 87, 49, 38, 350, 87, 175, 4135, 2067
INVAR-6, Run: 047, P, 0, 1, 0, 0, 0, 1, 0, 526, 0, 0, 350, 1, 526, 175, 5003, 64, 64, 4477, 87, 54, 33, 350, 87, 175, 3841, 1920
INVAR-6, Run: 048, P, 0, 1, 0, 0, 0, 1, 0, 526, 0, 0, 350, 1, 526, 175, 4128, 61, 61, 3602, 87, 65, 22, 350, 87, 175, 4883, 2441
INVAR-6, Run: 049, P, 0, 1, 0, 0, 0, 1, 0, 526, 0, 0, 350, 1, 526, 175, 3516, 80, 80, 2990, 87, 52, 35, 350, 87, 175, 3969, 1984
INVAR-6, Run: 050, P, 0, 1, 0, 0, 0, 1, 0, 526, 0, 0, 350, 1, 526, 175, 3371, 59, 59, 2845, 87, 54, 33, 350, 87, 175, 2869, 1434
INVAR-6, Run: 051, P, 0, 1, 0, 0, 0, 1, 0, 526, 0, 0, 350, 1, 526, 175, 5436, 60, 60, 4910, 87, 59, 28, 350, 87, 175, 4311, 2155
INVAR-6, Run: 052, P, 0, 1, 0, 0, 0, 1, 0, 526, 0, 0, 350, 1, 526, 175, 4150, 79, 79, 3624, 87, 54, 33, 350, 87, 175, 3883, 1941
INVAR-6, Run: 053, P, 0, 1, 0, 0, 0, 1, 0, 526, 0, 0, 350, 1, 526, 175, 3354, 59, 59, 2828, 87, 59, 28, 350, 87, 175, 2963, 1481
INVAR-6, Run: 054, P, 0, 1, 0, 0, 0, 1, 0, 526, 0, 0, 350, 1, 526, 175, 3965, 44, 44, 3439, 87, 56, 31, 350, 87, 175, 3075, 1537
INVAR-6, Run: 055, P, 0, 1, 0, 0, 0, 1, 0, 526, 0, 0, 350, 1, 526, 175, 3634, 64, 64, 3108, 87, 59, 28, 350, 87, 175, 3449, 1724
INVAR-6, Run: 056, P, 0, 1, 0, 0, 0, 1, 0, 526, 0, 0, 350, 1, 526, 175, 4637, 49, 49, 4111, 87, 54, 33, 350, 87, 175, 3261, 1630
INVAR-6, Run: 057, P, 0, 1, 0, 0, 0, 1, 0, 526, 0, 0, 350, 1, 526, 175, 4467, 72, 72, 3941, 87, 67, 20, 350, 87, 175, 3047, 1523
INVAR-6, Run: 058, P, 0, 1, 0, 0, 0, 1, 0, 526, 0, 0, 350, 1, 526, 175, 4402, 68, 68, 3876, 87, 60, 27, 350, 87, 175, 2917, 1458
INVAR-6, Run: 059, P, 0, 1, 0, 0, 0, 1, 0, 526, 0, 0, 350, 1, 526, 175, 3972, 77, 77, 3446, 87, 62, 25, 350, 87, 175, 3241, 1620
INVAR-6, Run: 060, P, 0, 1, 0, 0, 0, 1, 0, 526, 0, 0, 350, 1, 526, 175, 4752, 59, 59, 4226, 87, 56, 31, 350, 87, 175, 3145, 1572
INVAR-6, Run: 061, P, 0, 1, 0, 0, 0, 1, 0, 526, 0, 0, 350, 1, 526, 175, 4143, 53, 53, 3617, 87, 50, 37, 350, 87, 175, 3149, 1574
INVAR-6, Run: 062, P, 0, 1, 0, 0, 0, 1, 0, 526, 0, 0, 350, 1, 526, 175, 5034, 76, 76, 4508, 87, 45, 42, 350, 87, 175, 3929, 1964
INVAR-6, Run: 063, P, 0, 1, 0, 0, 0, 1, 0, 526, 0, 0, 350, 1, 526, 175, 3531, 52, 52, 3005, 87, 59, 28, 350, 87, 175, 3585, 1792
INVAR-6, Run: 064, P, 0, 1, 0, 0, 0, 1, 0, 526, 0, 0, 350, 1, 526, 175, 4389, 68, 68, 3863, 87, 50, 37, 350, 87, 175, 3831, 1915
INVAR-6, Run: 065, P, 0, 1, 0, 0, 0, 1, 0, 526, 0, 0, 350, 1, 526, 175, 5532, 82, 82, 5006, 87, 59, 28, 350, 87, 175, 4471, 2235
INVAR-6, Run: 066, P, 0, 1, 0, 0, 0, 1, 0, 526, 0, 0, 350, 1, 526, 175, 3804, 66, 66, 3278, 87, 55, 32, 350, 87, 175, 2969, 1484
INVAR-6, Run: 067, P, 0, 1, 0, 0, 0, 1, 0, 526, 0, 0, 350, 1, 526, 175, 3914, 76, 76, 3388, 87, 40, 47, 350, 87, 175, 3577, 1788
INVAR-6, Run: 068, P, 0, 1, 0, 0, 0, 1, 0, 526, 0, 0, 350, 1, 526, 175, 3299, 62, 62, 2773, 87, 50, 37, 350, 87, 175, 2727, 1363
INVAR-6, Run: 069, P, 0, 1, 0, 0, 0, 1, 0, 526, 0, 0, 350, 1, 526, 175, 5007, 75, 75, 4481, 87, 49, 38, 350, 87, 175, 4023, 2011
INVAR-6, Run: 070, P, 0, 1, 0, 0, 0, 1, 0, 526, 0, 0, 350, 1, 526, 175, 4067, 75, 75, 3541, 87, 63, 24, 350, 87, 175, 3703, 1851
INVAR-6, Run: 071, P, 0, 1, 0, 0, 0, 1, 0, 526, 0, 0, 350, 1, 526, 175, 6567, 81, 81, 6041, 87, 49, 38, 350, 87, 175, 2433, 1216
INVAR-6, Run: 072, P, 0, 1, 0, 0, 0, 1, 0, 526, 0, 0, 350, 1, 526, 175, 4862, 70, 70, 4336, 87, 53, 34, 350, 87, 175, 3773, 1886
INVAR-6, Run: 073, P, 0, 1, 0, 0, 0, 1, 0, 526, 0, 0, 350, 1, 526, 175, 5177, 77, 77, 4651, 87, 57, 30, 350, 87, 175, 2929, 1464
INVAR-6, Run: 074, P, 0, 1, 0, 0, 0, 1, 0, 526, 0, 0, 350, 1, 526, 175, 3660, 62, 62, 3134, 87, 59, 28, 350, 87, 175, 2933, 1466
INVAR-6, Run: 075, P, 0, 1, 0, 0, 0, 1, 0, 526, 0, 0, 350, 1, 526, 175, 3913, 71, 71, 3387, 87, 55, 32, 350, 87, 175, 4119, 2059
INVAR-6, Run: 076, P, 0, 1, 0, 0, 0, 1, 0, 526, 0, 0, 350, 1, 526, 175, 5469, 72, 72, 4943, 87, 54, 33, 350, 87, 175, 4091, 2045
INVAR-6, Run: 077, P, 0, 1, 0, 0, 0, 1, 0, 526, 0, 0, 350, 1, 526, 175, 3824, 58, 58, 3298, 87, 57, 30, 350, 87, 175, 5217, 2608
INVAR-6, Run: 078, P, 0, 1, 0, 0, 0, 1, 0, 526, 0, 0, 350, 1, 526, 175, 3053, 65, 65, 2527, 87, 62, 25, 350, 87, 175, 2945, 1472
INVAR-6, Run: 079, P, 0, 1, 0, 0, 0, 1, 0, 526, 0, 0, 350, 1, 526, 175, 3479, 60, 60, 2953, 87, 62, 25, 350, 87, 175, 3481, 1740
INVAR-6, Run: 080, P, 0, 1, 0, 0, 0, 1, 0, 526, 0, 0, 350, 1, 526, 175, 4271, 72, 72, 3745, 87, 65, 22, 350, 87, 175, 2287, 1143
INVAR-6, Run: 081, P, 0, 1, 0, 0, 0, 1, 0, 526, 0, 0, 350, 1, 526, 175, 5373, 71, 71, 4847, 87, 51, 36, 350, 87, 175, 4613, 2306
INVAR-6, Run: 082, P, 0, 1, 0, 0, 0, 1, 0, 526, 0, 0, 350, 1, 526, 175, 4999, 58, 58, 4473, 87, 65, 22, 350, 87, 175, 3837, 1918
INVAR-6, Run: 083, P, 0, 1, 0, 0, 0, 1, 0, 526, 0, 0, 350, 1, 526, 175, 4186, 76, 76, 3660, 87, 51, 36, 350, 87, 175, 3643, 1821
INVAR-6, Run: 084, P, 0, 1, 0, 0, 0, 1, 0, 526, 0, 0, 350, 1, 526, 175, 4531, 84, 84, 4005, 87, 56, 31, 350, 87, 175, 2931, 1465
INVAR-6, Run: 085, P, 0, 1, 0, 0, 0, 1, 0, 526, 0, 0, 350, 1, 526, 175, 5270, 65, 65, 4744, 87, 60, 27, 350, 87, 175, 3413, 1706
INVAR-6, Run: 086, P, 0, 1, 0, 0, 0, 1, 0, 526, 0, 0, 350, 1, 526, 175, 4161, 64, 64, 3635, 87, 52, 35, 350, 87, 175, 4143, 2071
INVAR-6, Run: 087, P, 0, 1, 0, 0, 0, 1, 0, 526, 0, 0, 350, 1, 526, 175, 3650, 63, 63, 3124, 87, 55, 32, 350, 87, 175, 3707, 1853
INVAR-6, Run: 088, P, 0, 1, 0, 0, 0, 1, 0, 526, 0, 0, 350, 1, 526, 175, 4103, 65, 65, 3577, 87, 55, 32, 350, 87, 175, 4263, 2131
INVAR-6, Run: 089, P, 0, 1, 0, 0, 0, 1, 0, 526, 0, 0, 350, 1, 526, 175, 3662, 71, 71, 3136, 87, 48, 39, 350, 87, 175, 3975, 1987
INVAR-6, Run: 090, P, 0, 1, 0, 0, 0, 1, 0, 526, 0, 0, 350, 1, 526, 175, 4519, 75, 75, 3993, 87, 55, 32, 350, 87, 175, 3363, 1681
INVAR-6, Run: 091, P, 0, 1, 0, 0, 0, 1, 0, 526, 0, 0, 350, 1, 526, 175, 3977, 72, 72, 3451, 87, 61, 26, 350, 87, 175, 3533, 1766
INVAR-6, Run: 092, P, 0, 1, 0, 0, 0, 1, 0, 526, 0, 0, 350, 1, 526, 175, 3163, 71, 71, 2637, 87, 47, 40, 350, 87, 175, 3541, 1770
INVAR-6, Run: 093, P, 0, 1, 0, 0, 0, 1, 0, 526, 0, 0, 350, 1, 526, 175, 3314, 53, 53, 2788, 87, 53, 34, 350, 87, 175, 3681, 1840
INVAR-6, Run: 094, P, 0, 1, 0, 0, 0, 1, 0, 526, 0, 0, 350, 1, 526, 175, 4036, 67, 67, 3510, 87, 55, 32, 350, 87, 175, 3475, 1737
INVAR-6, Run: 095, P, 0, 1, 0, 0, 0, 1, 0, 526, 0, 0, 350, 1, 526, 175, 4173, 61, 61, 3647, 87, 62, 25, 350, 87, 175, 3617, 1808
INVAR-6, Run: 096, P, 0, 1, 0, 0, 0, 1, 0, 526, 0, 0, 350, 1, 526, 175, 4215, 80, 80, 3689, 87, 53, 34, 350, 87, 175, 3697, 1848
INVAR-6, Run: 097, P, 0, 1, 0, 0, 0, 1, 0, 526, 0, 0, 350, 1, 526, 175, 4487, 60, 60, 3961, 87, 61, 26, 350, 87, 175, 2723, 1361
INVAR-6, Run: 098, P, 0, 1, 0, 0, 0, 1, 0, 526, 0, 0, 350, 1, 526, 175, 4233, 61, 61, 3707, 87, 54, 33, 350, 87, 175, 3703, 1851
INVAR-6, Run: 099, P, 0, 1, 0, 0, 0, 1, 0, 526, 0, 0, 350, 1, 526, 175, 5240, 98, 98, 4714, 87, 54, 33, 350, 87, 175, 4047, 2023
INVAR-6, Run: 100, P, 0, 1, 0, 0, 0, 1, 0, 526, 0, 0, 350, 1, 526, 175, 3700, 75, 75, 3174, 87, 52, 35, 350, 87, 175, 2913, 1456
INVAR-7, Run: 001, P, 0, 0, 0, 0, 0, 0, 0, 0, 0, 0, 0, 0, 0, 0, 0, 0, 0, 0, 0, 0, 0, 0, 0, 0, 0, 0
INVAR-7, Run: 002, P, 0, 0, 0, 0, 0, 0, 0, 0, 0, 0, 0, 0, 0, 0, 0, 0, 0, 0, 0, 0, 0, 0, 0, 0, 0, 0
INVAR-7, Run: 003, P, 0, 0, 0, 0, 0, 0, 0, 0, 0, 0, 0, 0, 0, 0, 0, 0, 0, 0, 0, 0, 0, 0, 0, 0, 0, 0
INVAR-7, Run: 004, P, 0, 0, 0, 0, 0, 0, 0, 0, 0, 0, 0, 0, 0, 0, 0, 0, 0, 0, 0, 0, 0, 0, 0, 0, 0, 0
INVAR-7, Run: 005, P, 0, 0, 0, 0, 0, 0, 0, 0, 0, 0, 0, 0, 0, 0, 0, 0, 0, 0, 0, 0, 0, 0, 0, 0, 0, 0
INVAR-7, Run: 006, P, 0, 0, 0, 0, 0, 0, 0, 0, 0, 0, 0, 0, 0, 0, 0, 0, 0, 0, 0, 0, 0, 0, 0, 0, 0, 0
INVAR-7, Run: 007, P, 0, 0, 0, 0, 0, 0, 0, 0, 0, 0, 0, 0, 0, 0, 0, 0, 0, 0, 0, 0, 0, 0, 0, 0, 0, 0
INVAR-7, Run: 008, P, 0, 0, 0, 0, 0, 0, 0, 0, 0, 0, 0, 0, 0, 0, 0, 0, 0, 0, 0, 0, 0, 0, 0, 0, 0, 0
INVAR-7, Run: 009, P, 0, 0, 0, 0, 0, 0, 0, 0, 0, 0, 0, 0, 0, 0, 0, 0, 0, 0, 0, 0, 0, 0, 0, 0, 0, 0
INVAR-7, Run: 010, P, 0, 0, 0, 0, 0, 0, 0, 0, 0, 0, 0, 0, 0, 0, 0, 0, 0, 0, 0, 0, 0, 0, 0, 0, 0, 0
INVAR-7, Run: 011, P, 0, 0, 0, 0, 0, 0, 0, 0, 0, 0, 0, 0, 0, 0, 0, 0, 0, 0, 0, 0, 0, 0, 0, 0, 0, 0
INVAR-7, Run: 012, P, 0, 0, 0, 0, 0, 0, 0, 0, 0, 0, 0, 0, 0, 0, 0, 0, 0, 0, 0, 0, 0, 0, 0, 0, 0, 0
INVAR-7, Run: 013, P, 0, 0, 0, 0, 0, 0, 0, 0, 0, 0, 0, 0, 0, 0, 0, 0, 0, 0, 0, 0, 0, 0, 0, 0, 0, 0
INVAR-7, Run: 014, P, 0, 0, 0, 0, 0, 0, 0, 0, 0, 0, 0, 0, 0, 0, 0, 0, 0, 0, 0, 0, 0, 0, 0, 0, 0, 0
INVAR-7, Run: 015, P, 0, 0, 0, 0, 0, 0, 0, 0, 0, 0, 0, 0, 0, 0, 0, 0, 0, 0, 0, 0, 0, 0, 0, 0, 0, 0
INVAR-7, Run: 016, P, 0, 0, 0, 0, 0, 0, 0, 0, 0, 0, 0, 0, 0, 0, 0, 0, 0, 0, 0, 0, 0, 0, 0, 0, 0, 0
INVAR-7, Run: 017, P, 0, 0, 0, 0, 0, 0, 0, 0, 0, 0, 0, 0, 0, 0, 0, 0, 0, 0, 0, 0, 0, 0, 0, 0, 0, 0
INVAR-7, Run: 018, P, 0, 0, 0, 0, 0, 0, 0, 0, 0, 0, 0, 0, 0, 0, 0, 0, 0, 0, 0, 0, 0, 0, 0, 0, 0, 0
INVAR-7, Run: 019, P, 0, 0, 0, 0, 0, 0, 0, 0, 0, 0, 0, 0, 0, 0, 0, 0, 0, 0, 0, 0, 0, 0, 0, 0, 0, 0
INVAR-7, Run: 020, P, 0, 0, 0, 0, 0, 0, 0, 0, 0, 0, 0, 0, 0, 0, 0, 0, 0, 0, 0, 0, 0, 0, 0, 0, 0, 0
INVAR-7, Run: 021, P, 0, 0, 0, 0, 0, 0, 0, 0, 0, 0, 0, 0, 0, 0, 0, 0, 0, 0, 0, 0, 0, 0, 0, 0, 0, 0
INVAR-7, Run: 022, P, 0, 0, 0, 0, 0, 0, 0, 0, 0, 0, 0, 0, 0, 0, 0, 0, 0, 0, 0, 0, 0, 0, 0, 0, 0, 0
INVAR-7, Run: 023, P, 0, 0, 0, 0, 0, 0, 0, 0, 0, 0, 0, 0, 0, 0, 0, 0, 0, 0, 0, 0, 0, 0, 0, 0, 0, 0
INVAR-7, Run: 024, P, 0, 0, 0, 0, 0, 0, 0, 0, 0, 0, 0, 0, 0, 0, 0, 0, 0, 0, 0, 0, 0, 0, 0, 0, 0, 0
INVAR-7, Run: 025, P, 0, 0, 0, 0, 0, 0, 0, 0, 0, 0, 0, 0, 0, 0, 0, 0, 0, 0, 0, 0, 0, 0, 0, 0, 0, 0
INVAR-7, Run: 026, P, 0, 0, 0, 0, 0, 0, 0, 0, 0, 0, 0, 0, 0, 0, 0, 0, 0, 0, 0, 0, 0, 0, 0, 0, 0, 0
INVAR-7, Run: 027, P, 0, 0, 0, 0, 0, 0, 0, 0, 0, 0, 0, 0, 0, 0, 0, 0, 0, 0, 0, 0, 0, 0, 0, 0, 0, 0
INVAR-7, Run: 028, P, 0, 0, 0, 0, 0, 0, 0, 0, 0, 0, 0, 0, 0, 0, 0, 0, 0, 0, 0, 0, 0, 0, 0, 0, 0, 0
INVAR-7, Run: 029, P, 0, 0, 0, 0, 0, 0, 0, 0, 0, 0, 0, 0, 0, 0, 0, 0, 0, 0, 0, 0, 0, 0, 0, 0, 0, 0
INVAR-7, Run: 030, P, 0, 0, 0, 0, 0, 0, 0, 0, 0, 0, 0, 0, 0, 0, 0, 0, 0, 0, 0, 0, 0, 0, 0, 0, 0, 0
INVAR-7, Run: 031, P, 0, 0, 0, 0, 0, 0, 0, 0, 0, 0, 0, 0, 0, 0, 0, 0, 0, 0, 0, 0, 0, 0, 0, 0, 0, 0
INVAR-7, Run: 032, P, 0, 0, 0, 0, 0, 0, 0, 0, 0, 0, 0, 0, 0, 0, 0, 0, 0, 0, 0, 0, 0, 0, 0, 0, 0, 0
INVAR-7, Run: 033, P, 0, 0, 0, 0, 0, 0, 0, 0, 0, 0, 0, 0, 0, 0, 0, 0, 0, 0, 0, 0, 0, 0, 0, 0, 0, 0
INVAR-7, Run: 034, P, 0, 0, 0, 0, 0, 0, 0, 0, 0, 0, 0, 0, 0, 0, 0, 0, 0, 0, 0, 0, 0, 0, 0, 0, 0, 0
INVAR-7, Run: 035, P, 0, 0, 0, 0, 0, 0, 0, 0, 0, 0, 0, 0, 0, 0, 0, 0, 0, 0, 0, 0, 0, 0, 0, 0, 0, 0
INVAR-7, Run: 036, P, 0, 0, 0, 0, 0, 0, 0, 0, 0, 0, 0, 0, 0, 0, 0, 0, 0, 0, 0, 0, 0, 0, 0, 0, 0, 0
INVAR-7, Run: 037, P, 0, 0, 0, 0, 0, 0, 0, 0, 0, 0, 0, 0, 0, 0, 0, 0, 0, 0, 0, 0, 0, 0, 0, 0, 0, 0
INVAR-7, Run: 038, P, 0, 0, 0, 0, 0, 0, 0, 0, 0, 0, 0, 0, 0, 0, 0, 0, 0, 0, 0, 0, 0, 0, 0, 0, 0, 0
INVAR-7, Run: 039, P, 0, 0, 0, 0, 0, 0, 0, 0, 0, 0, 0, 0, 0, 0, 0, 0, 0, 0, 0, 0, 0, 0, 0, 0, 0, 0
INVAR-7, Run: 040, P, 0, 0, 0, 0, 0, 0, 0, 0, 0, 0, 0, 0, 0, 0, 0, 0, 0, 0, 0, 0, 0, 0, 0, 0, 0, 0
INVAR-7, Run: 041, P, 0, 0, 0, 0, 0, 0, 0, 0, 0, 0, 0, 0, 0, 0, 0, 0, 0, 0, 0, 0, 0, 0, 0, 0, 0, 0
INVAR-7, Run: 042, P, 0, 0, 0, 0, 0, 0, 0, 0, 0, 0, 0, 0, 0, 0, 0, 0, 0, 0, 0, 0, 0, 0, 0, 0, 0, 0
INVAR-7, Run: 043, P, 0, 0, 0, 0, 0, 0, 0, 0, 0, 0, 0, 0, 0, 0, 0, 0, 0, 0, 0, 0, 0, 0, 0, 0, 0, 0
INVAR-7, Run: 044, P, 0, 0, 0, 0, 0, 0, 0, 0, 0, 0, 0, 0, 0, 0, 0, 0, 0, 0, 0, 0, 0, 0, 0, 0, 0, 0
INVAR-7, Run: 045, P, 0, 0, 0, 0, 0, 0, 0, 0, 0, 0, 0, 0, 0, 0, 0, 0, 0, 0, 0, 0, 0, 0, 0, 0, 0, 0
INVAR-7, Run: 046, P, 0, 0, 0, 0, 0, 0, 0, 0, 0, 0, 0, 0, 0, 0, 0, 0, 0, 0, 0, 0, 0, 0, 0, 0, 0, 0
INVAR-7, Run: 047, P, 0, 0, 0, 0, 0, 0, 0, 0, 0, 0, 0, 0, 0, 0, 0, 0, 0, 0, 0, 0, 0, 0, 0, 0, 0, 0
INVAR-7, Run: 048, P, 0, 0, 0, 0, 0, 0, 0, 0, 0, 0, 0, 0, 0, 0, 0, 0, 0, 0, 0, 0, 0, 0, 0, 0, 0, 0
INVAR-7, Run: 049, P, 0, 0, 0, 0, 0, 0, 0, 0, 0, 0, 0, 0, 0, 0, 0, 0, 0, 0, 0, 0, 0, 0, 0, 0, 0, 0
INVAR-7, Run: 050, P, 0, 0, 0, 0, 0, 0, 0, 0, 0, 0, 0, 0, 0, 0, 0, 0, 0, 0, 0, 0, 0, 0, 0, 0, 0, 0
INVAR-7, Run: 051, P, 0, 0, 0, 0, 0, 0, 0, 0, 0, 0, 0, 0, 0, 0, 0, 0, 0, 0, 0, 0, 0, 0, 0, 0, 0, 0
INVAR-7, Run: 052, P, 0, 0, 0, 0, 0, 0, 0, 0, 0, 0, 0, 0, 0, 0, 0, 0, 0, 0, 0, 0, 0, 0, 0, 0, 0, 0
INVAR-7, Run: 053, P, 0, 0, 0, 0, 0, 0, 0, 0, 0, 0, 0, 0, 0, 0, 0, 0, 0, 0, 0, 0, 0, 0, 0, 0, 0, 0
INVAR-7, Run: 054, P, 0, 0, 0, 0, 0, 0, 0, 0, 0, 0, 0, 0, 0, 0, 0, 0, 0, 0, 0, 0, 0, 0, 0, 0, 0, 0
INVAR-7, Run: 055, P, 0, 0, 0, 0, 0, 0, 0, 0, 0, 0, 0, 0, 0, 0, 0, 0, 0, 0, 0, 0, 0, 0, 0, 0, 0, 0
INVAR-7, Run: 056, P, 0, 0, 0, 0, 0, 0, 0, 0, 0, 0, 0, 0, 0, 0, 0, 0, 0, 0, 0, 0, 0, 0, 0, 0, 0, 0
INVAR-7, Run: 057, P, 0, 0, 0, 0, 0, 0, 0, 0, 0, 0, 0, 0, 0, 0, 0, 0, 0, 0, 0, 0, 0, 0, 0, 0, 0, 0
INVAR-7, Run: 058, P, 0, 0, 0, 0, 0, 0, 0, 0, 0, 0, 0, 0, 0, 0, 0, 0, 0, 0, 0, 0, 0, 0, 0, 0, 0, 0
INVAR-7, Run: 059, P, 0, 0, 0, 0, 0, 0, 0, 0, 0, 0, 0, 0, 0, 0, 0, 0, 0, 0, 0, 0, 0, 0, 0, 0, 0, 0
INVAR-7, Run: 060, P, 0, 0, 0, 0, 0, 0, 0, 0, 0, 0, 0, 0, 0, 0, 0, 0, 0, 0, 0, 0, 0, 0, 0, 0, 0, 0
INVAR-7, Run: 061, P, 0, 0, 0, 0, 0, 0, 0, 0, 0, 0, 0, 0, 0, 0, 0, 0, 0, 0, 0, 0, 0, 0, 0, 0, 0, 0
INVAR-7, Run: 062, P, 0, 0, 0, 0, 0, 0, 0, 0, 0, 0, 0, 0, 0, 0, 0, 0, 0, 0, 0, 0, 0, 0, 0, 0, 0, 0
INVAR-7, Run: 063, P, 0, 0, 0, 0, 0, 0, 0, 0, 0, 0, 0, 0, 0, 0, 0, 0, 0, 0, 0, 0, 0, 0, 0, 0, 0, 0
INVAR-7, Run: 064, P, 0, 0, 0, 0, 0, 0, 0, 0, 0, 0, 0, 0, 0, 0, 0, 0, 0, 0, 0, 0, 0, 0, 0, 0, 0, 0
INVAR-7, Run: 065, P, 0, 0, 0, 0, 0, 0, 0, 0, 0, 0, 0, 0, 0, 0, 0, 0, 0, 0, 0, 0, 0, 0, 0, 0, 0, 0
INVAR-7, Run: 066, P, 0, 0, 0, 0, 0, 0, 0, 0, 0, 0, 0, 0, 0, 0, 0, 0, 0, 0, 0, 0, 0, 0, 0, 0, 0, 0
INVAR-7, Run: 067, P, 0, 0, 0, 0, 0, 0, 0, 0, 0, 0, 0, 0, 0, 0, 0, 0, 0, 0, 0, 0, 0, 0, 0, 0, 0, 0
INVAR-7, Run: 068, P, 0, 0, 0, 0, 0, 0, 0, 0, 0, 0, 0, 0, 0, 0, 0, 0, 0, 0, 0, 0, 0, 0, 0, 0, 0, 0
INVAR-7, Run: 069, P, 0, 0, 0, 0, 0, 0, 0, 0, 0, 0, 0, 0, 0, 0, 0, 0, 0, 0, 0, 0, 0, 0, 0, 0, 0, 0
INVAR-7, Run: 070, P, 0, 0, 0, 0, 0, 0, 0, 0, 0, 0, 0, 0, 0, 0, 0, 0, 0, 0, 0, 0, 0, 0, 0, 0, 0, 0
INVAR-7, Run: 071, P, 0, 0, 0, 0, 0, 0, 0, 0, 0, 0, 0, 0, 0, 0, 0, 0, 0, 0, 0, 0, 0, 0, 0, 0, 0, 0
INVAR-7, Run: 072, P, 0, 0, 0, 0, 0, 0, 0, 0, 0, 0, 0, 0, 0, 0, 0, 0, 0, 0, 0, 0, 0, 0, 0, 0, 0, 0
INVAR-7, Run: 073, P, 0, 0, 0, 0, 0, 0, 0, 0, 0, 0, 0, 0, 0, 0, 0, 0, 0, 0, 0, 0, 0, 0, 0, 0, 0, 0
INVAR-7, Run: 074, P, 0, 0, 0, 0, 0, 0, 0, 0, 0, 0, 0, 0, 0, 0, 0, 0, 0, 0, 0, 0, 0, 0, 0, 0, 0, 0
INVAR-7, Run: 075, P, 0, 0, 0, 0, 0, 0, 0, 0, 0, 0, 0, 0, 0, 0, 0, 0, 0, 0, 0, 0, 0, 0, 0, 0, 0, 0
INVAR-7, Run: 076, P, 0, 0, 0, 0, 0, 0, 0, 0, 0, 0, 0, 0, 0, 0, 0, 0, 0, 0, 0, 0, 0, 0, 0, 0, 0, 0
INVAR-7, Run: 077, P, 0, 0, 0, 0, 0, 0, 0, 0, 0, 0, 0, 0, 0, 0, 0, 0, 0, 0, 0, 0, 0, 0, 0, 0, 0, 0
INVAR-7, Run: 078, P, 0, 0, 0, 0, 0, 0, 0, 0, 0, 0, 0, 0, 0, 0, 0, 0, 0, 0, 0, 0, 0, 0, 0, 0, 0, 0
INVAR-7, Run: 079, P, 0, 0, 0, 0, 0, 0, 0, 0, 0, 0, 0, 0, 0, 0, 0, 0, 0, 0, 0, 0, 0, 0, 0, 0, 0, 0
INVAR-7, Run: 080, P, 0, 0, 0, 0, 0, 0, 0, 0, 0, 0, 0, 0, 0, 0, 0, 0, 0, 0, 0, 0, 0, 0, 0, 0, 0, 0
INVAR-7, Run: 081, P, 0, 0, 0, 0, 0, 0, 0, 0, 0, 0, 0, 0, 0, 0, 0, 0, 0, 0, 0, 0, 0, 0, 0, 0, 0, 0
INVAR-7, Run: 082, P, 0, 0, 0, 0, 0, 0, 0, 0, 0, 0, 0, 0, 0, 0, 0, 0, 0, 0, 0, 0, 0, 0, 0, 0, 0, 0
INVAR-7, Run: 083, P, 0, 0, 0, 0, 0, 0, 0, 0, 0, 0, 0, 0, 0, 0, 0, 0, 0, 0, 0, 0, 0, 0, 0, 0, 0, 0
INVAR-7, Run: 084, P, 0, 0, 0, 0, 0, 0, 0, 0, 0, 0, 0, 0, 0, 0, 0, 0, 0, 0, 0, 0, 0, 0, 0, 0, 0, 0
INVAR-7, Run: 085, P, 0, 0, 0, 0, 0, 0, 0, 0, 0, 0, 0, 0, 0, 0, 0, 0, 0, 0, 0, 0, 0, 0, 0, 0, 0, 0
INVAR-7, Run: 086, P, 0, 0, 0, 0, 0, 0, 0, 0, 0, 0, 0, 0, 0, 0, 0, 0, 0, 0, 0, 0, 0, 0, 0, 0, 0, 0
INVAR-7, Run: 087, P, 0, 0, 0, 0, 0, 0, 0, 0, 0, 0, 0, 0, 0, 0, 0, 0, 0, 0, 0, 0, 0, 0, 0, 0, 0, 0
INVAR-7, Run: 088, P, 0, 0, 0, 0, 0, 0, 0, 0, 0, 0, 0, 0, 0, 0, 0, 0, 0, 0, 0, 0, 0, 0, 0, 0, 0, 0
INVAR-7, Run: 089, P, 0, 0, 0, 0, 0, 0, 0, 0, 0, 0, 0, 0, 0, 0, 0, 0, 0, 0, 0, 0, 0, 0, 0, 0, 0, 0
INVAR-7, Run: 090, P, 0, 0, 0, 0, 0, 0, 0, 0, 0, 0, 0, 0, 0, 0, 0, 0, 0, 0, 0, 0, 0, 0, 0, 0, 0, 0
INVAR-7, Run: 091, P, 0, 0, 0, 0, 0, 0, 0, 0, 0, 0, 0, 0, 0, 0, 0, 0, 0, 0, 0, 0, 0, 0, 0, 0, 0, 0
INVAR-7, Run: 092, P, 0, 0, 0, 0, 0, 0, 0, 0, 0, 0, 0, 0, 0, 0, 0, 0, 0, 0, 0, 0, 0, 0, 0, 0, 0, 0
INVAR-7, Run: 093, P, 0, 0, 0, 0, 0, 0, 0, 0, 0, 0, 0, 0, 0, 0, 0, 0, 0, 0, 0, 0, 0, 0, 0, 0, 0, 0
INVAR-7, Run: 094, P, 0, 0, 0, 0, 0, 0, 0, 0, 0, 0, 0, 0, 0, 0, 0, 0, 0, 0, 0, 0, 0, 0, 0, 0, 0, 0
INVAR-7, Run: 095, P, 0, 0, 0, 0, 0, 0, 0, 0, 0, 0, 0, 0, 0, 0, 0, 0, 0, 0, 0, 0, 0, 0, 0, 0, 0, 0
INVAR-7, Run: 096, P, 0, 0, 0, 0, 0, 0, 0, 0, 0, 0, 0, 0, 0, 0, 0, 0, 0, 0, 0, 0, 0, 0, 0, 0, 0, 0
INVAR-7, Run: 097, P, 0, 0, 0, 0, 0, 0, 0, 0, 0, 0, 0, 0, 0, 0, 0, 0, 0, 0, 0, 0, 0, 0, 0, 0, 0, 0
INVAR-7, Run: 098, P, 0, 0, 0, 0, 0, 0, 0, 0, 0, 0, 0, 0, 0, 0, 0, 0, 0, 0, 0, 0, 0, 0, 0, 0, 0, 0
INVAR-7, Run: 099, P, 0, 0, 0, 0, 0, 0, 0, 0, 0, 0, 0, 0, 0, 0, 0, 0, 0, 0, 0, 0, 0, 0, 0, 0, 0, 0
INVAR-7, Run: 100, P, 0, 0, 0, 0, 0, 0, 0, 0, 0, 0, 0, 0, 0, 0, 0, 0, 0, 0, 0, 0, 0, 0, 0, 0, 0, 0
INVAR-8, Run: 001, P, 0, 0, 0, 0, 0, 0, 116, 34, 1, 1, 42, 0, 35, 50, 529, 15, 14, 495, 25, 16, 8, 42, 25, 50, 446, 223
INVAR-8, Run: 002, P, 0, 0, 0, 0, 0, 0, 118, 32, 1, 2, 41, 0, 34, 50, 417, 11, 9, 385, 25, 20, 4, 41, 25, 50, 640, 320
INVAR-8, Run: 003, P, 0, 0, 0, 0, 0, 0, 106, 44, 1, 2, 47, 0, 46, 50, 520, 23, 21, 476, 25, 13, 11, 47, 25, 50, 626, 313
INVAR-8, Run: 004, P, 0, 0, 0, 0, 0, 0, 68, 82, 1, 1, 66, 0, 83, 50, 604, 18, 17, 522, 25, 16, 8, 66, 25, 50, 632, 316
INVAR-8, Run: 005, P, 0, 0, 0, 0, 0, 0, 94, 56, 1, 2, 53, 0, 58, 50, 448, 29, 27, 392, 25, 16, 8, 53, 25, 50, 1002, 501
INVAR-8, Run: 006, P, 0, 0, 0, 0, 0, 0, 120, 30, 1, 1, 40, 0, 31, 50, 445, 19, 18, 415, 25, 18, 6, 40, 25, 50, 360, 180
INVAR-8, Run: 007, P, 0, 0, 0, 0, 0, 0, 52, 98, 1, 1, 74, 0, 99, 50, 633, 17, 16, 535, 25, 17, 7, 74, 25, 50, 400, 200
INVAR-8, Run: 008, P, 0, 0, 0, 0, 0, 0, 114, 36, 1, 1, 43, 0, 37, 50, 555, 12, 11, 519, 25, 21, 3, 43, 25, 50, 996, 498
INVAR-8, Run: 009, P, 0, 0, 0, 0, 0, 0, 128, 22, 1, 1, 36, 0, 23, 50, 427, 14, 13, 405, 25, 19, 5, 36, 25, 50, 750, 375
INVAR-8, Run: 010, P, 0, 0, 0, 0, 0, 0, 104, 46, 1, 3, 48, 0, 49, 50, 602, 21, 18, 556, 25, 18, 6, 48, 25, 50, 592, 296
INVAR-8, Run: 011, P, 0, 0, 0, 0, 0, 0, 120, 30, 1, 4, 40, 0, 34, 50, 414, 22, 18, 384, 25, 14, 10, 40, 25, 50, 884, 442
INVAR-8, Run: 012, P, 0, 0, 0, 0, 0, 0, 70, 80, 1, 1, 65, 0, 81, 50, 572, 19, 18, 492, 25, 15, 9, 65, 25, 50, 586, 293
INVAR-8, Run: 013, P, 0, 0, 0, 0, 0, 0, 38, 112, 1, 1, 81, 0, 113, 50, 425, 21, 20, 313, 25, 15, 9, 81, 25, 50, 192, 96
INVAR-8, Run: 014, P, 0, 0, 0, 0, 0, 0, 50, 100, 1, 1, 75, 0, 101, 50, 512, 17, 16, 412, 25, 17, 7, 75, 25, 50, 428, 214
INVAR-8, Run: 015, P, 0, 0, 0, 0, 0, 0, 114, 36, 1, 2, 43, 0, 38, 50, 455, 26, 24, 419, 25, 17, 7, 43, 25, 50, 284, 142
INVAR-8, Run: 016, P, 0, 0, 0, 0, 0, 0, 74, 76, 1, 0, 63, 0, 76, 50, 588, 18, 18, 512, 25, 17, 7, 63, 25, 50, 652, 326
INVAR-8, Run: 017, P, 0, 0, 0, 0, 0, 0, 124, 26, 1, 2, 38, 0, 28, 50, 704, 27, 25, 678, 25, 14, 10, 38, 25, 50, 1162, 581
INVAR-8, Run: 018, P, 0, 0, 0, 0, 0, 0, 136, 14, 1, 2, 32, 0, 16, 50, 303, 17, 15, 289, 25, 16, 8, 32, 25, 50, 904, 452
INVAR-8, Run: 019, P, 0, 0, 0, 0, 0, 0, 134, 16, 1, 3, 33, 0, 19, 50, 443, 19, 16, 427, 25, 15, 9, 33, 25, 50, 446, 223
INVAR-8, Run: 020, P, 0, 0, 0, 0, 0, 0, 108, 42, 1, 1, 46, 0, 43, 50, 429, 16, 15, 387, 25, 14, 10, 46, 25, 50, 906, 453
INVAR-8, Run: 021, P, 0, 0, 0, 0, 0, 0, 132, 18, 1, 2, 34, 0, 20, 50, 484, 17, 15, 466, 25, 13, 11, 34, 25, 50, 590, 295
INVAR-8, Run: 022, P, 0, 0, 0, 0, 0, 0, 110, 40, 1, 1, 45, 0, 41, 50, 766, 30, 29, 726, 25, 14, 10, 45, 25, 50, 1832, 916
INVAR-8, Run: 023, P, 0, 0, 0, 0, 0, 0, 112, 38, 1, 2, 44, 0, 40, 50, 268, 20, 18, 230, 25, 17, 7, 44, 25, 50, 282, 141
INVAR-8, Run: 024, P, 0, 0, 0, 0, 0, 0, 96, 54, 1, 1, 52, 0, 55, 50, 627, 15, 14, 573, 25, 18, 6, 52, 25, 50, 882, 441
INVAR-8, Run: 025, P, 0, 0, 0, 0, 0, 0, 76, 74, 1, 2, 62, 0, 76, 50, 459, 31, 29, 385, 25, 14, 10, 62, 25, 50, 500, 250
INVAR-8, Run: 026, P, 0, 0, 0, 0, 0, 0, 108, 42, 1, 2, 46, 0, 44, 50, 634, 31, 29, 592, 25, 12, 12, 46, 25, 50, 564, 282
INVAR-8, Run: 027, P, 0, 0, 0, 0, 0, 0, 108, 42, 1, 1, 46, 0, 43, 50, 717, 25, 24, 675, 25, 16, 8, 46, 25, 50, 354, 177
INVAR-8, Run: 028, P, 0, 0, 0, 0, 0, 0, 102, 48, 1, 2, 49, 0, 50, 50, 457, 18, 16, 409, 25, 20, 4, 49, 25, 50, 508, 254
INVAR-8, Run: 029, P, 0, 0, 0, 0, 0, 0, 134, 16, 1, 2, 33, 0, 18, 50, 299, 26, 24, 283, 25, 18, 6, 33, 25, 50, 460, 230
INVAR-8, Run: 030, P, 0, 0, 0, 0, 0, 0, 128, 22, 1, 3, 36, 0, 25, 50, 599, 23, 20, 577, 25, 14, 10, 36, 25, 50, 666, 333
INVAR-8, Run: 031, P, 0, 0, 0, 0, 0, 0, 128, 22, 1, 0, 36, 0, 22, 50, 429, 23, 23, 407, 25, 15, 9, 36, 25, 50, 346, 173
INVAR-8, Run: 032, P, 0, 0, 0, 0, 0, 0, 106, 44, 1, 3, 47, 0, 47, 50, 412, 30, 27, 368, 25, 17, 7, 47, 25, 50, 440, 220
INVAR-8, Run: 033, P, 0, 0, 0, 0, 0, 0, 70, 80, 1, 1, 65, 0, 81, 50, 599, 20, 19, 519, 25, 17, 7, 65, 25, 50, 514, 257
INVAR-8, Run: 034, P, 0, 0, 0, 0, 0, 0, 34, 116, 1, 1, 83, 0, 117, 50, 502, 17, 16, 386, 25, 13, 11, 83, 25, 50, 292, 146
INVAR-8, Run: 035, P, 0, 0, 0, 0, 0, 0, 80, 70, 1, 2, 60, 0, 72, 50, 646, 27, 25, 576, 25, 17, 7, 60, 25, 50, 694, 347
INVAR-8, Run: 036, P, 0, 0, 0, 0, 0, 0, 120, 30, 1, 2, 40, 0, 32, 50, 566, 14, 12, 536, 25, 19, 5, 40, 25, 50, 736, 368
INVAR-8, Run: 037, P, 0, 0, 0, 0, 0, 0, 74, 76, 1, 0, 63, 0, 76, 50, 521, 14, 14, 445, 25, 10, 14, 63, 25, 50, 456, 228
INVAR-8, Run: 038, P, 0, 0, 0, 0, 0, 0, 96, 54, 1, 1, 52, 0, 55, 50, 396, 18, 17, 342, 25, 14, 10, 52, 25, 50, 722, 361
INVAR-8, Run: 039, P, 0, 0, 0, 0, 0, 0, 52, 98, 1, 2, 74, 0, 100, 50, 433, 29, 27, 335, 25, 10, 14, 74, 25, 50, 446, 223
INVAR-8, Run: 040, P, 0, 0, 0, 0, 0, 0, 138, 12, 1, 3, 31, 0, 15, 50, 412, 24, 21, 400, 25, 18, 6, 31, 25, 50, 710, 355
INVAR-8, Run: 041, P, 0, 0, 0, 0, 0, 0, 144, 6, 1, 3, 28, 0, 9, 50, 240, 21, 18, 234, 25, 7, 17, 28, 25, 50, 790, 395
INVAR-8, Run: 042, P, 0, 0, 0, 0, 0, 0, 42, 108, 1, 3, 79, 0, 111, 50, 582, 28, 25, 474, 25, 15, 9, 79, 25, 50, 352, 176
INVAR-8, Run: 043, P, 0, 0, 0, 0, 0, 0, 94, 56, 1, 1, 53, 0, 57, 50, 522, 22, 21, 466, 25, 13, 11, 53, 25, 50, 502, 251
INVAR-8, Run: 044, P, 0, 0, 0, 0, 0, 0, 134, 16, 1, 1, 33, 0, 17, 50, 310, 20, 19, 294, 25, 18, 6, 33, 25, 50, 1008, 504
INVAR-8, Run: 045, P, 0, 0, 0, 0, 0, 0, 130, 20, 1, 0, 35, 0, 20, 50, 578, 26, 26, 558, 25, 16, 8, 35, 25, 50, 410, 205
INVAR-8, Run: 046, P, 0, 0, 0, 0, 0, 0, 88, 62, 1, 0, 56, 0, 62, 50, 688, 21, 21, 626, 25, 12, 12, 56, 25, 50, 1012, 506
INVAR-8, Run: 047, P, 0, 0, 0, 0, 0, 0, 56, 94, 1, 1, 72, 0, 95, 50, 728, 24, 23, 634, 25, 13, 11, 72, 25, 50, 326, 163
INVAR-8, Run: 048, P, 0, 0, 0, 0, 0, 0, 104, 46, 1, 1, 48, 0, 47, 50, 295, 11, 10, 249, 25, 18, 6, 48, 25, 50, 366, 183
INVAR-8, Run: 049, P, 0, 0, 0, 0, 0, 0, 124, 26, 1, 2, 38, 0, 28, 50, 432, 22, 20, 406, 25, 14, 10, 38, 25, 50, 768, 384
INVAR-8, Run: 050, P, 0, 0, 0, 0, 0, 0, 74, 76, 1, 2, 63, 0, 78, 50, 409, 15, 13, 333, 25, 18, 6, 63, 25, 50, 188, 94
INVAR-8, Run: 051, P, 0, 0, 0, 0, 0, 0, 124, 26, 1, 2, 38, 0, 28, 50, 346, 25, 23, 320, 25, 13, 11, 38, 25, 50, 470, 235
INVAR-8, Run: 052, P, 0, 0, 0, 0, 0, 0, 106, 44, 1, 0, 47, 0, 44, 50, 386, 20, 20, 342, 25, 22, 2, 47, 25, 50, 1112, 556
INVAR-8, Run: 053, P, 0, 0, 0, 0, 0, 0, 58, 92, 1, 2, 71, 0, 94, 50, 618, 14, 12, 526, 25, 20, 4, 71, 25, 50, 1306, 653
INVAR-8, Run: 054, P, 0, 0, 0, 0, 0, 0, 104, 46, 1, 3, 48, 0, 49, 50, 638, 30, 27, 592, 25, 12, 12, 48, 25, 50, 358, 179
INVAR-8, Run: 055, P, 0, 0, 0, 0, 0, 0, 124, 26, 1, 1, 38, 0, 27, 50, 602, 33, 32, 576, 25, 11, 13, 38, 25, 50, 304, 152
INVAR-8, Run: 056, P, 0, 0, 0, 0, 0, 0, 92, 58, 1, 4, 54, 0, 62, 50, 474, 25, 21, 416, 25, 16, 8, 54, 25, 50, 612, 306
INVAR-8, Run: 057, P, 0, 0, 0, 0, 0, 0, 132, 18, 1, 3, 34, 0, 21, 50, 593, 27, 24, 575, 25, 15, 9, 34, 25, 50, 420, 210
INVAR-8, Run: 058, P, 0, 0, 0, 0, 0, 0, 134, 16, 1, 4, 33, 0, 20, 50, 621, 24, 20, 605, 25, 18, 6, 33, 25, 50, 760, 380
INVAR-8, Run: 059, P, 0, 0, 0, 0, 0, 0, 54, 96, 1, 0, 73, 0, 96, 50, 427, 16, 16, 331, 25, 15, 9, 73, 25, 50, 870, 435
INVAR-8, Run: 060, P, 0, 0, 0, 0, 0, 0, 104, 46, 1, 2, 48, 0, 48, 50, 504, 19, 17, 458, 25, 12, 12, 48, 25, 50, 750, 375
INVAR-8, Run: 061, P, 0, 0, 0, 0, 0, 0, 90, 60, 1, 2, 55, 0, 62, 50, 913, 22, 20, 853, 25, 11, 13, 55, 25, 50, 522, 261
INVAR-8, Run: 062, P, 0, 0, 0, 0, 0, 0, 82, 68, 1, 1, 59, 0, 69, 50, 470, 24, 23, 402, 25, 15, 9, 59, 25, 50, 392, 196
INVAR-8, Run: 063, P, 0, 0, 0, 0, 0, 0, 98, 52, 1, 2, 51, 0, 54, 50, 386, 20, 18, 334, 25, 15, 9, 51, 25, 50, 542, 271
INVAR-8, Run: 064, P, 0, 0, 0, 0, 0, 0, 42, 108, 1, 3, 79, 0, 111, 50, 650, 28, 25, 542, 25, 13, 11, 79, 25, 50, 888, 444
INVAR-8, Run: 065, P, 0, 0, 0, 0, 0, 0, 56, 94, 1, 0, 72, 0, 94, 50, 618, 17, 17, 524, 25, 10, 14, 72, 25, 50, 848, 424
INVAR-8, Run: 066, P, 0, 0, 0, 0, 0, 0, 86, 64, 1, 1, 57, 0, 65, 50, 414, 33, 32, 350, 25, 15, 9, 57, 25, 50, 612, 306
INVAR-8, Run: 067, P, 0, 0, 0, 0, 0, 0, 36, 114, 1, 1, 82, 0, 115, 50, 490, 22, 21, 376, 25, 16, 8, 82, 25, 50, 504, 252
INVAR-8, Run: 068, P, 0, 0, 0, 0, 0, 0, 88, 62, 1, 3, 56, 0, 65, 50, 453, 29, 26, 391, 25, 16, 8, 56, 25, 50, 450, 225
INVAR-8, Run: 069, P, 0, 0, 0, 0, 0, 0, 82, 68, 1, 1, 59, 0, 69, 50, 402, 32, 31, 334, 25, 11, 13, 59, 25, 50, 494, 247
INVAR-8, Run: 070, P, 0, 0, 0, 0, 0, 0, 74, 76, 1, 2, 63, 0, 78, 50, 607, 19, 17, 531, 25, 17, 7, 63, 25, 50, 440, 220
INVAR-8, Run: 071, P, 0, 0, 0, 0, 0, 0, 110, 40, 1, 1, 45, 0, 41, 50, 360, 23, 22, 320, 25, 13, 11, 45, 25, 50, 744, 372
INVAR-8, Run: 072, P, 0, 0, 0, 0, 0, 0, 128, 22, 1, 1, 36, 0, 23, 50, 418, 21, 20, 396, 25, 15, 9, 36, 25, 50, 246, 123
INVAR-8, Run: 073, P, 0, 0, 0, 0, 0, 0, 108, 42, 1, 3, 46, 0, 45, 50, 467, 23, 20, 425, 25, 13, 11, 46, 25, 50, 652, 326
INVAR-8, Run: 074, P, 0, 0, 0, 0, 0, 0, 94, 56, 1, 0, 53, 0, 56, 50, 691, 12, 12, 635, 25, 19, 5, 53, 25, 50, 876, 438
INVAR-8, Run: 075, P, 0, 0, 0, 0, 0, 0, 106, 44, 1, 4, 47, 0, 48, 50, 356, 18, 14, 312, 25, 19, 5, 47, 25, 50, 430, 215
INVAR-8, Run: 076, P, 0, 0, 0, 0, 0, 0, 122, 28, 1, 1, 39, 0, 29, 50, 424, 21, 20, 396, 25, 13, 11, 39, 25, 50, 616, 308
INVAR-8, Run: 077, P, 0, 0, 0, 0, 0, 0, 144, 6, 1, 3, 28, 0, 9, 50, 269, 25, 22, 263, 25, 13, 11, 28, 25, 50, 344, 172
INVAR-8, Run: 078, P, 0, 0, 0, 0, 0, 0, 52, 98, 1, 3, 74, 0, 101, 50, 498, 18, 15, 400, 25, 16, 8, 74, 25, 50, 312, 156
INVAR-8, Run: 079, P, 0, 0, 0, 0, 0, 0, 122, 28, 1, 1, 39, 0, 29, 50, 370, 18, 17, 342, 25, 12, 12, 39, 25, 50, 386, 193
INVAR-8, Run: 080, P, 0, 0, 0, 0, 0, 0, 34, 116, 1, 0, 83, 0, 116, 50, 677, 15, 15, 561, 25, 11, 13, 83, 25, 50, 232, 116
INVAR-8, Run: 081, P, 0, 0, 0, 0, 0, 0, 100, 50, 1, 3, 50, 0, 53, 50, 535, 22, 19, 485, 25, 16, 8, 50, 25, 50, 670, 335
INVAR-8, Run: 082, P, 0, 0, 0, 0, 0, 0, 110, 40, 1, 3, 45, 0, 43, 50, 480, 25, 22, 440, 25, 14, 10, 45, 25, 50, 534, 267
INVAR-8, Run: 083, P, 0, 0, 0, 0, 0, 0, 118, 32, 1, 2, 41, 0, 34, 50, 644, 24, 22, 612, 25, 14, 10, 41, 25, 50, 532, 266
INVAR-8, Run: 084, P, 0, 0, 0, 0, 0, 0, 22, 128, 1, 3, 89, 0, 131, 50, 580, 25, 22, 452, 25, 16, 8, 89, 25, 50, 330, 165
INVAR-8, Run: 085, P, 0, 0, 0, 0, 0, 0, 58, 92, 1, 2, 71, 0, 94, 50, 512, 13, 11, 420, 25, 18, 6, 71, 25, 50, 528, 264
INVAR-8, Run: 086, P, 0, 0, 0, 0, 0, 0, 112, 38, 1, 1, 44, 0, 39, 50, 661, 32, 31, 623, 25, 13, 11, 44, 25, 50, 488, 244
INVAR-8, Run: 087, P, 0, 0, 0, 0, 0, 0, 96, 54, 1, 1, 52, 0, 55, 50, 359, 21, 20, 305, 25, 16, 8, 52, 25, 50, 406, 203
INVAR-8, Run: 088, P, 0, 0, 0, 0, 0, 0, 94, 56, 1, 0, 53, 0, 56, 50, 498, 20, 20, 442, 25, 20, 4, 53, 25, 50, 452, 226
INVAR-8, Run: 089, P, 0, 0, 0, 0, 0, 0, 102, 48, 1, 2, 49, 0, 50, 50, 495, 16, 14, 447, 25, 18, 6, 49, 25, 50, 474, 237
INVAR-8, Run: 090, P, 0, 0, 0, 0, 0, 0, 110, 40, 1, 1, 45, 0, 41, 50, 726, 21, 20, 686, 25, 17, 7, 45, 25, 50, 840, 420
INVAR-8, Run: 091, P, 0, 0, 0, 0, 0, 0, 136, 14, 1, 2, 32, 0, 16, 50, 503, 24, 22, 489, 25, 14, 10, 32, 25, 50, 1000, 500
INVAR-8, Run: 092, P, 0, 0, 0, 0, 0, 0, 62, 88, 1, 3, 69, 0, 91, 50, 423, 19, 16, 335, 25, 16, 8, 69, 25, 50, 562, 281
INVAR-8, Run: 093, P, 0, 0, 0, 0, 0, 0, 128, 22, 1, 1, 36, 0, 23, 50, 520, 30, 29, 498, 25, 13, 11, 36, 25, 50, 292, 146
INVAR-8, Run: 094, P, 0, 0, 0, 0, 0, 0, 92, 58, 1, 3, 54, 0, 61, 50, 522, 18, 15, 464, 25, 15, 9, 54, 25, 50, 554, 277
INVAR-8, Run: 095, P, 0, 0, 0, 0, 0, 0, 124, 26, 1, 2, 38, 0, 28, 50, 527, 24, 22, 501, 25, 13, 11, 38, 25, 50, 372, 186
INVAR-8, Run: 096, P, 0, 0, 0, 0, 0, 0, 132, 18, 1, 2, 34, 0, 20, 50, 454, 18, 16, 436, 25, 15, 9, 34, 25, 50, 602, 301
INVAR-8, Run: 097, P, 0, 0, 0, 0, 0, 0, 64, 86, 1, 3, 68, 0, 89, 50, 633, 25, 22, 547, 25, 14, 10, 68, 25, 50, 258, 129
INVAR-8, Run: 098, P, 0, 0, 0, 0, 0, 0, 106, 44, 1, 1, 47, 0, 45, 50, 571, 22, 21, 527, 25, 18, 6, 47, 25, 50, 340, 170
INVAR-8, Run: 099, P, 0, 0, 0, 0, 0, 0, 96, 54, 1, 3, 52, 0, 57, 50, 463, 24, 21, 409, 25, 18, 6, 52, 25, 50, 430, 215
INVAR-8, Run: 100, P, 0, 0, 0, 0, 0, 0, 90, 60, 1, 2, 55, 0, 62, 50, 443, 27, 25, 383, 25, 13, 11, 55, 25, 50, 436, 218
INVAR-9, Run: 001, P, 0, 0, 0, 0, 0, 0, 142, 158, 1, 0, 129, 0, 158, 100, 1917, 31, 31, 1759, 50, 30, 19, 129, 50, 100, 1798, 899
INVAR-9, Run: 002, P, 0, 0, 0, 0, 0, 0, 218, 82, 1, 0, 91, 0, 82, 100, 1133, 41, 41, 1051, 50, 21, 28, 91, 50, 100, 1576, 788
INVAR-9, Run: 003, P, 0, 0, 0, 0, 0, 0, 126, 174, 1, 2, 137, 0, 176, 100, 1434, 50, 48, 1260, 50, 26, 23, 137, 50, 100, 1148, 574
INVAR-9, Run: 004, P, 0, 0, 0, 0, 0, 0, 182, 118, 1, 3, 109, 0, 121, 100, 1255, 39, 36, 1137, 50, 34, 15, 109, 50, 100, 1580, 790
INVAR-9, Run: 005, P, 0, 0, 0, 0, 0, 0, 242, 58, 1, 2, 79, 0, 60, 100, 1919, 46, 44, 1861, 50, 33, 16, 79, 50, 100, 2480, 1240
INVAR-9, Run: 006, P, 0, 0, 0, 0, 0, 0, 162, 138, 1, 1, 119, 0, 139, 100, 1731, 35, 34, 1593, 50, 33, 16, 119, 50, 100, 1464, 732
INVAR-9, Run: 007, P, 0, 0, 0, 0, 0, 0, 144, 156, 1, 0, 128, 0, 156, 100, 1378, 38, 38, 1222, 50, 30, 19, 128, 50, 100, 1432, 716
INVAR-9, Run: 008, P, 0, 0, 0, 0, 0, 0, 198, 102, 1, 2, 101, 0, 104, 100, 1368, 34, 32, 1266, 50, 35, 14, 101, 50, 100, 1026, 513
INVAR-9, Run: 009, P, 0, 0, 0, 0, 0, 0, 204, 96, 1, 2, 98, 0, 98, 100, 1369, 42, 40, 1273, 50, 31, 18, 98, 50, 100, 1370, 685
INVAR-9, Run: 010, P, 0, 0, 0, 0, 0, 0, 56, 244, 1, 2, 172, 0, 246, 100, 1523, 46, 44, 1279, 50, 30, 19, 172, 50, 100, 1336, 668
INVAR-9, Run: 011, P, 0, 0, 0, 0, 0, 0, 230, 70, 1, 1, 85, 0, 71, 100, 1862, 41, 40, 1792, 50, 35, 14, 85, 50, 100, 1872, 936
INVAR-9, Run: 012, P, 0, 0, 0, 0, 0, 0, 198, 102, 1, 1, 101, 0, 103, 100, 1882, 30, 29, 1780, 50, 29, 20, 101, 50, 100, 2628, 1314
INVAR-9, Run: 013, P, 0, 0, 0, 0, 0, 0, 238, 62, 1, 1, 81, 0, 63, 100, 1912, 18, 17, 1850, 50, 36, 13, 81, 50, 100, 2310, 1155
INVAR-9, Run: 014, P, 0, 0, 0, 0, 0, 0, 218, 82, 1, 2, 91, 0, 84, 100, 1876, 47, 45, 1794, 50, 29, 20, 91, 50, 100, 1968, 984
INVAR-9, Run: 015, P, 0, 0, 0, 0, 0, 0, 244, 56, 1, 0, 78, 0, 56, 100, 1681, 37, 37, 1625, 50, 33, 16, 78, 50, 100, 1926, 963
INVAR-9, Run: 016, P, 0, 0, 0, 0, 0, 0, 264, 36, 1, 1, 68, 0, 37, 100, 1307, 37, 36, 1271, 50, 30, 19, 68, 50, 100, 1412, 706
INVAR-9, Run: 017, P, 0, 0, 0, 0, 0, 0, 200, 100, 1, 3, 100, 0, 103, 100, 1560, 37, 34, 1460, 50, 24, 25, 100, 50, 100, 2646, 1323
INVAR-9, Run: 018, P, 0, 0, 0, 0, 0, 0, 214, 86, 1, 2, 93, 0, 88, 100, 1615, 52, 50, 1529, 50, 25, 24, 93, 50, 100, 2216, 1108
INVAR-9, Run: 019, P, 0, 0, 0, 0, 0, 0, 256, 44, 1, 3, 72, 0, 47, 100, 1590, 51, 48, 1546, 50, 29, 20, 72, 50, 100, 1380, 690
INVAR-9, Run: 020, P, 0, 0, 0, 0, 0, 0, 124, 176, 1, 2, 138, 0, 178, 100, 1310, 49, 47, 1134, 50, 29, 20, 138, 50, 100, 1458, 729
INVAR-9, Run: 021, P, 0, 0, 0, 0, 0, 0, 224, 76, 1, 0, 88, 0, 76, 100, 1443, 45, 45, 1367, 50, 32, 17, 88, 50, 100, 2114, 1057
INVAR-9, Run: 022, P, 0, 0, 0, 0, 0, 0, 146, 154, 1, 2, 127, 0, 156, 100, 1656, 45, 43, 1502, 50, 36, 13, 127, 50, 100, 2234, 1117
INVAR-9, Run: 023, P, 0, 0, 0, 0, 0, 0, 226, 74, 1, 1, 87, 0, 75, 100, 1190, 41, 40, 1116, 50, 28, 21, 87, 50, 100, 3068, 1534
INVAR-9, Run: 024, P, 0, 0, 0, 0, 0, 0, 264, 36, 1, 0, 68, 0, 36, 100, 1193, 40, 40, 1157, 50, 25, 24, 68, 50, 100, 2656, 1328
INVAR-9, Run: 025, P, 0, 0, 0, 0, 0, 0, 248, 52, 1, 4, 76, 0, 56, 100, 1055, 43, 39, 1003, 50, 28, 21, 76, 50, 100, 1798, 899
INVAR-9, Run: 026, P, 0, 0, 0, 0, 0, 0, 178, 122, 1, 1, 111, 0, 123, 100, 1292, 38, 37, 1170, 50, 31, 18, 111, 50, 100, 1310, 655
INVAR-9, Run: 027, P, 0, 0, 0, 0, 0, 0, 266, 34, 1, 2, 67, 0, 36, 100, 1481, 32, 30, 1447, 50, 33, 16, 67, 50, 100, 2600, 1300
INVAR-9, Run: 028, P, 0, 0, 0, 0, 0, 0, 172, 128, 1, 4, 114, 0, 132, 100, 1433, 30, 26, 1305, 50, 33, 16, 114, 50, 100, 1462, 731
INVAR-9, Run: 029, P, 0, 0, 0, 0, 0, 0, 88, 212, 1, 1, 156, 0, 213, 100, 1890, 26, 25, 1678, 50, 33, 16, 156, 50, 100, 1330, 665
INVAR-9, Run: 030, P, 0, 0, 0, 0, 0, 0, 102, 198, 1, 1, 149, 0, 199, 100, 1402, 42, 41, 1204, 50, 30, 19, 149, 50, 100, 856, 428
INVAR-9, Run: 031, P, 0, 0, 0, 0, 0, 0, 124, 176, 1, 4, 138, 0, 180, 100, 1401, 33, 29, 1225, 50, 29, 20, 138, 50, 100, 1078, 539
INVAR-9, Run: 032, P, 0, 0, 0, 0, 0, 0, 270, 30, 1, 2, 65, 0, 32, 100, 1516, 31, 29, 1486, 50, 34, 15, 65, 50, 100, 1454, 727
INVAR-9, Run: 033, P, 0, 0, 0, 0, 0, 0, 114, 186, 1, 1, 143, 0, 187, 100, 1863, 43, 42, 1677, 50, 30, 19, 143, 50, 100, 1266, 633
INVAR-9, Run: 034, P, 0, 0, 0, 0, 0, 0, 280, 20, 1, 2, 60, 0, 22, 100, 1146, 40, 38, 1126, 50, 29, 20, 60, 50, 100, 1682, 841
INVAR-9, Run: 035, P, 0, 0, 0, 0, 0, 0, 166, 134, 1, 1, 117, 0, 135, 100, 1656, 37, 36, 1522, 50, 39, 10, 117, 50, 100, 1850, 925
INVAR-9, Run: 036, P, 0, 0, 0, 0, 0, 0, 196, 104, 1, 1, 102, 0, 105, 100, 1482, 34, 33, 1378, 50, 28, 21, 102, 50, 100, 1402, 701
INVAR-9, Run: 037, P, 0, 0, 0, 0, 0, 0, 158, 142, 1, 0, 121, 0, 142, 100, 1957, 62, 62, 1815, 50, 30, 19, 121, 50, 100, 1888, 944
INVAR-9, Run: 038, P, 0, 0, 0, 0, 0, 0, 180, 120, 1, 2, 110, 0, 122, 100, 1453, 30, 28, 1333, 50, 33, 16, 110, 50, 100, 1152, 576
INVAR-9, Run: 039, P, 0, 0, 0, 0, 0, 0, 230, 70, 1, 4, 85, 0, 74, 100, 1130, 33, 29, 1060, 50, 38, 11, 85, 50, 100, 1528, 764
INVAR-9, Run: 040, P, 0, 0, 0, 0, 0, 0, 142, 158, 1, 1, 129, 0, 159, 100, 1729, 46, 45, 1571, 50, 33, 16, 129, 50, 100, 1958, 979
INVAR-9, Run: 041, P, 0, 0, 0, 0, 0, 0, 252, 48, 1, 2, 74, 0, 50, 100, 1483, 60, 58, 1435, 50, 22, 27, 74, 50, 100, 1978, 989
INVAR-9, Run: 042, P, 0, 0, 0, 0, 0, 0, 166, 134, 1, 3, 117, 0, 137, 100, 1438, 35, 32, 1304, 50, 36, 13, 117, 50, 100, 1184, 592
INVAR-9, Run: 043, P, 0, 0, 0, 0, 0, 0, 260, 40, 1, 3, 70, 0, 43, 100, 1455, 43, 40, 1415, 50, 31, 18, 70, 50, 100, 1568, 784
INVAR-9, Run: 044, P, 0, 0, 0, 0, 0, 0, 184, 116, 1, 3, 108, 0, 119, 100, 1460, 47, 44, 1344, 50, 32, 17, 108, 50, 100, 1414, 707
INVAR-9, Run: 045, P, 0, 0, 0, 0, 0, 0, 254, 46, 1, 1, 73, 0, 47, 100, 1506, 40, 39, 1460, 50, 35, 14, 73, 50, 100, 1846, 923
INVAR-9, Run: 046, P, 0, 0, 0, 0, 0, 0, 138, 162, 1, 2, 131, 0, 164, 100, 1350, 29, 27, 1188, 50, 30, 19, 131, 50, 100, 1808, 904
INVAR-9, Run: 047, P, 0, 0, 0, 0, 0, 0, 232, 68, 1, 2, 84, 0, 70, 100, 1358, 33, 31, 1290, 50, 33, 16, 84, 50, 100, 1832, 916
INVAR-9, Run: 048, P, 0, 0, 0, 0, 0, 0, 202, 98, 1, 3, 99, 0, 101, 100, 1403, 33, 30, 1305, 50, 33, 16, 99, 50, 100, 2186, 1093
INVAR-9, Run: 049, P, 0, 0, 0, 0, 0, 0, 222, 78, 1, 0, 89, 0, 78, 100, 1572, 37, 37, 1494, 50, 36, 13, 89, 50, 100, 2006, 1003
INVAR-9, Run: 050, P, 0, 0, 0, 0, 0, 0, 170, 130, 1, 2, 115, 0, 132, 100, 1577, 39, 37, 1447, 50, 34, 15, 115, 50, 100, 1824, 912
INVAR-9, Run: 051, P, 0, 0, 0, 0, 0, 0, 222, 78, 1, 0, 89, 0, 78, 100, 1257, 24, 24, 1179, 50, 36, 13, 89, 50, 100, 1082, 541
INVAR-9, Run: 052, P, 0, 0, 0, 0, 0, 0, 224, 76, 1, 3, 88, 0, 79, 100, 1738, 46, 43, 1662, 50, 31, 18, 88, 50, 100, 1130, 565
INVAR-9, Run: 053, P, 0, 0, 0, 0, 0, 0, 252, 48, 1, 3, 74, 0, 51, 100, 2192, 53, 50, 2144, 50, 29, 20, 74, 50, 100, 2824, 1412
INVAR-9, Run: 054, P, 0, 0, 0, 0, 0, 0, 216, 84, 1, 3, 92, 0, 87, 100, 1623, 31, 28, 1539, 50, 29, 20, 92, 50, 100, 2106, 1053
INVAR-9, Run: 055, P, 0, 0, 0, 0, 0, 0, 166, 134, 1, 3, 117, 0, 137, 100, 1426, 38, 35, 1292, 50, 27, 22, 117, 50, 100, 1440, 720
INVAR-9, Run: 056, P, 0, 0, 0, 0, 0, 0, 226, 74, 1, 0, 87, 0, 74, 100, 1761, 36, 36, 1687, 50, 33, 16, 87, 50, 100, 2144, 1072
INVAR-9, Run: 057, P, 0, 0, 0, 0, 0, 0, 208, 92, 1, 2, 96, 0, 94, 100, 1769, 31, 29, 1677, 50, 29, 20, 96, 50, 100, 1294, 647
INVAR-9, Run: 058, P, 0, 0, 0, 0, 0, 0, 252, 48, 1, 2, 74, 0, 50, 100, 1200, 29, 27, 1152, 50, 33, 16, 74, 50, 100, 1434, 717
INVAR-9, Run: 059, P, 0, 0, 0, 0, 0, 0, 240, 60, 1, 0, 80, 0, 60, 100, 1698, 43, 43, 1638, 50, 31, 18, 80, 50, 100, 1882, 941
INVAR-9, Run: 060, P, 0, 0, 0, 0, 0, 0, 44, 256, 1, 1, 178, 0, 257, 100, 1828, 43, 42, 1572, 50, 36, 13, 178, 50, 100, 1494, 747
INVAR-9, Run: 061, P, 0, 0, 0, 0, 0, 0, 224, 76, 1, 2, 88, 0, 78, 100, 1409, 39, 37, 1333, 50, 28, 21, 88, 50, 100, 1406, 703
INVAR-9, Run: 062, P, 0, 0, 0, 0, 0, 0, 248, 52, 1, 4, 76, 0, 56, 100, 1724, 30, 26, 1672, 50, 36, 13, 76, 50, 100, 1894, 947
INVAR-9, Run: 063, P, 0, 0, 0, 0, 0, 0, 152, 148, 1, 3, 124, 0, 151, 100, 1777, 41, 38, 1629, 50, 30, 19, 124, 50, 100, 1806, 903
INVAR-9, Run: 064, P, 0, 0, 0, 0, 0, 0, 242, 58, 1, 2, 79, 0, 60, 100, 1064, 22, 20, 1006, 50, 33, 16, 79, 50, 100, 2676, 1338
INVAR-9, Run: 065, P, 0, 0, 0, 0, 0, 0, 246, 54, 1, 4, 77, 0, 58, 100, 1485, 26, 22, 1431, 50, 29, 20, 77, 50, 100, 1804, 902
INVAR-9, Run: 066, P, 0, 0, 0, 0, 0, 0, 234, 66, 1, 3, 83, 0, 69, 100, 1618, 46, 43, 1552, 50, 28, 21, 83, 50, 100, 1216, 608
INVAR-9, Run: 067, P, 0, 0, 0, 0, 0, 0, 180, 120, 1, 3, 110, 0, 123, 100, 1623, 43, 40, 1503, 50, 34, 15, 110, 50, 100, 1250, 625
INVAR-9, Run: 068, P, 0, 0, 0, 0, 0, 0, 186, 114, 1, 0, 107, 0, 114, 100, 1752, 46, 46, 1638, 50, 39, 10, 107, 50, 100, 2172, 1086
INVAR-9, Run: 069, P, 0, 0, 0, 0, 0, 0, 224, 76, 1, 1, 88, 0, 77, 100, 1940, 42, 41, 1864, 50, 39, 10, 88, 50, 100, 1548, 774
INVAR-9, Run: 070, P, 0, 0, 0, 0, 0, 0, 254, 46, 1, 0, 73, 0, 46, 100, 1332, 37, 37, 1286, 50, 29, 20, 73, 50, 100, 1890, 945
INVAR-9, Run: 071, P, 0, 0, 0, 0, 0, 0, 266, 34, 1, 1, 67, 0, 35, 100, 1238, 33, 32, 1204, 50, 31, 18, 67, 50, 100, 1324, 662
INVAR-9, Run: 072, P, 0, 0, 0, 0, 0, 0, 232, 68, 1, 1, 84, 0, 69, 100, 2794, 44, 43, 2726, 50, 27, 22, 84, 50, 100, 2046, 1023
INVAR-9, Run: 073, P, 0, 0, 0, 0, 0, 0, 238, 62, 1, 2, 81, 0, 64, 100, 1337, 31, 29, 1275, 50, 32, 17, 81, 50, 100, 1656, 828
INVAR-9, Run: 074, P, 0, 0, 0, 0, 0, 0, 230, 70, 1, 1, 85, 0, 71, 100, 1480, 39, 38, 1410, 50, 33, 16, 85, 50, 100, 2602, 1301
INVAR-9, Run: 075, P, 0, 0, 0, 0, 0, 0, 80, 220, 1, 1, 160, 0, 221, 100, 1394, 35, 34, 1174, 50, 28, 21, 160, 50, 100, 1176, 588
INVAR-9, Run: 076, P, 0, 0, 0, 0, 0, 0, 170, 130, 1, 2, 115, 0, 132, 100, 1581, 24, 22, 1451, 50, 30, 19, 115, 50, 100, 1616, 808
INVAR-9, Run: 077, P, 0, 0, 0, 0, 0, 0, 226, 74, 1, 2, 87, 0, 76, 100, 2094, 41, 39, 2020, 50, 36, 13, 87, 50, 100, 3086, 1543
INVAR-9, Run: 078, P, 0, 0, 0, 0, 0, 0, 272, 28, 1, 4, 64, 0, 32, 100, 1269, 25, 21, 1241, 50, 33, 16, 64, 50, 100, 1036, 518
INVAR-9, Run: 079, P, 0, 0, 0, 0, 0, 0, 210, 90, 1, 1, 95, 0, 91, 100, 1324, 38, 37, 1234, 50, 34, 15, 95, 50, 100, 4202, 2101
INVAR-9, Run: 080, P, 0, 0, 0, 0, 0, 0, 188, 112, 1, 2, 106, 0, 114, 100, 1789, 43, 41, 1677, 50, 32, 17, 106, 50, 100, 1496, 748
INVAR-9, Run: 081, P, 0, 0, 0, 0, 0, 0, 264, 36, 1, 2, 68, 0, 38, 100, 1415, 49, 47, 1379, 50, 30, 19, 68, 50, 100, 1434, 717
INVAR-9, Run: 082, P, 0, 0, 0, 0, 0, 0, 196, 104, 1, 3, 102, 0, 107, 100, 1247, 56, 53, 1143, 50, 30, 19, 102, 50, 100, 1336, 668
INVAR-9, Run: 083, P, 0, 0, 0, 0, 0, 0, 258, 42, 1, 2, 71, 0, 44, 100, 1880, 37, 35, 1838, 50, 41, 8, 71, 50, 100, 1934, 967
INVAR-9, Run: 084, P, 0, 0, 0, 0, 0, 0, 104, 196, 1, 2, 148, 0, 198, 100, 2348, 49, 47, 2152, 50, 30, 19, 148, 50, 100, 1378, 689
INVAR-9, Run: 085, P, 0, 0, 0, 0, 0, 0, 238, 62, 1, 2, 81, 0, 64, 100, 1595, 52, 50, 1533, 50, 36, 13, 81, 50, 100, 1808, 904
INVAR-9, Run: 086, P, 0, 0, 0, 0, 0, 0, 264, 36, 1, 1, 68, 0, 37, 100, 1751, 47, 46, 1715, 50, 30, 19, 68, 50, 100, 2354, 1177
INVAR-9, Run: 087, P, 0, 0, 0, 0, 0, 0, 262, 38, 1, 3, 69, 0, 41, 100, 1592, 30, 27, 1554, 50, 24, 25, 69, 50, 100, 1804, 902
INVAR-9, Run: 088, P, 0, 0, 0, 0, 0, 0, 166, 134, 1, 4, 117, 0, 138, 100, 1554, 36, 32, 1420, 50, 32, 17, 117, 50, 100, 1744, 872
INVAR-9, Run: 089, P, 0, 0, 0, 0, 0, 0, 248, 52, 1, 2, 76, 0, 54, 100, 1483, 33, 31, 1431, 50, 35, 14, 76, 50, 100, 1472, 736
INVAR-9, Run: 090, P, 0, 0, 0, 0, 0, 0, 36, 264, 1, 1, 182, 0, 265, 100, 1461, 30, 29, 1197, 50, 34, 15, 182, 50, 100, 1354, 677
INVAR-9, Run: 091, P, 0, 0, 0, 0, 0, 0, 196, 104, 1, 2, 102, 0, 106, 100, 1081, 40, 38, 977, 50, 30, 19, 102, 50, 100, 1468, 734
INVAR-9, Run: 092, P, 0, 0, 0, 0, 0, 0, 112, 188, 1, 3, 144, 0, 191, 100, 1737, 40, 37, 1549, 50, 26, 23, 144, 50, 100, 1376, 688
INVAR-9, Run: 093, P, 0, 0, 0, 0, 0, 0, 226, 74, 1, 2, 87, 0, 76, 100, 1466, 38, 36, 1392, 50, 38, 11, 87, 50, 100, 1254, 627
INVAR-9, Run: 094, P, 0, 0, 0, 0, 0, 0, 174, 126, 1, 0, 113, 0, 126, 100, 1264, 28, 28, 1138, 50, 34, 15, 113, 50, 100, 1020, 510
INVAR-9, Run: 095, P, 0, 0, 0, 0, 0, 0, 266, 34, 1, 1, 67, 0, 35, 100, 1147, 33, 32, 1113, 50, 25, 24, 67, 50, 100, 2710, 1355
INVAR-9, Run: 096, P, 0, 0, 0, 0, 0, 0, 180, 120, 1, 2, 110, 0, 122, 100, 1593, 36, 34, 1473, 50, 38, 11, 110, 50, 100, 1804, 902
INVAR-9, Run: 097, P, 0, 0, 0, 0, 0, 0, 196, 104, 1, 2, 102, 0, 106, 100, 1357, 29, 27, 1253, 50, 39, 10, 102, 50, 100, 1768, 884
INVAR-9, Run: 098, P, 0, 0, 0, 0, 0, 0, 242, 58, 1, 1, 79, 0, 59, 100, 1680, 30, 29, 1622, 50, 28, 21, 79, 50, 100, 2102, 1051
INVAR-9, Run: 099, P, 0, 0, 0, 0, 0, 0, 234, 66, 1, 3, 83, 0, 69, 100, 1516, 39, 36, 1450, 50, 32, 17, 83, 50, 100, 4522, 2261
INVAR-9, Run: 100, P, 0, 0, 0, 0, 0, 0, 224, 76, 1, 1, 88, 0, 77, 100, 1262, 45, 44, 1186, 50, 26, 23, 88, 50, 100, 1592, 796
