Input Number, Run_Number, Result@ 100, PO, A, H, X1, M, CE, Y, D, CO, PE, B, NEW_REACTION, Reaction1, Reaction10, Reaction11, Reaction2, Reaction3, Reaction4, Reaction5, Reaction6, Reaction7, Reaction8, Reaction9
INVAR-1, Run: 001, P, 0, 21, 0, 0, 0, 0, 37, 11, 37, 0, 0, 4, 18, 23, 96, 7, 6, 1, 11, 18, 27, 23, 133
INVAR-1, Run: 002, P, 0, 60, 0, 0, 0, 12, 12, 0, 0, 1, 0, 6, 18, 17, 69, 6, 2, 3, 12, 18, 27, 29, 69
INVAR-1, Run: 003, P, 0, 5, 0, 0, 0, 0, 55, 12, 55, 0, 0, 6, 18, 7, 49, 6, 5, 1, 12, 18, 27, 7, 104
INVAR-1, Run: 004, P, 0, 43, 0, 0, 0, 0, 15, 11, 15, 0, 0, 4, 18, 11, 9, 7, 3, 4, 11, 18, 27, 11, 24
INVAR-1, Run: 005, P, 0, 54, 0, 0, 0, 9, 9, 0, 0, 1, 0, 0, 18, 20, 65, 9, 2, 6, 9, 18, 27, 29, 65
INVAR-1, Run: 006, P, 0, 60, 0, 0, 0, 12, 12, 0, 0, 1, 0, 6, 18, 8, 88, 6, 3, 2, 12, 18, 27, 20, 88
INVAR-1, Run: 007, P, 0, 60, 0, 0, 0, 12, 12, 0, 0, 1, 0, 6, 18, 13, 104, 6, 4, 1, 12, 18, 27, 25, 104
INVAR-1, Run: 008, P, 0, 36, 0, 0, 0, 0, 22, 11, 22, 0, 0, 4, 18, 7, 56, 7, 7, 0, 11, 18, 27, 7, 78
INVAR-1, Run: 009, P, 0, 58, 0, 0, 0, 11, 11, 0, 0, 1, 0, 4, 18, 19, 50, 7, 2, 4, 11, 18, 27, 30, 50
INVAR-1, Run: 010, P, 0, 6, 0, 0, 0, 0, 54, 12, 54, 0, 0, 6, 18, 24, 75, 6, 4, 2, 12, 18, 27, 24, 129
INVAR-1, Run: 011, P, 0, 1, 0, 0, 0, 0, 57, 11, 57, 0, 0, 4, 18, 35, 168, 7, 5, 2, 11, 18, 27, 35, 225
INVAR-1, Run: 012, P, 0, 39, 0, 0, 0, 0, 25, 14, 25, 0, 0, 10, 18, 18, 67, 4, 3, 1, 14, 18, 27, 18, 92
INVAR-1, Run: 013, P, 0, 60, 0, 0, 0, 12, 12, 0, 0, 1, 0, 6, 18, 28, 156, 6, 5, 0, 12, 18, 27, 40, 156
INVAR-1, Run: 014, P, 0, 35, 0, 0, 0, 0, 29, 14, 29, 0, 0, 10, 18, 4, 3, 4, 2, 2, 14, 18, 27, 4, 32
INVAR-1, Run: 015, P, 0, 58, 0, 0, 0, 11, 11, 0, 0, 1, 0, 4, 18, 12, 73, 7, 4, 2, 11, 18, 27, 23, 73
INVAR-1, Run: 016, P, 0, 1, 0, 0, 0, 0, 57, 11, 57, 0, 0, 4, 18, 18, 61, 7, 6, 1, 11, 18, 27, 18, 118
INVAR-1, Run: 017, P, 0, 45, 0, 0, 0, 0, 13, 11, 13, 0, 0, 4, 18, 18, 48, 7, 3, 4, 11, 18, 27, 18, 61
INVAR-1, Run: 018, P, 0, 60, 0, 0, 0, 12, 12, 0, 0, 1, 0, 6, 18, 20, 95, 6, 3, 2, 12, 18, 27, 32, 95
INVAR-1, Run: 019, P, 0, 17, 0, 0, 0, 0, 43, 12, 43, 0, 0, 6, 18, 15, 30, 6, 4, 2, 12, 18, 27, 15, 73
INVAR-1, Run: 020, P, 0, 62, 0, 0, 0, 13, 13, 0, 0, 1, 0, 8, 18, 23, 86, 5, 3, 1, 13, 18, 27, 36, 86
INVAR-1, Run: 021, P, 0, 58, 0, 0, 0, 11, 11, 0, 0, 1, 0, 4, 18, 31, 126, 7, 3, 3, 11, 18, 27, 42, 126
INVAR-1, Run: 022, P, 0, 45, 0, 0, 0, 0, 13, 11, 13, 0, 0, 4, 18, 12, 100, 7, 7, 0, 11, 18, 27, 12, 113
INVAR-1, Run: 023, P, 0, 60, 0, 0, 0, 12, 12, 0, 0, 1, 0, 6, 18, 9, 50, 6, 3, 2, 12, 18, 27, 21, 50
INVAR-1, Run: 024, P, 0, 11, 0, 0, 0, 0, 47, 11, 47, 0, 0, 4, 18, 8, 64, 7, 6, 1, 11, 18, 27, 8, 111
INVAR-1, Run: 025, P, 0, 58, 0, 0, 0, 11, 11, 0, 0, 1, 0, 4, 18, 12, 50, 7, 3, 3, 11, 18, 27, 23, 50
INVAR-1, Run: 026, P, 0, 60, 0, 0, 0, 12, 12, 0, 0, 1, 0, 6, 18, 7, 73, 6, 3, 2, 12, 18, 27, 19, 73
INVAR-1, Run: 027, P, 0, 58, 0, 0, 0, 11, 11, 0, 0, 1, 0, 4, 18, 21, 67, 7, 4, 2, 11, 18, 27, 32, 67
INVAR-1, Run: 028, P, 0, 14, 0, 0, 0, 0, 46, 12, 46, 0, 0, 6, 18, 11, 79, 6, 5, 1, 12, 18, 27, 11, 125
INVAR-1, Run: 029, P, 0, 13, 0, 0, 0, 0, 49, 13, 49, 0, 0, 8, 18, 13, 31, 5, 2, 3, 13, 18, 27, 13, 80
INVAR-1, Run: 030, P, 0, 58, 0, 0, 0, 11, 11, 0, 0, 1, 0, 4, 18, 26, 89, 7, 3, 3, 11, 18, 27, 37, 89
INVAR-1, Run: 031, P, 0, 60, 0, 0, 0, 12, 12, 0, 0, 1, 0, 6, 18, 12, 72, 6, 5, 0, 12, 18, 27, 24, 72
INVAR-1, Run: 032, P, 0, 56, 0, 0, 0, 10, 10, 0, 0, 1, 0, 2, 18, 19, 134, 8, 6, 1, 10, 18, 27, 29, 134
INVAR-1, Run: 033, P, 0, 26, 0, 0, 0, 0, 36, 13, 36, 0, 0, 8, 18, 35, 145, 5, 4, 1, 13, 18, 27, 35, 181
INVAR-1, Run: 034, P, 0, 5, 0, 0, 0, 0, 55, 12, 55, 0, 0, 6, 18, 41, 158, 6, 4, 2, 12, 18, 27, 41, 213
INVAR-1, Run: 035, P, 0, 31, 0, 0, 0, 0, 29, 12, 29, 0, 0, 6, 18, 14, 63, 6, 2, 4, 12, 18, 27, 14, 92
INVAR-1, Run: 036, P, 0, 35, 0, 0, 0, 0, 25, 12, 25, 0, 0, 6, 18, 33, 132, 6, 4, 2, 12, 18, 27, 33, 157
INVAR-1, Run: 037, P, 0, 1, 0, 0, 0, 0, 61, 13, 61, 0, 0, 8, 18, 20, 69, 5, 3, 2, 13, 18, 27, 20, 130
INVAR-1, Run: 038, P, 0, 58, 0, 0, 0, 11, 11, 0, 0, 1, 0, 4, 18, 9, 63, 7, 4, 2, 11, 18, 27, 20, 63
INVAR-1, Run: 039, P, 0, 58, 0, 0, 0, 11, 11, 0, 0, 1, 0, 4, 18, 18, 62, 7, 2, 4, 11, 18, 27, 29, 62
INVAR-1, Run: 040, P, 0, 60, 0, 0, 0, 12, 12, 0, 0, 1, 0, 6, 18, 22, 79, 6, 3, 2, 12, 18, 27, 34, 79
INVAR-1, Run: 041, P, 0, 56, 0, 0, 0, 10, 10, 0, 0, 1, 0, 2, 18, 19, 112, 8, 7, 0, 10, 18, 27, 29, 112
INVAR-1, Run: 042, P, 0, 60, 0, 0, 0, 12, 12, 0, 0, 1, 0, 6, 18, 14, 57, 6, 2, 3, 12, 18, 27, 26, 57
INVAR-1, Run: 043, P, 0, 56, 0, 0, 0, 10, 10, 0, 0, 1, 0, 2, 18, 16, 79, 8, 3, 4, 10, 18, 27, 26, 79
INVAR-1, Run: 044, P, 0, 40, 0, 0, 0, 0, 20, 12, 20, 0, 0, 6, 18, 14, 51, 6, 3, 3, 12, 18, 27, 14, 71
INVAR-1, Run: 045, P, 0, 36, 0, 0, 0, 0, 24, 12, 24, 0, 0, 6, 18, 39, 74, 6, 4, 2, 12, 18, 27, 39, 98
INVAR-1, Run: 046, P, 0, 56, 0, 0, 0, 10, 10, 0, 0, 1, 0, 2, 18, 13, 52, 8, 4, 3, 10, 18, 27, 23, 52
INVAR-1, Run: 047, P, 0, 62, 0, 0, 0, 13, 13, 0, 0, 1, 0, 8, 18, 39, 148, 5, 2, 2, 13, 18, 27, 52, 148
INVAR-1, Run: 048, P, 0, 7, 0, 0, 0, 0, 55, 13, 55, 0, 0, 8, 18, 14, 54, 5, 3, 2, 13, 18, 27, 14, 109
INVAR-1, Run: 049, P, 0, 13, 0, 0, 0, 0, 49, 13, 49, 0, 0, 8, 18, 19, 50, 5, 4, 1, 13, 18, 27, 19, 99
INVAR-1, Run: 050, P, 0, 2, 0, 0, 0, 0, 54, 10, 54, 0, 0, 2, 18, 15, 73, 8, 6, 2, 10, 18, 27, 15, 127
INVAR-1, Run: 051, P, 0, 33, 0, 0, 0, 0, 25, 11, 25, 0, 0, 4, 18, 23, 53, 7, 5, 2, 11, 18, 27, 23, 78
INVAR-1, Run: 052, P, 0, 47, 0, 0, 0, 0, 13, 12, 13, 0, 0, 6, 18, 10, 70, 6, 3, 3, 12, 18, 27, 10, 83
INVAR-1, Run: 053, P, 0, 56, 0, 0, 0, 10, 10, 0, 0, 1, 0, 2, 18, 4, 60, 8, 4, 3, 10, 18, 27, 14, 60
INVAR-1, Run: 054, P, 0, 60, 0, 0, 0, 12, 12, 0, 0, 1, 0, 6, 18, 26, 111, 6, 4, 1, 12, 18, 27, 38, 111
INVAR-1, Run: 055, P, 0, 60, 0, 0, 0, 12, 12, 0, 0, 1, 0, 6, 18, 25, 128, 6, 3, 2, 12, 18, 27, 37, 128
INVAR-1, Run: 056, P, 0, 56, 0, 0, 0, 10, 10, 0, 0, 1, 0, 2, 18, 29, 109, 8, 4, 3, 10, 18, 27, 39, 109
INVAR-1, Run: 057, P, 0, 12, 0, 0, 0, 0, 50, 13, 50, 0, 0, 8, 18, 11, 43, 5, 4, 1, 13, 18, 27, 11, 93
INVAR-1, Run: 058, P, 0, 3, 0, 0, 0, 0, 57, 12, 57, 0, 0, 6, 18, 8, 60, 6, 5, 1, 12, 18, 27, 8, 117
INVAR-1, Run: 059, P, 0, 31, 0, 0, 0, 0, 29, 12, 29, 0, 0, 6, 18, 15, 39, 6, 6, 0, 12, 18, 27, 15, 68
INVAR-1, Run: 060, P, 0, 9, 0, 0, 0, 0, 53, 13, 53, 0, 0, 8, 18, 14, 52, 5, 4, 1, 13, 18, 27, 14, 105
INVAR-1, Run: 061, P, 0, 11, 0, 0, 0, 0, 49, 12, 49, 0, 0, 6, 18, 3, 48, 6, 4, 2, 12, 18, 27, 3, 97
INVAR-1, Run: 062, P, 0, 58, 0, 0, 0, 11, 11, 0, 0, 1, 0, 4, 18, 16, 140, 7, 4, 2, 11, 18, 27, 27, 140
INVAR-1, Run: 063, P, 0, 20, 0, 0, 0, 0, 44, 14, 44, 0, 0, 10, 18, 23, 74, 4, 2, 2, 14, 18, 27, 23, 118
INVAR-1, Run: 064, P, 0, 4, 0, 0, 0, 0, 58, 13, 58, 0, 0, 8, 18, 18, 73, 5, 5, 0, 13, 18, 27, 18, 131
INVAR-1, Run: 065, P, 0, 62, 0, 0, 0, 13, 13, 0, 0, 1, 0, 8, 18, 14, 93, 5, 2, 2, 13, 18, 27, 27, 93
INVAR-1, Run: 066, P, 0, 39, 0, 0, 0, 0, 23, 13, 23, 0, 0, 8, 18, 17, 47, 5, 5, 0, 13, 18, 27, 17, 70
INVAR-1, Run: 067, P, 0, 56, 0, 0, 0, 10, 10, 0, 0, 1, 0, 2, 18, 19, 65, 8, 2, 5, 10, 18, 27, 29, 65
INVAR-1, Run: 068, P, 0, 56, 0, 0, 0, 10, 10, 0, 0, 1, 0, 2, 18, 15, 65, 8, 5, 2, 10, 18, 27, 25, 65
INVAR-1, Run: 069, P, 0, 58, 0, 0, 0, 11, 11, 0, 0, 1, 0, 4, 18, 11, 95, 7, 6, 0, 11, 18, 27, 22, 95
INVAR-1, Run: 070, P, 0, 60, 0, 0, 0, 12, 12, 0, 0, 1, 0, 6, 18, 11, 89, 6, 4, 1, 12, 18, 27, 23, 89
INVAR-1, Run: 071, P, 0, 2, 0, 0, 0, 0, 56, 11, 56, 0, 0, 4, 18, 11, 32, 7, 5, 2, 11, 18, 27, 11, 88
INVAR-1, Run: 072, P, 0, 58, 0, 0, 0, 11, 11, 0, 0, 1, 0, 4, 18, 13, 85, 7, 5, 1, 11, 18, 27, 24, 85
INVAR-1, Run: 073, P, 0, 1, 0, 0, 0, 0, 59, 12, 59, 0, 0, 6, 18, 34, 138, 6, 3, 3, 12, 18, 27, 34, 197
INVAR-1, Run: 074, P, 0, 60, 0, 0, 0, 12, 12, 0, 0, 1, 0, 6, 18, 26, 111, 6, 4, 1, 12, 18, 27, 38, 111
INVAR-1, Run: 075, P, 0, 53, 0, 0, 0, 3, 8, 8, 5, 0, 0, 4, 18, 11, 68, 7, 5, 2, 11, 18, 27, 14, 73
INVAR-1, Run: 076, P, 0, 64, 0, 0, 0, 14, 14, 0, 0, 1, 0, 10, 18, 11, 75, 4, 3, 0, 14, 18, 27, 25, 75
INVAR-1, Run: 077, P, 0, 53, 0, 0, 0, 0, 9, 13, 9, 0, 0, 8, 18, 39, 172, 5, 5, 0, 13, 18, 27, 39, 181
INVAR-1, Run: 078, P, 0, 6, 0, 0, 0, 0, 50, 10, 50, 0, 0, 2, 18, 26, 166, 8, 7, 1, 10, 18, 27, 26, 216
INVAR-1, Run: 079, P, 0, 1, 0, 0, 0, 0, 59, 12, 59, 0, 0, 6, 18, 4, 31, 6, 3, 3, 12, 18, 27, 4, 90
INVAR-1, Run: 080, P, 0, 58, 0, 0, 0, 11, 11, 0, 0, 1, 0, 4, 18, 22, 93, 7, 4, 2, 11, 18, 27, 33, 93
INVAR-1, Run: 081, P, 0, 36, 0, 0, 0, 0, 22, 11, 22, 0, 0, 4, 18, 29, 79, 7, 4, 3, 11, 18, 27, 29, 101
INVAR-1, Run: 082, P, 0, 18, 0, 0, 0, 0, 42, 12, 42, 0, 0, 6, 18, 9, 67, 6, 4, 2, 12, 18, 27, 9, 109
INVAR-1, Run: 083, P, 0, 60, 0, 0, 0, 12, 12, 0, 0, 1, 0, 6, 18, 22, 102, 6, 4, 1, 12, 18, 27, 34, 102
INVAR-1, Run: 084, P, 0, 20, 0, 0, 0, 0, 40, 12, 40, 0, 0, 6, 18, 29, 118, 6, 6, 0, 12, 18, 27, 29, 158
INVAR-1, Run: 085, P, 0, 4, 0, 0, 0, 0, 56, 12, 56, 0, 0, 6, 18, 22, 95, 6, 4, 2, 12, 18, 27, 22, 151
INVAR-1, Run: 086, P, 0, 12, 0, 0, 0, 0, 48, 12, 48, 0, 0, 6, 18, 25, 104, 6, 5, 1, 12, 18, 27, 25, 152
INVAR-1, Run: 087, P, 0, 62, 0, 0, 0, 13, 13, 0, 0, 1, 0, 8, 18, 32, 101, 5, 3, 1, 13, 18, 27, 45, 101
INVAR-1, Run: 088, P, 0, 62, 0, 0, 0, 13, 13, 0, 0, 1, 0, 8, 18, 28, 146, 5, 2, 2, 13, 18, 27, 41, 146
INVAR-1, Run: 089, P, 0, 33, 0, 0, 0, 0, 27, 12, 27, 0, 0, 6, 18, 24, 82, 6, 4, 2, 12, 18, 27, 24, 109
INVAR-1, Run: 090, P, 0, 56, 0, 0, 0, 10, 10, 0, 0, 1, 0, 2, 18, 17, 62, 8, 4, 3, 10, 18, 27, 27, 62
INVAR-1, Run: 091, P, 0, 6, 0, 0, 0, 0, 50, 10, 50, 0, 0, 2, 18, 33, 135, 8, 3, 5, 10, 18, 27, 33, 185
INVAR-1, Run: 092, P, 0, 58, 0, 0, 0, 11, 11, 0, 0, 1, 0, 4, 18, 3, 42, 7, 5, 1, 11, 18, 27, 14, 42
INVAR-1, Run: 093, P, 0, 15, 0, 0, 0, 0, 43, 11, 43, 0, 0, 4, 18, 24, 100, 7, 5, 2, 11, 18, 27, 24, 143
INVAR-1, Run: 094, P, 0, 3, 0, 0, 0, 0, 55, 11, 55, 0, 0, 4, 18, 7, 32, 7, 5, 2, 11, 18, 27, 7, 87
INVAR-1, Run: 095, P, 0, 60, 0, 0, 0, 12, 12, 0, 0, 1, 0, 6, 18, 17, 84, 6, 4, 1, 12, 18, 27, 29, 84
INVAR-1, Run: 096, P, 0, 16, 0, 0, 0, 0, 46, 13, 46, 0, 0, 8, 18, 9, 67, 5, 3, 2, 13, 18, 27, 9, 113
INVAR-1, Run: 097, P, 0, 25, 0, 0, 0, 0, 33, 11, 33, 0, 0, 4, 18, 12, 55, 7, 3, 4, 11, 18, 27, 12, 88
INVAR-1, Run: 098, P, 0, 9, 0, 0, 0, 0, 49, 11, 49, 0, 0, 4, 18, 32, 84, 7, 3, 4, 11, 18, 27, 32, 133
INVAR-1, Run: 099, P, 0, 58, 0, 0, 0, 11, 11, 0, 0, 1, 0, 4, 18, 20, 93, 7, 4, 2, 11, 18, 27, 31, 93
INVAR-1, Run: 100, P, 0, 58, 0, 0, 0, 11, 11, 0, 0, 1, 0, 4, 18, 9, 60, 7, 3, 3, 11, 18, 27, 20, 60
INVAR-10, Run: 001, P, 0, 142, 0, 0, 0, 0, 478, 110, 478, 0, 0, 20, 200, 894, 5326, 90, 56, 34, 110, 200, 300, 894, 5804
INVAR-10, Run: 002, P, 0, 618, 0, 0, 0, 109, 109, 0, 0, 1, 0, 18, 200, 590, 5018, 91, 66, 24, 109, 200, 300, 699, 5018
INVAR-10, Run: 003, P, 0, 100, 0, 0, 0, 0, 516, 108, 516, 0, 0, 16, 200, 933, 4913, 92, 59, 33, 108, 200, 300, 933, 5429
INVAR-10, Run: 004, P, 0, 322, 0, 0, 0, 0, 302, 112, 302, 0, 0, 24, 200, 741, 4025, 88, 55, 33, 112, 200, 300, 741, 4327
INVAR-10, Run: 005, P, 0, 618, 0, 0, 0, 109, 109, 0, 0, 1, 0, 18, 200, 761, 3823, 91, 54, 36, 109, 200, 300, 870, 3823
INVAR-10, Run: 006, P, 0, 616, 0, 0, 0, 108, 108, 0, 0, 1, 0, 16, 200, 770, 3274, 92, 66, 25, 108, 200, 300, 878, 3274
INVAR-10, Run: 007, P, 0, 620, 0, 0, 0, 110, 110, 0, 0, 1, 0, 20, 200, 712, 4294, 90, 64, 25, 110, 200, 300, 822, 4294
INVAR-10, Run: 008, P, 0, 12, 0, 0, 0, 0, 614, 113, 614, 0, 0, 26, 200, 943, 4657, 87, 61, 26, 113, 200, 300, 943, 5271
INVAR-10, Run: 009, P, 0, 60, 0, 0, 0, 0, 554, 107, 554, 0, 0, 14, 200, 732, 3549, 93, 59, 34, 107, 200, 300, 732, 4103
INVAR-10, Run: 010, P, 0, 624, 0, 0, 0, 112, 112, 0, 0, 1, 0, 24, 200, 994, 4977, 88, 59, 28, 112, 200, 300, 1106, 4977
INVAR-10, Run: 011, P, 0, 182, 0, 0, 0, 0, 434, 108, 434, 0, 0, 16, 200, 772, 3661, 92, 61, 31, 108, 200, 300, 772, 4095
INVAR-10, Run: 012, P, 0, 608, 0, 0, 0, 104, 104, 0, 0, 1, 0, 8, 200, 876, 3684, 96, 55, 40, 104, 200, 300, 980, 3684
INVAR-10, Run: 013, P, 0, 624, 0, 0, 0, 112, 112, 0, 0, 1, 0, 24, 200, 742, 5026, 88, 66, 21, 112, 200, 300, 854, 5026
INVAR-10, Run: 014, P, 0, 421, 0, 0, 0, 0, 199, 110, 199, 0, 0, 20, 200, 842, 5281, 90, 54, 36, 110, 200, 300, 842, 5480
INVAR-10, Run: 015, P, 0, 614, 0, 0, 0, 107, 107, 0, 0, 1, 0, 14, 200, 895, 4769, 93, 52, 40, 107, 200, 300, 1002, 4769
INVAR-10, Run: 016, P, 0, 614, 0, 0, 0, 107, 107, 0, 0, 1, 0, 14, 200, 734, 4739, 93, 50, 42, 107, 200, 300, 841, 4739
INVAR-10, Run: 017, P, 0, 618, 0, 0, 0, 109, 109, 0, 0, 1, 0, 18, 200, 944, 4565, 91, 52, 38, 109, 200, 300, 1053, 4565
INVAR-10, Run: 018, P, 0, 252, 0, 0, 0, 0, 370, 111, 370, 0, 0, 22, 200, 854, 4248, 89, 63, 26, 111, 200, 300, 854, 4618
INVAR-10, Run: 019, P, 0, 355, 0, 0, 0, 0, 265, 110, 265, 0, 0, 20, 200, 1062, 5308, 90, 57, 33, 110, 200, 300, 1062, 5573
INVAR-10, Run: 020, P, 0, 624, 0, 0, 0, 112, 112, 0, 0, 1, 0, 24, 200, 777, 3893, 88, 61, 26, 112, 200, 300, 889, 3893
INVAR-10, Run: 021, P, 0, 22, 0, 0, 0, 0, 598, 110, 598, 0, 0, 20, 200, 821, 4155, 90, 63, 27, 110, 200, 300, 821, 4753
INVAR-10, Run: 022, P, 0, 185, 0, 0, 0, 0, 433, 109, 433, 0, 0, 18, 200, 845, 4595, 91, 65, 26, 109, 200, 300, 845, 5028
INVAR-10, Run: 023, P, 0, 472, 0, 0, 0, 0, 150, 111, 150, 0, 0, 22, 200, 839, 4063, 89, 51, 38, 111, 200, 300, 839, 4213
INVAR-10, Run: 024, P, 0, 616, 0, 0, 0, 108, 108, 0, 0, 1, 0, 16, 200, 932, 5507, 92, 53, 38, 108, 200, 300, 1040, 5507
INVAR-10, Run: 025, P, 0, 86, 0, 0, 0, 0, 534, 110, 534, 0, 0, 20, 200, 581, 3951, 90, 55, 35, 110, 200, 300, 581, 4485
INVAR-10, Run: 026, P, 0, 262, 0, 0, 0, 0, 364, 113, 364, 0, 0, 26, 200, 919, 4710, 87, 54, 33, 113, 200, 300, 919, 5074
INVAR-10, Run: 027, P, 0, 87, 0, 0, 0, 0, 535, 111, 535, 0, 0, 22, 200, 680, 3541, 89, 54, 35, 111, 200, 300, 680, 4076
INVAR-10, Run: 028, P, 0, 618, 0, 0, 0, 109, 109, 0, 0, 1, 0, 18, 200, 771, 4727, 91, 58, 32, 109, 200, 300, 880, 4727
INVAR-10, Run: 029, P, 0, 624, 0, 0, 0, 112, 112, 0, 0, 1, 0, 24, 200, 695, 4353, 88, 59, 28, 112, 200, 300, 807, 4353
INVAR-10, Run: 030, P, 0, 614, 0, 0, 0, 107, 107, 0, 0, 1, 0, 14, 200, 676, 4250, 93, 60, 32, 107, 200, 300, 783, 4250
INVAR-10, Run: 031, P, 0, 610, 0, 0, 0, 105, 105, 0, 0, 1, 0, 10, 200, 726, 4269, 95, 64, 30, 105, 200, 300, 831, 4269
INVAR-10, Run: 032, P, 0, 212, 0, 0, 0, 0, 408, 110, 408, 0, 0, 20, 200, 785, 3153, 90, 59, 31, 110, 200, 300, 785, 3561
INVAR-10, Run: 033, P, 0, 262, 0, 0, 0, 0, 356, 109, 356, 0, 0, 18, 200, 806, 4256, 91, 60, 31, 109, 200, 300, 806, 4612
INVAR-10, Run: 034, P, 0, 618, 0, 0, 0, 109, 109, 0, 0, 1, 0, 18, 200, 866, 4386, 91, 61, 29, 109, 200, 300, 975, 4386
INVAR-10, Run: 035, P, 0, 628, 0, 0, 0, 114, 114, 0, 0, 1, 0, 28, 200, 1046, 5666, 86, 51, 34, 114, 200, 300, 1160, 5666
INVAR-10, Run: 036, P, 0, 154, 0, 0, 0, 0, 478, 116, 478, 0, 0, 32, 200, 897, 4382, 84, 53, 31, 116, 200, 300, 897, 4860
INVAR-10, Run: 037, P, 0, 535, 0, 0, 0, 0, 89, 112, 89, 0, 0, 24, 200, 819, 4652, 88, 62, 26, 112, 200, 300, 819, 4741
INVAR-10, Run: 038, P, 0, 618, 0, 0, 0, 109, 109, 0, 0, 1, 0, 18, 200, 793, 4633, 91, 61, 29, 109, 200, 300, 902, 4633
INVAR-10, Run: 039, P, 0, 300, 0, 0, 0, 0, 324, 112, 324, 0, 0, 24, 200, 875, 5232, 88, 58, 30, 112, 200, 300, 875, 5556
INVAR-10, Run: 040, P, 0, 614, 0, 0, 0, 107, 107, 0, 0, 1, 0, 14, 200, 896, 5249, 93, 50, 42, 107, 200, 300, 1003, 5249
INVAR-10, Run: 041, P, 0, 624, 0, 0, 0, 112, 112, 0, 0, 1, 0, 24, 200, 903, 3909, 88, 50, 37, 112, 200, 300, 1015, 3909
INVAR-10, Run: 042, P, 0, 614, 0, 0, 0, 107, 107, 0, 0, 1, 0, 14, 200, 934, 4052, 93, 59, 33, 107, 200, 300, 1041, 4052
INVAR-10, Run: 043, P, 0, 72, 0, 0, 0, 0, 554, 113, 554, 0, 0, 26, 200, 756, 4544, 87, 57, 30, 113, 200, 300, 756, 5098
INVAR-10, Run: 044, P, 0, 308, 0, 0, 0, 0, 320, 114, 320, 0, 0, 28, 200, 814, 3953, 86, 62, 24, 114, 200, 300, 814, 4273
INVAR-10, Run: 045, P, 0, 628, 0, 0, 0, 114, 114, 0, 0, 1, 0, 28, 200, 874, 4487, 86, 46, 39, 114, 200, 300, 988, 4487
INVAR-10, Run: 046, P, 0, 258, 0, 0, 0, 0, 358, 108, 358, 0, 0, 16, 200, 769, 4134, 92, 60, 32, 108, 200, 300, 769, 4492
INVAR-10, Run: 047, P, 0, 14, 0, 0, 0, 0, 608, 111, 608, 0, 0, 22, 200, 826, 4493, 89, 53, 36, 111, 200, 300, 826, 5101
INVAR-10, Run: 048, P, 0, 118, 0, 0, 0, 0, 502, 110, 502, 0, 0, 20, 200, 987, 4693, 90, 55, 35, 110, 200, 300, 987, 5195
INVAR-10, Run: 049, P, 0, 616, 0, 0, 0, 108, 108, 0, 0, 1, 0, 16, 200, 745, 4886, 92, 54, 37, 108, 200, 300, 853, 4886
INVAR-10, Run: 050, P, 0, 183, 0, 0, 0, 0, 435, 109, 435, 0, 0, 18, 200, 815, 4366, 91, 58, 33, 109, 200, 300, 815, 4801
INVAR-10, Run: 051, P, 0, 616, 0, 0, 0, 108, 108, 0, 0, 1, 0, 16, 200, 792, 4427, 92, 66, 25, 108, 200, 300, 900, 4427
INVAR-10, Run: 052, P, 0, 616, 0, 0, 0, 108, 108, 0, 0, 1, 0, 16, 200, 827, 3966, 92, 54, 37, 108, 200, 300, 935, 3966
INVAR-10, Run: 053, P, 0, 614, 0, 0, 0, 107, 107, 0, 0, 1, 0, 14, 200, 754, 4332, 93, 59, 33, 107, 200, 300, 861, 4332
INVAR-10, Run: 054, P, 0, 490, 0, 0, 0, 0, 126, 108, 126, 0, 0, 16, 200, 685, 4141, 92, 58, 34, 108, 200, 300, 685, 4267
INVAR-10, Run: 055, P, 0, 624, 0, 0, 0, 112, 112, 0, 0, 1, 0, 24, 200, 835, 4410, 88, 56, 31, 112, 200, 300, 947, 4410
INVAR-10, Run: 056, P, 0, 276, 0, 0, 0, 0, 346, 111, 346, 0, 0, 22, 200, 939, 3841, 89, 51, 38, 111, 200, 300, 939, 4187
INVAR-10, Run: 057, P, 0, 540, 0, 0, 0, 0, 90, 115, 90, 0, 0, 30, 200, 782, 4623, 85, 57, 28, 115, 200, 300, 782, 4713
INVAR-10, Run: 058, P, 0, 616, 0, 0, 0, 108, 108, 0, 0, 1, 0, 16, 200, 812, 4034, 92, 60, 31, 108, 200, 300, 920, 4034
INVAR-10, Run: 059, P, 0, 22, 0, 0, 0, 0, 594, 108, 594, 0, 0, 16, 200, 699, 3702, 92, 56, 36, 108, 200, 300, 699, 4296
INVAR-10, Run: 060, P, 0, 624, 0, 0, 0, 112, 112, 0, 0, 1, 0, 24, 200, 813, 3814, 88, 50, 37, 112, 200, 300, 925, 3814
INVAR-10, Run: 061, P, 0, 206, 0, 0, 0, 0, 414, 110, 414, 0, 0, 20, 200, 882, 4895, 90, 56, 34, 110, 200, 300, 882, 5309
INVAR-10, Run: 062, P, 0, 626, 0, 0, 0, 113, 113, 0, 0, 1, 0, 26, 200, 852, 3729, 87, 59, 27, 113, 200, 300, 965, 3729
INVAR-10, Run: 063, P, 0, 618, 0, 0, 0, 109, 109, 0, 0, 1, 0, 18, 200, 741, 5763, 91, 61, 29, 109, 200, 300, 850, 5763
INVAR-10, Run: 064, P, 0, 9, 0, 0, 0, 0, 609, 109, 609, 0, 0, 18, 200, 598, 3689, 91, 50, 41, 109, 200, 300, 598, 4298
INVAR-10, Run: 065, P, 0, 32, 0, 0, 0, 0, 588, 110, 588, 0, 0, 20, 200, 958, 4294, 90, 43, 47, 110, 200, 300, 958, 4882
INVAR-10, Run: 066, P, 0, 622, 0, 0, 0, 111, 111, 0, 0, 1, 0, 22, 200, 717, 4346, 89, 53, 35, 111, 200, 300, 828, 4346
INVAR-10, Run: 067, P, 0, 616, 0, 0, 0, 108, 108, 0, 0, 1, 0, 16, 200, 1019, 5577, 92, 59, 32, 108, 200, 300, 1127, 5577
INVAR-10, Run: 068, P, 0, 145, 0, 0, 0, 0, 473, 109, 473, 0, 0, 18, 200, 926, 4700, 91, 59, 32, 109, 200, 300, 926, 5173
INVAR-10, Run: 069, P, 0, 622, 0, 0, 0, 111, 111, 0, 0, 1, 0, 22, 200, 775, 3794, 89, 61, 27, 111, 200, 300, 886, 3794
INVAR-10, Run: 070, P, 0, 616, 0, 0, 0, 108, 108, 0, 0, 1, 0, 16, 200, 1090, 3634, 92, 52, 39, 108, 200, 300, 1198, 3634
INVAR-10, Run: 071, P, 0, 454, 0, 0, 0, 0, 166, 110, 166, 0, 0, 20, 200, 909, 4128, 90, 54, 36, 110, 200, 300, 909, 4294
INVAR-10, Run: 072, P, 0, 614, 0, 0, 0, 107, 107, 0, 0, 1, 0, 14, 200, 834, 4192, 93, 66, 26, 107, 200, 300, 941, 4192
INVAR-10, Run: 073, P, 0, 106, 0, 0, 0, 0, 510, 108, 510, 0, 0, 16, 200, 1020, 4978, 92, 59, 33, 108, 200, 300, 1020, 5488
INVAR-10, Run: 074, P, 0, 618, 0, 0, 0, 109, 109, 0, 0, 1, 0, 18, 200, 860, 5091, 91, 65, 25, 109, 200, 300, 969, 5091
INVAR-10, Run: 075, P, 0, 231, 0, 0, 0, 0, 403, 117, 403, 0, 0, 34, 200, 672, 3771, 83, 53, 30, 117, 200, 300, 672, 4174
INVAR-10, Run: 076, P, 0, 314, 0, 0, 0, 0, 298, 106, 298, 0, 0, 12, 200, 742, 4642, 94, 57, 37, 106, 200, 300, 742, 4940
INVAR-10, Run: 077, P, 0, 99, 0, 0, 0, 0, 527, 113, 527, 0, 0, 26, 200, 712, 3846, 87, 66, 21, 113, 200, 300, 712, 4373
INVAR-10, Run: 078, P, 0, 618, 0, 0, 0, 109, 109, 0, 0, 1, 0, 18, 200, 874, 3506, 91, 60, 30, 109, 200, 300, 983, 3506
INVAR-10, Run: 079, P, 0, 204, 0, 0, 0, 0, 422, 113, 422, 0, 0, 26, 200, 681, 4516, 87, 55, 32, 113, 200, 300, 681, 4938
INVAR-10, Run: 080, P, 0, 49, 0, 0, 0, 0, 579, 114, 579, 0, 0, 28, 200, 675, 3726, 86, 67, 19, 114, 200, 300, 675, 4305
INVAR-10, Run: 081, P, 0, 577, 0, 0, 0, 0, 43, 110, 43, 0, 0, 20, 200, 907, 4870, 90, 58, 32, 110, 200, 300, 907, 4913
INVAR-10, Run: 082, P, 0, 618, 0, 0, 0, 109, 109, 0, 0, 1, 0, 18, 200, 673, 3672, 91, 57, 33, 109, 200, 300, 782, 3672
INVAR-10, Run: 083, P, 0, 620, 0, 0, 0, 110, 110, 0, 0, 1, 0, 20, 200, 749, 3612, 90, 48, 41, 110, 200, 300, 859, 3612
INVAR-10, Run: 084, P, 0, 634, 0, 0, 0, 117, 117, 0, 0, 1, 0, 34, 200, 1173, 5602, 83, 57, 25, 117, 200, 300, 1290, 5602
INVAR-10, Run: 085, P, 0, 614, 0, 0, 0, 107, 107, 0, 0, 1, 0, 14, 200, 833, 4834, 93, 61, 31, 107, 200, 300, 940, 4834
INVAR-10, Run: 086, P, 0, 234, 0, 0, 0, 0, 382, 108, 382, 0, 0, 16, 200, 829, 4916, 92, 56, 36, 108, 200, 300, 829, 5298
INVAR-10, Run: 087, P, 0, 616, 0, 0, 0, 108, 108, 0, 0, 1, 0, 16, 200, 785, 4138, 92, 62, 29, 108, 200, 300, 893, 4138
INVAR-10, Run: 088, P, 0, 624, 0, 0, 0, 112, 112, 0, 0, 1, 0, 24, 200, 743, 4334, 88, 44, 43, 112, 200, 300, 855, 4334
INVAR-10, Run: 089, P, 0, 574, 0, 0, 0, 0, 44, 109, 44, 0, 0, 18, 200, 1078, 4617, 91, 59, 32, 109, 200, 300, 1078, 4661
INVAR-10, Run: 090, P, 0, 612, 0, 0, 0, 106, 106, 0, 0, 1, 0, 12, 200, 833, 4718, 94, 54, 39, 106, 200, 300, 939, 4718
INVAR-10, Run: 091, P, 0, 466, 0, 0, 0, 0, 166, 116, 166, 0, 0, 32, 200, 902, 4018, 84, 57, 27, 116, 200, 300, 902, 4184
INVAR-10, Run: 092, P, 0, 620, 0, 0, 0, 110, 110, 0, 0, 1, 0, 20, 200, 689, 4319, 90, 42, 47, 110, 200, 300, 799, 4319
INVAR-10, Run: 093, P, 0, 337, 0, 0, 0, 0, 283, 110, 283, 0, 0, 20, 200, 719, 3444, 90, 56, 34, 110, 200, 300, 719, 3727
INVAR-10, Run: 094, P, 0, 614, 0, 0, 0, 107, 107, 0, 0, 1, 0, 14, 200, 859, 4838, 93, 67, 25, 107, 200, 300, 966, 4838
INVAR-10, Run: 095, P, 0, 603, 0, 0, 0, 8, 27, 103, 19, 0, 0, 22, 200, 850, 3831, 89, 52, 37, 111, 200, 300, 858, 3850
INVAR-10, Run: 096, P, 0, 620, 0, 0, 0, 110, 110, 0, 0, 1, 0, 20, 200, 1182, 4711, 90, 59, 30, 110, 200, 300, 1292, 4711
INVAR-10, Run: 097, P, 0, 618, 0, 0, 0, 109, 109, 0, 0, 1, 0, 18, 200, 720, 4407, 91, 52, 38, 109, 200, 300, 829, 4407
INVAR-10, Run: 098, P, 0, 130, 0, 0, 0, 0, 492, 111, 492, 0, 0, 22, 200, 886, 4581, 89, 57, 32, 111, 200, 300, 886, 5073
INVAR-10, Run: 099, P, 0, 246, 0, 0, 0, 0, 374, 110, 374, 0, 0, 20, 200, 799, 4026, 90, 56, 34, 110, 200, 300, 799, 4400
INVAR-10, Run: 100, P, 0, 618, 0, 0, 0, 109, 109, 0, 0, 1, 0, 18, 200, 750, 4068, 91, 53, 37, 109, 200, 300, 859, 4068
INVAR-2, Run: 001, P, 0, 62, 0, 0, 0, 0, 118, 34, 118, 0, 0, 12, 56, 105, 648, 22, 15, 7, 34, 56, 84, 105, 766
INVAR-2, Run: 002, P, 0, 178, 0, 0, 0, 33, 33, 0, 0, 1, 0, 10, 56, 93, 534, 23, 16, 6, 33, 56, 84, 126, 534
INVAR-2, Run: 003, P, 0, 69, 0, 0, 0, 0, 107, 32, 107, 0, 0, 8, 56, 97, 562, 24, 18, 6, 32, 56, 84, 97, 669
INVAR-2, Run: 004, P, 0, 178, 0, 0, 0, 33, 33, 0, 0, 1, 0, 10, 56, 107, 663, 23, 16, 6, 33, 56, 84, 140, 663
INVAR-2, Run: 005, P, 0, 126, 0, 0, 0, 0, 54, 34, 54, 0, 0, 12, 56, 71, 494, 22, 16, 6, 34, 56, 84, 71, 548
INVAR-2, Run: 006, P, 0, 176, 0, 0, 0, 32, 32, 0, 0, 1, 0, 8, 56, 87, 402, 24, 18, 5, 32, 56, 84, 119, 402
INVAR-2, Run: 007, P, 0, 19, 0, 0, 0, 0, 163, 35, 163, 0, 0, 14, 56, 139, 518, 21, 10, 11, 35, 56, 84, 139, 681
INVAR-2, Run: 008, P, 0, 54, 0, 0, 0, 0, 120, 31, 120, 0, 0, 6, 56, 115, 367, 25, 16, 9, 31, 56, 84, 115, 487
INVAR-2, Run: 009, P, 0, 176, 0, 0, 0, 32, 32, 0, 0, 1, 0, 8, 56, 93, 337, 24, 11, 12, 32, 56, 84, 125, 337
INVAR-2, Run: 010, P, 0, 147, 0, 0, 0, 0, 29, 32, 29, 0, 0, 8, 56, 143, 505, 24, 13, 11, 32, 56, 84, 143, 534
INVAR-2, Run: 011, P, 0, 178, 0, 0, 0, 33, 33, 0, 0, 1, 0, 10, 56, 98, 532, 23, 17, 5, 33, 56, 84, 131, 532
INVAR-2, Run: 012, P, 0, 75, 0, 0, 0, 0, 99, 31, 99, 0, 0, 6, 56, 127, 451, 25, 12, 13, 31, 56, 84, 127, 550
INVAR-2, Run: 013, P, 0, 129, 0, 0, 0, 0, 45, 31, 45, 0, 0, 6, 56, 84, 349, 25, 16, 9, 31, 56, 84, 84, 394
INVAR-2, Run: 014, P, 0, 27, 0, 0, 0, 0, 151, 33, 151, 0, 0, 10, 56, 180, 560, 23, 10, 13, 33, 56, 84, 180, 711
INVAR-2, Run: 015, P, 0, 176, 0, 0, 0, 32, 32, 0, 0, 1, 0, 8, 56, 161, 585, 24, 12, 11, 32, 56, 84, 193, 585
INVAR-2, Run: 016, P, 0, 176, 0, 0, 0, 32, 32, 0, 0, 1, 0, 8, 56, 101, 523, 24, 14, 9, 32, 56, 84, 133, 523
INVAR-2, Run: 017, P, 0, 176, 0, 0, 0, 32, 32, 0, 0, 1, 0, 8, 56, 69, 385, 24, 15, 8, 32, 56, 84, 101, 385
INVAR-2, Run: 018, P, 0, 176, 0, 0, 0, 32, 32, 0, 0, 1, 0, 8, 56, 173, 743, 24, 13, 10, 32, 56, 84, 205, 743
INVAR-2, Run: 019, P, 0, 34, 0, 0, 0, 0, 148, 35, 148, 0, 0, 14, 56, 68, 294, 21, 15, 6, 35, 56, 84, 68, 442
INVAR-2, Run: 020, P, 0, 176, 0, 0, 0, 32, 32, 0, 0, 1, 0, 8, 56, 100, 477, 24, 15, 8, 32, 56, 84, 132, 477
INVAR-2, Run: 021, P, 0, 174, 0, 0, 0, 31, 31, 0, 0, 1, 0, 6, 56, 64, 303, 25, 16, 8, 31, 56, 84, 95, 303
INVAR-2, Run: 022, P, 0, 174, 0, 0, 0, 31, 31, 0, 0, 1, 0, 6, 56, 121, 512, 25, 13, 11, 31, 56, 84, 152, 512
INVAR-2, Run: 023, P, 0, 178, 0, 0, 0, 33, 33, 0, 0, 1, 0, 10, 56, 106, 426, 23, 12, 10, 33, 56, 84, 139, 426
INVAR-2, Run: 024, P, 0, 88, 0, 0, 0, 0, 96, 36, 96, 0, 0, 16, 56, 110, 768, 20, 15, 5, 36, 56, 84, 110, 864
INVAR-2, Run: 025, P, 0, 130, 0, 0, 0, 0, 46, 32, 46, 0, 0, 8, 56, 115, 685, 24, 17, 7, 32, 56, 84, 115, 731
INVAR-2, Run: 026, P, 0, 182, 0, 0, 0, 35, 35, 0, 0, 1, 0, 14, 56, 96, 495, 21, 14, 6, 35, 56, 84, 131, 495
INVAR-2, Run: 027, P, 0, 23, 0, 0, 0, 0, 159, 35, 159, 0, 0, 14, 56, 55, 317, 21, 15, 6, 35, 56, 84, 55, 476
INVAR-2, Run: 028, P, 0, 180, 0, 0, 0, 34, 34, 0, 0, 1, 0, 12, 56, 99, 740, 22, 12, 9, 34, 56, 84, 133, 740
INVAR-2, Run: 029, P, 0, 96, 0, 0, 0, 0, 82, 33, 82, 0, 0, 10, 56, 139, 543, 23, 15, 8, 33, 56, 84, 139, 625
INVAR-2, Run: 030, P, 0, 178, 0, 0, 0, 33, 33, 0, 0, 1, 0, 10, 56, 152, 427, 23, 13, 9, 33, 56, 84, 185, 427
INVAR-2, Run: 031, P, 0, 176, 0, 0, 0, 32, 32, 0, 0, 1, 0, 8, 56, 97, 450, 24, 17, 6, 32, 56, 84, 129, 450
INVAR-2, Run: 032, P, 0, 174, 0, 0, 0, 31, 31, 0, 0, 1, 0, 6, 56, 134, 575, 25, 17, 7, 31, 56, 84, 165, 575
INVAR-2, Run: 033, P, 0, 148, 0, 0, 0, 0, 30, 33, 30, 0, 0, 10, 56, 151, 569, 23, 16, 7, 33, 56, 84, 151, 599
INVAR-2, Run: 034, P, 0, 61, 0, 0, 0, 0, 115, 32, 115, 0, 0, 8, 56, 111, 342, 24, 11, 13, 32, 56, 84, 111, 457
INVAR-2, Run: 035, P, 0, 82, 0, 0, 0, 0, 94, 32, 94, 0, 0, 8, 56, 114, 466, 24, 14, 10, 32, 56, 84, 114, 560
INVAR-2, Run: 036, P, 0, 135, 0, 0, 0, 0, 41, 32, 41, 0, 0, 8, 56, 116, 349, 24, 16, 8, 32, 56, 84, 116, 390
INVAR-2, Run: 037, P, 0, 152, 0, 0, 0, 1, 25, 31, 24, 0, 0, 8, 56, 115, 463, 24, 15, 9, 32, 56, 84, 116, 487
INVAR-2, Run: 038, P, 0, 176, 0, 0, 0, 32, 32, 0, 0, 1, 0, 8, 56, 100, 470, 24, 18, 5, 32, 56, 84, 132, 470
INVAR-2, Run: 039, P, 0, 178, 0, 0, 0, 33, 33, 0, 0, 1, 0, 10, 56, 91, 697, 23, 14, 8, 33, 56, 84, 124, 697
INVAR-2, Run: 040, P, 0, 174, 0, 0, 0, 31, 31, 0, 0, 1, 0, 6, 56, 79, 549, 25, 19, 5, 31, 56, 84, 110, 549
INVAR-2, Run: 041, P, 0, 180, 0, 0, 0, 34, 34, 0, 0, 1, 0, 12, 56, 138, 637, 22, 16, 5, 34, 56, 84, 172, 637
INVAR-2, Run: 042, P, 0, 180, 0, 0, 0, 34, 34, 0, 0, 1, 0, 12, 56, 126, 659, 22, 15, 6, 34, 56, 84, 160, 659
INVAR-2, Run: 043, P, 0, 180, 0, 0, 0, 34, 34, 0, 0, 1, 0, 12, 56, 72, 544, 22, 15, 6, 34, 56, 84, 106, 544
INVAR-2, Run: 044, P, 0, 178, 0, 0, 0, 33, 33, 0, 0, 1, 0, 10, 56, 65, 428, 23, 14, 8, 33, 56, 84, 98, 428
INVAR-2, Run: 045, P, 0, 41, 0, 0, 0, 0, 137, 33, 137, 0, 0, 10, 56, 82, 240, 23, 19, 4, 33, 56, 84, 82, 377
INVAR-2, Run: 046, P, 0, 178, 0, 0, 0, 33, 33, 0, 0, 1, 0, 10, 56, 142, 600, 23, 13, 9, 33, 56, 84, 175, 600
INVAR-2, Run: 047, P, 0, 92, 0, 0, 0, 0, 86, 33, 86, 0, 0, 10, 56, 101, 603, 23, 20, 3, 33, 56, 84, 101, 689
INVAR-2, Run: 048, P, 0, 99, 0, 0, 0, 0, 81, 34, 81, 0, 0, 12, 56, 98, 447, 22, 16, 6, 34, 56, 84, 98, 528
INVAR-2, Run: 049, P, 0, 176, 0, 0, 0, 32, 32, 0, 0, 1, 0, 8, 56, 124, 725, 24, 19, 4, 32, 56, 84, 156, 725
INVAR-2, Run: 050, P, 0, 17, 0, 0, 0, 0, 167, 36, 167, 0, 0, 16, 56, 53, 268, 20, 15, 5, 36, 56, 84, 53, 435
INVAR-2, Run: 051, P, 0, 94, 0, 0, 0, 0, 84, 33, 84, 0, 0, 10, 56, 124, 520, 23, 17, 6, 33, 56, 84, 124, 604
INVAR-2, Run: 052, P, 0, 64, 0, 0, 0, 0, 120, 36, 120, 0, 0, 16, 56, 55, 400, 20, 17, 3, 36, 56, 84, 55, 520
INVAR-2, Run: 053, P, 0, 38, 0, 0, 0, 0, 142, 34, 142, 0, 0, 12, 56, 78, 662, 22, 18, 4, 34, 56, 84, 78, 804
INVAR-2, Run: 054, P, 0, 20, 0, 0, 0, 0, 162, 35, 162, 0, 0, 14, 56, 126, 495, 21, 12, 9, 35, 56, 84, 126, 657
INVAR-2, Run: 055, P, 0, 182, 0, 0, 0, 35, 35, 0, 0, 1, 0, 14, 56, 62, 517, 21, 14, 6, 35, 56, 84, 97, 517
INVAR-2, Run: 056, P, 0, 3, 0, 0, 0, 0, 177, 34, 177, 0, 0, 12, 56, 75, 496, 22, 14, 8, 34, 56, 84, 75, 673
INVAR-2, Run: 057, P, 0, 6, 0, 0, 0, 0, 172, 33, 172, 0, 0, 10, 56, 91, 361, 23, 13, 10, 33, 56, 84, 91, 533
INVAR-2, Run: 058, P, 0, 180, 0, 0, 0, 34, 34, 0, 0, 1, 0, 12, 56, 159, 681, 22, 13, 8, 34, 56, 84, 193, 681
INVAR-2, Run: 059, P, 0, 43, 0, 0, 0, 0, 133, 32, 133, 0, 0, 8, 56, 136, 340, 24, 17, 7, 32, 56, 84, 136, 473
INVAR-2, Run: 060, P, 0, 13, 0, 0, 0, 0, 167, 34, 167, 0, 0, 12, 56, 144, 626, 22, 14, 8, 34, 56, 84, 144, 793
INVAR-2, Run: 061, P, 0, 70, 0, 0, 0, 0, 110, 34, 110, 0, 0, 12, 56, 154, 724, 22, 14, 8, 34, 56, 84, 154, 834
INVAR-2, Run: 062, P, 0, 69, 0, 0, 0, 0, 107, 32, 107, 0, 0, 8, 56, 154, 585, 24, 15, 9, 32, 56, 84, 154, 692
INVAR-2, Run: 063, P, 0, 128, 0, 0, 0, 0, 52, 34, 52, 0, 0, 12, 56, 69, 531, 22, 17, 5, 34, 56, 84, 69, 583
INVAR-2, Run: 064, P, 0, 178, 0, 0, 0, 33, 33, 0, 0, 1, 0, 10, 56, 137, 538, 23, 12, 10, 33, 56, 84, 170, 538
INVAR-2, Run: 065, P, 0, 163, 0, 0, 0, 2, 17, 31, 15, 0, 0, 10, 56, 73, 363, 23, 13, 10, 33, 56, 84, 75, 378
INVAR-2, Run: 066, P, 0, 174, 0, 0, 0, 31, 31, 0, 0, 1, 0, 6, 56, 109, 705, 25, 14, 10, 31, 56, 84, 140, 705
INVAR-2, Run: 067, P, 0, 176, 0, 0, 0, 32, 32, 0, 0, 1, 0, 8, 56, 155, 552, 24, 14, 9, 32, 56, 84, 187, 552
INVAR-2, Run: 068, P, 0, 178, 0, 0, 0, 33, 33, 0, 0, 1, 0, 10, 56, 141, 898, 23, 14, 8, 33, 56, 84, 174, 898
INVAR-2, Run: 069, P, 0, 176, 0, 0, 0, 32, 32, 0, 0, 1, 0, 8, 56, 114, 535, 24, 14, 9, 32, 56, 84, 146, 535
INVAR-2, Run: 070, P, 0, 8, 0, 0, 0, 0, 170, 33, 170, 0, 0, 10, 56, 59, 408, 23, 16, 7, 33, 56, 84, 59, 578
INVAR-2, Run: 071, P, 0, 98, 0, 0, 0, 0, 78, 32, 78, 0, 0, 8, 56, 126, 499, 24, 11, 13, 32, 56, 84, 126, 577
INVAR-2, Run: 072, P, 0, 180, 0, 0, 0, 34, 34, 0, 0, 1, 0, 12, 56, 150, 648, 22, 17, 4, 34, 56, 84, 184, 648
INVAR-2, Run: 073, P, 0, 22, 0, 0, 0, 0, 152, 31, 152, 0, 0, 6, 56, 103, 333, 25, 11, 14, 31, 56, 84, 103, 485
INVAR-2, Run: 074, P, 0, 174, 0, 0, 0, 31, 31, 0, 0, 1, 0, 6, 56, 99, 413, 25, 15, 9, 31, 56, 84, 130, 413
INVAR-2, Run: 075, P, 0, 178, 0, 0, 0, 33, 33, 0, 0, 1, 0, 10, 56, 84, 440, 23, 14, 8, 33, 56, 84, 117, 440
INVAR-2, Run: 076, P, 0, 138, 0, 0, 0, 0, 42, 34, 42, 0, 0, 12, 56, 173, 798, 22, 13, 9, 34, 56, 84, 173, 840
INVAR-2, Run: 077, P, 0, 178, 0, 0, 0, 33, 33, 0, 0, 1, 0, 10, 56, 75, 453, 23, 16, 6, 33, 56, 84, 108, 453
INVAR-2, Run: 078, P, 0, 178, 0, 0, 0, 33, 33, 0, 0, 1, 0, 10, 56, 172, 592, 23, 14, 8, 33, 56, 84, 205, 592
INVAR-2, Run: 079, P, 0, 184, 0, 0, 0, 36, 36, 0, 0, 1, 0, 16, 56, 152, 762, 20, 13, 6, 36, 56, 84, 188, 762
INVAR-2, Run: 080, P, 0, 178, 0, 0, 0, 33, 33, 0, 0, 1, 0, 10, 56, 84, 495, 23, 18, 4, 33, 56, 84, 117, 495
INVAR-2, Run: 081, P, 0, 176, 0, 0, 0, 32, 32, 0, 0, 1, 0, 8, 56, 103, 642, 24, 12, 11, 32, 56, 84, 135, 642
INVAR-2, Run: 082, P, 0, 178, 0, 0, 0, 33, 33, 0, 0, 1, 0, 10, 56, 154, 487, 23, 10, 12, 33, 56, 84, 187, 487
INVAR-2, Run: 083, P, 0, 172, 0, 0, 0, 30, 30, 0, 0, 1, 0, 4, 56, 92, 433, 26, 17, 8, 30, 56, 84, 122, 433
INVAR-2, Run: 084, P, 0, 29, 0, 0, 0, 0, 145, 31, 145, 0, 0, 6, 56, 116, 375, 25, 13, 12, 31, 56, 84, 116, 520
INVAR-2, Run: 085, P, 0, 21, 0, 0, 0, 0, 157, 33, 157, 0, 0, 10, 56, 67, 325, 23, 16, 7, 33, 56, 84, 67, 482
INVAR-2, Run: 086, P, 0, 184, 0, 0, 0, 36, 36, 0, 0, 1, 0, 16, 56, 130, 595, 20, 10, 9, 36, 56, 84, 166, 595
INVAR-2, Run: 087, P, 0, 82, 0, 0, 0, 0, 98, 34, 98, 0, 0, 12, 56, 218, 613, 22, 15, 7, 34, 56, 84, 218, 711
INVAR-2, Run: 088, P, 0, 178, 0, 0, 0, 33, 33, 0, 0, 1, 0, 10, 56, 130, 428, 23, 14, 8, 33, 56, 84, 163, 428
INVAR-2, Run: 089, P, 0, 100, 0, 0, 0, 0, 76, 32, 76, 0, 0, 8, 56, 102, 628, 24, 19, 5, 32, 56, 84, 102, 704
INVAR-2, Run: 090, P, 0, 24, 0, 0, 0, 0, 158, 35, 158, 0, 0, 14, 56, 131, 473, 21, 12, 9, 35, 56, 84, 131, 631
INVAR-2, Run: 091, P, 0, 178, 0, 0, 0, 33, 33, 0, 0, 1, 0, 10, 56, 144, 671, 23, 17, 5, 33, 56, 84, 177, 671
INVAR-2, Run: 092, P, 0, 178, 0, 0, 0, 33, 33, 0, 0, 1, 0, 10, 56, 125, 589, 23, 14, 8, 33, 56, 84, 158, 589
INVAR-2, Run: 093, P, 0, 25, 0, 0, 0, 0, 153, 33, 153, 0, 0, 10, 56, 80, 390, 23, 15, 8, 33, 56, 84, 80, 543
INVAR-2, Run: 094, P, 0, 12, 0, 0, 0, 0, 166, 33, 166, 0, 0, 10, 56, 144, 683, 23, 17, 6, 33, 56, 84, 144, 849
INVAR-2, Run: 095, P, 0, 42, 0, 0, 0, 0, 138, 34, 138, 0, 0, 12, 56, 104, 700, 22, 14, 8, 34, 56, 84, 104, 838
INVAR-2, Run: 096, P, 0, 176, 0, 0, 0, 32, 32, 0, 0, 1, 0, 8, 56, 145, 768, 24, 15, 8, 32, 56, 84, 177, 768
INVAR-2, Run: 097, P, 0, 108, 0, 0, 0, 0, 64, 30, 64, 0, 0, 4, 56, 131, 503, 26, 12, 14, 30, 56, 84, 131, 567
INVAR-2, Run: 098, P, 0, 65, 0, 0, 0, 0, 111, 32, 111, 0, 0, 8, 56, 97, 564, 24, 18, 6, 32, 56, 84, 97, 675
INVAR-2, Run: 099, P, 0, 182, 0, 0, 0, 35, 35, 0, 0, 1, 0, 14, 56, 160, 678, 21, 12, 8, 35, 56, 84, 195, 678
INVAR-2, Run: 100, P, 0, 178, 0, 0, 0, 33, 33, 0, 0, 1, 0, 10, 56, 71, 279, 23, 19, 3, 33, 56, 84, 104, 279
INVAR-3, Run: 001, P, 0, 506, 0, 0, 0, 89, 89, 0, 0, 1, 0, 14, 164, 508, 2865, 75, 50, 24, 89, 164, 246, 597, 2865
INVAR-3, Run: 002, P, 0, 37, 0, 0, 0, 0, 473, 91, 473, 0, 0, 18, 164, 530, 3116, 73, 41, 32, 91, 164, 246, 530, 3589
INVAR-3, Run: 003, P, 0, 10, 0, 0, 0, 0, 500, 91, 500, 0, 0, 18, 164, 542, 2838, 73, 46, 27, 91, 164, 246, 542, 3338
INVAR-3, Run: 004, P, 0, 419, 0, 0, 0, 0, 87, 89, 87, 0, 0, 14, 164, 672, 3931, 75, 44, 31, 89, 164, 246, 672, 4018
INVAR-3, Run: 005, P, 0, 510, 0, 0, 0, 91, 91, 0, 0, 1, 0, 18, 164, 689, 4160, 73, 50, 22, 91, 164, 246, 780, 4160
INVAR-3, Run: 006, P, 0, 180, 0, 0, 0, 0, 330, 91, 330, 0, 0, 18, 164, 719, 3009, 73, 43, 30, 91, 164, 246, 719, 3339
INVAR-3, Run: 007, P, 0, 415, 0, 0, 0, 0, 95, 91, 95, 0, 0, 18, 164, 731, 2461, 73, 42, 31, 91, 164, 246, 731, 2556
INVAR-3, Run: 008, P, 0, 508, 0, 0, 0, 90, 90, 0, 0, 1, 0, 16, 164, 651, 3736, 74, 46, 27, 90, 164, 246, 741, 3736
INVAR-3, Run: 009, P, 0, 500, 0, 0, 0, 86, 86, 0, 0, 1, 0, 8, 164, 759, 2769, 78, 43, 34, 86, 164, 246, 845, 2769
INVAR-3, Run: 010, P, 0, 216, 0, 0, 0, 0, 294, 91, 294, 0, 0, 18, 164, 573, 2769, 73, 54, 19, 91, 164, 246, 573, 3063
INVAR-3, Run: 011, P, 0, 227, 0, 0, 0, 0, 279, 89, 279, 0, 0, 14, 164, 726, 3143, 75, 44, 31, 89, 164, 246, 726, 3422
INVAR-3, Run: 012, P, 0, 508, 0, 0, 0, 90, 90, 0, 0, 1, 0, 16, 164, 846, 4044, 74, 51, 22, 90, 164, 246, 936, 4044
INVAR-3, Run: 013, P, 0, 508, 0, 0, 0, 90, 90, 0, 0, 1, 0, 16, 164, 609, 2771, 74, 41, 32, 90, 164, 246, 699, 2771
INVAR-3, Run: 014, P, 0, 37, 0, 0, 0, 0, 473, 91, 473, 0, 0, 18, 164, 539, 2510, 73, 44, 29, 91, 164, 246, 539, 2983
INVAR-3, Run: 015, P, 0, 504, 0, 0, 0, 88, 88, 0, 0, 1, 0, 12, 164, 648, 2916, 76, 49, 26, 88, 164, 246, 736, 2916
INVAR-3, Run: 016, P, 0, 269, 0, 0, 0, 0, 243, 92, 243, 0, 0, 20, 164, 561, 2486, 72, 49, 23, 92, 164, 246, 561, 2729
INVAR-3, Run: 017, P, 0, 17, 0, 0, 0, 0, 489, 89, 489, 0, 0, 14, 164, 575, 2877, 75, 40, 35, 89, 164, 246, 575, 3366
INVAR-3, Run: 018, P, 0, 89, 0, 0, 0, 0, 417, 89, 417, 0, 0, 14, 164, 772, 3731, 75, 51, 24, 89, 164, 246, 772, 4148
INVAR-3, Run: 019, P, 0, 10, 0, 0, 0, 0, 498, 90, 498, 0, 0, 16, 164, 755, 3047, 74, 47, 27, 90, 164, 246, 755, 3545
INVAR-3, Run: 020, P, 0, 504, 0, 0, 0, 88, 88, 0, 0, 1, 0, 12, 164, 438, 3096, 76, 59, 16, 88, 164, 246, 526, 3096
INVAR-3, Run: 021, P, 0, 138, 0, 0, 0, 0, 374, 92, 374, 0, 0, 20, 164, 678, 2815, 72, 44, 28, 92, 164, 246, 678, 3189
INVAR-3, Run: 022, P, 0, 502, 0, 0, 0, 87, 87, 0, 0, 1, 0, 10, 164, 608, 3619, 77, 49, 27, 87, 164, 246, 695, 3619
INVAR-3, Run: 023, P, 0, 19, 0, 0, 0, 0, 497, 94, 497, 0, 0, 24, 164, 484, 2346, 70, 40, 30, 94, 164, 246, 484, 2843
INVAR-3, Run: 024, P, 0, 184, 0, 0, 0, 0, 328, 92, 328, 0, 0, 20, 164, 605, 2870, 72, 52, 20, 92, 164, 246, 605, 3198
INVAR-3, Run: 025, P, 0, 506, 0, 0, 0, 89, 89, 0, 0, 1, 0, 14, 164, 672, 3010, 75, 46, 28, 89, 164, 246, 761, 3010
INVAR-3, Run: 026, P, 0, 87, 0, 0, 0, 0, 423, 91, 423, 0, 0, 18, 164, 515, 3792, 73, 53, 20, 91, 164, 246, 515, 4215
INVAR-3, Run: 027, P, 0, 506, 0, 0, 0, 89, 89, 0, 0, 1, 0, 14, 164, 479, 2232, 75, 37, 37, 89, 164, 246, 568, 2232
INVAR-3, Run: 028, P, 0, 510, 0, 0, 0, 91, 91, 0, 0, 1, 0, 18, 164, 480, 2945, 73, 52, 20, 91, 164, 246, 571, 2945
INVAR-3, Run: 029, P, 0, 16, 0, 0, 0, 0, 490, 89, 490, 0, 0, 14, 164, 535, 2410, 75, 51, 24, 89, 164, 246, 535, 2900
INVAR-3, Run: 030, P, 0, 297, 0, 0, 0, 0, 217, 93, 217, 0, 0, 22, 164, 690, 2991, 71, 43, 28, 93, 164, 246, 690, 3208
INVAR-3, Run: 031, P, 0, 500, 0, 0, 0, 86, 86, 0, 0, 1, 0, 8, 164, 583, 2990, 78, 48, 29, 86, 164, 246, 669, 2990
INVAR-3, Run: 032, P, 0, 172, 0, 0, 0, 0, 342, 93, 342, 0, 0, 22, 164, 402, 3189, 71, 51, 20, 93, 164, 246, 402, 3531
INVAR-3, Run: 033, P, 0, 366, 0, 0, 0, 0, 146, 92, 146, 0, 0, 20, 164, 611, 2742, 72, 46, 26, 92, 164, 246, 611, 2888
INVAR-3, Run: 034, P, 0, 510, 0, 0, 0, 91, 91, 0, 0, 1, 0, 18, 164, 660, 3499, 73, 52, 20, 91, 164, 246, 751, 3499
INVAR-3, Run: 035, P, 0, 394, 0, 0, 0, 0, 120, 93, 120, 0, 0, 22, 164, 725, 2789, 71, 46, 25, 93, 164, 246, 725, 2909
INVAR-3, Run: 036, P, 0, 409, 0, 0, 0, 0, 101, 91, 101, 0, 0, 18, 164, 658, 4017, 73, 49, 24, 91, 164, 246, 658, 4118
INVAR-3, Run: 037, P, 0, 512, 0, 0, 0, 92, 92, 0, 0, 1, 0, 20, 164, 642, 3437, 72, 47, 24, 92, 164, 246, 734, 3437
INVAR-3, Run: 038, P, 0, 23, 0, 0, 0, 0, 493, 94, 493, 0, 0, 24, 164, 578, 2762, 70, 52, 18, 94, 164, 246, 578, 3255
INVAR-3, Run: 039, P, 0, 449, 0, 0, 0, 0, 61, 91, 61, 0, 0, 18, 164, 517, 2447, 73, 45, 28, 91, 164, 246, 517, 2508
INVAR-3, Run: 040, P, 0, 65, 0, 0, 0, 0, 451, 94, 451, 0, 0, 24, 164, 717, 3406, 70, 46, 24, 94, 164, 246, 717, 3857
INVAR-3, Run: 041, P, 0, 239, 0, 0, 0, 0, 271, 91, 271, 0, 0, 18, 164, 616, 3242, 73, 45, 28, 91, 164, 246, 616, 3513
INVAR-3, Run: 042, P, 0, 150, 0, 0, 0, 0, 368, 95, 368, 0, 0, 26, 164, 571, 2678, 69, 36, 33, 95, 164, 246, 571, 3046
INVAR-3, Run: 043, P, 0, 520, 0, 0, 0, 96, 96, 0, 0, 1, 0, 28, 164, 698, 3206, 68, 43, 24, 96, 164, 246, 794, 3206
INVAR-3, Run: 044, P, 0, 514, 0, 0, 0, 93, 93, 0, 0, 1, 0, 22, 164, 693, 3731, 71, 48, 22, 93, 164, 246, 786, 3731
INVAR-3, Run: 045, P, 0, 54, 0, 0, 0, 0, 454, 90, 454, 0, 0, 16, 164, 638, 3850, 74, 56, 18, 90, 164, 246, 638, 4304
INVAR-3, Run: 046, P, 0, 508, 0, 0, 0, 90, 90, 0, 0, 1, 0, 16, 164, 583, 3114, 74, 43, 30, 90, 164, 246, 673, 3114
INVAR-3, Run: 047, P, 0, 266, 0, 0, 0, 0, 238, 88, 238, 0, 0, 12, 164, 617, 2928, 76, 48, 28, 88, 164, 246, 617, 3166
INVAR-3, Run: 048, P, 0, 306, 0, 0, 0, 0, 206, 92, 206, 0, 0, 20, 164, 763, 3175, 72, 46, 26, 92, 164, 246, 763, 3381
INVAR-3, Run: 049, P, 0, 508, 0, 0, 0, 90, 90, 0, 0, 1, 0, 16, 164, 465, 2448, 74, 51, 22, 90, 164, 246, 555, 2448
INVAR-3, Run: 050, P, 0, 508, 0, 0, 0, 90, 90, 0, 0, 1, 0, 16, 164, 612, 3318, 74, 43, 30, 90, 164, 246, 702, 3318
INVAR-3, Run: 051, P, 0, 118, 0, 0, 0, 0, 400, 95, 400, 0, 0, 26, 164, 400, 2700, 69, 45, 24, 95, 164, 246, 400, 3100
INVAR-3, Run: 052, P, 0, 201, 0, 0, 0, 0, 311, 92, 311, 0, 0, 20, 164, 665, 3448, 72, 45, 27, 92, 164, 246, 665, 3759
INVAR-3, Run: 053, P, 0, 516, 0, 0, 0, 94, 94, 0, 0, 1, 0, 24, 164, 522, 2855, 70, 46, 23, 94, 164, 246, 616, 2855
INVAR-3, Run: 054, P, 0, 510, 0, 0, 0, 91, 91, 0, 0, 1, 0, 18, 164, 710, 4052, 73, 43, 29, 91, 164, 246, 801, 4052
INVAR-3, Run: 055, P, 0, 510, 0, 0, 0, 91, 91, 0, 0, 1, 0, 18, 164, 680, 3389, 73, 47, 25, 91, 164, 246, 771, 3389
INVAR-3, Run: 056, P, 0, 327, 0, 0, 0, 0, 183, 91, 183, 0, 0, 18, 164, 664, 2901, 73, 51, 22, 91, 164, 246, 664, 3084
INVAR-3, Run: 057, P, 0, 516, 0, 0, 0, 94, 94, 0, 0, 1, 0, 24, 164, 617, 3712, 70, 48, 21, 94, 164, 246, 711, 3712
INVAR-3, Run: 058, P, 0, 126, 0, 0, 0, 0, 386, 92, 386, 0, 0, 20, 164, 482, 2564, 72, 45, 27, 92, 164, 246, 482, 2950
INVAR-3, Run: 059, P, 0, 161, 0, 0, 0, 0, 349, 91, 349, 0, 0, 18, 164, 477, 2597, 73, 51, 22, 91, 164, 246, 477, 2946
INVAR-3, Run: 060, P, 0, 516, 0, 0, 0, 94, 94, 0, 0, 1, 0, 24, 164, 540, 3024, 70, 43, 26, 94, 164, 246, 634, 3024
INVAR-3, Run: 061, P, 0, 4, 0, 0, 0, 0, 510, 93, 510, 0, 0, 22, 164, 693, 3641, 71, 43, 28, 93, 164, 246, 693, 4151
INVAR-3, Run: 062, P, 0, 510, 0, 0, 0, 91, 91, 0, 0, 1, 0, 18, 164, 514, 2641, 73, 41, 31, 91, 164, 246, 605, 2641
INVAR-3, Run: 063, P, 0, 506, 0, 0, 0, 89, 89, 0, 0, 1, 0, 14, 164, 784, 3591, 75, 44, 30, 89, 164, 246, 873, 3591
INVAR-3, Run: 064, P, 0, 508, 0, 0, 0, 90, 90, 0, 0, 1, 0, 16, 164, 486, 2904, 74, 43, 30, 90, 164, 246, 576, 2904
INVAR-3, Run: 065, P, 0, 506, 0, 0, 0, 89, 89, 0, 0, 1, 0, 14, 164, 505, 3095, 75, 45, 29, 89, 164, 246, 594, 3095
INVAR-3, Run: 066, P, 0, 18, 0, 0, 0, 0, 494, 92, 494, 0, 0, 20, 164, 550, 2591, 72, 49, 23, 92, 164, 246, 550, 3085
INVAR-3, Run: 067, P, 0, 228, 0, 0, 0, 0, 276, 88, 276, 0, 0, 12, 164, 732, 3575, 76, 40, 36, 88, 164, 246, 732, 3851
INVAR-3, Run: 068, P, 0, 510, 0, 0, 0, 91, 91, 0, 0, 1, 0, 18, 164, 857, 5221, 73, 47, 25, 91, 164, 246, 948, 5221
INVAR-3, Run: 069, P, 0, 510, 0, 0, 0, 91, 91, 0, 0, 1, 0, 18, 164, 788, 3952, 73, 42, 30, 91, 164, 246, 879, 3952
INVAR-3, Run: 070, P, 0, 56, 0, 0, 0, 0, 456, 92, 456, 0, 0, 20, 164, 641, 3943, 72, 51, 21, 92, 164, 246, 641, 4399
INVAR-3, Run: 071, P, 0, 70, 0, 0, 0, 0, 442, 92, 442, 0, 0, 20, 164, 634, 3564, 72, 46, 26, 92, 164, 246, 634, 4006
INVAR-3, Run: 072, P, 0, 518, 0, 0, 0, 95, 95, 0, 0, 1, 0, 26, 164, 575, 3646, 69, 44, 24, 95, 164, 246, 670, 3646
INVAR-3, Run: 073, P, 0, 197, 0, 0, 0, 0, 313, 91, 313, 0, 0, 18, 164, 576, 3177, 73, 41, 32, 91, 164, 246, 576, 3490
INVAR-3, Run: 074, P, 0, 516, 0, 0, 0, 94, 94, 0, 0, 1, 0, 24, 164, 619, 3881, 70, 42, 27, 94, 164, 246, 713, 3881
INVAR-3, Run: 075, P, 0, 504, 0, 0, 0, 88, 88, 0, 0, 1, 0, 12, 164, 517, 3366, 76, 53, 22, 88, 164, 246, 605, 3366
INVAR-3, Run: 076, P, 0, 248, 0, 0, 0, 0, 254, 87, 254, 0, 0, 10, 164, 619, 3063, 77, 49, 28, 87, 164, 246, 619, 3317
INVAR-3, Run: 077, P, 0, 99, 0, 0, 0, 0, 409, 90, 409, 0, 0, 16, 164, 775, 4145, 74, 42, 32, 90, 164, 246, 775, 4554
INVAR-3, Run: 078, P, 0, 246, 0, 0, 0, 0, 266, 92, 266, 0, 0, 20, 164, 548, 2600, 72, 42, 30, 92, 164, 246, 548, 2866
INVAR-3, Run: 079, P, 0, 163, 0, 0, 0, 0, 353, 94, 353, 0, 0, 24, 164, 596, 3774, 70, 45, 25, 94, 164, 246, 596, 4127
INVAR-3, Run: 080, P, 0, 107, 0, 0, 0, 0, 405, 92, 405, 0, 0, 20, 164, 571, 2496, 72, 46, 26, 92, 164, 246, 571, 2901
INVAR-3, Run: 081, P, 0, 504, 0, 0, 0, 88, 88, 0, 0, 1, 0, 12, 164, 540, 3179, 76, 49, 26, 88, 164, 246, 628, 3179
INVAR-3, Run: 082, P, 0, 51, 0, 0, 0, 0, 459, 91, 459, 0, 0, 18, 164, 651, 2945, 73, 45, 28, 91, 164, 246, 651, 3404
INVAR-3, Run: 083, P, 0, 512, 0, 0, 0, 92, 92, 0, 0, 1, 0, 20, 164, 606, 3297, 72, 42, 29, 92, 164, 246, 698, 3297
INVAR-3, Run: 084, P, 0, 508, 0, 0, 0, 90, 90, 0, 0, 1, 0, 16, 164, 623, 2560, 74, 42, 31, 90, 164, 246, 713, 2560
INVAR-3, Run: 085, P, 0, 292, 0, 0, 0, 0, 222, 93, 222, 0, 0, 22, 164, 594, 3477, 71, 56, 15, 93, 164, 246, 594, 3699
INVAR-3, Run: 086, P, 0, 504, 0, 0, 0, 88, 88, 0, 0, 1, 0, 12, 164, 598, 2443, 76, 40, 35, 88, 164, 246, 686, 2443
INVAR-3, Run: 087, P, 0, 498, 0, 0, 0, 85, 85, 0, 0, 1, 0, 6, 164, 539, 2763, 79, 46, 32, 85, 164, 246, 624, 2763
INVAR-3, Run: 088, P, 0, 512, 0, 0, 0, 92, 92, 0, 0, 1, 0, 20, 164, 727, 3280, 72, 50, 21, 92, 164, 246, 819, 3280
INVAR-3, Run: 089, P, 0, 180, 0, 0, 0, 0, 328, 90, 328, 0, 0, 16, 164, 611, 2774, 74, 38, 36, 90, 164, 246, 611, 3102
INVAR-3, Run: 090, P, 0, 506, 0, 0, 0, 89, 89, 0, 0, 1, 0, 14, 164, 586, 3144, 75, 48, 26, 89, 164, 246, 675, 3144
INVAR-3, Run: 091, P, 0, 153, 0, 0, 0, 0, 365, 95, 365, 0, 0, 26, 164, 603, 3025, 69, 37, 32, 95, 164, 246, 603, 3390
INVAR-3, Run: 092, P, 0, 514, 0, 0, 0, 93, 93, 0, 0, 1, 0, 22, 164, 526, 3266, 71, 36, 34, 93, 164, 246, 619, 3266
INVAR-3, Run: 093, P, 0, 114, 0, 0, 0, 0, 398, 92, 398, 0, 0, 20, 164, 997, 6063, 72, 53, 19, 92, 164, 246, 997, 6461
INVAR-3, Run: 094, P, 0, 165, 0, 0, 0, 0, 347, 92, 347, 0, 0, 20, 164, 675, 3669, 72, 49, 23, 92, 164, 246, 675, 4016
INVAR-3, Run: 095, P, 0, 502, 0, 0, 0, 87, 87, 0, 0, 1, 0, 10, 164, 510, 3641, 77, 45, 31, 87, 164, 246, 597, 3641
INVAR-3, Run: 096, P, 0, 512, 0, 0, 0, 92, 92, 0, 0, 1, 0, 20, 164, 594, 3879, 72, 50, 21, 92, 164, 246, 686, 3879
INVAR-3, Run: 097, P, 0, 514, 0, 0, 0, 93, 93, 0, 0, 1, 0, 22, 164, 553, 2587, 71, 42, 28, 93, 164, 246, 646, 2587
INVAR-3, Run: 098, P, 0, 508, 0, 0, 0, 90, 90, 0, 0, 1, 0, 16, 164, 623, 3084, 74, 59, 14, 90, 164, 246, 713, 3084
INVAR-3, Run: 099, P, 0, 508, 0, 0, 0, 90, 90, 0, 0, 1, 0, 16, 164, 776, 3485, 74, 50, 23, 90, 164, 246, 866, 3485
INVAR-3, Run: 100, P, 0, 217, 0, 0, 0, 0, 297, 93, 297, 0, 0, 22, 164, 791, 5028, 71, 49, 22, 93, 164, 246, 791, 5325
INVAR-4, Run: 001, P, 0, 125, 0, 0, 0, 23, 23, 0, 0, 1, 1, 7, 39, 67, 471, 16, 10, 5, 23, 39, 58, 90, 471
INVAR-4, Run: 002, P, 0, 48, 0, 0, 0, 0, 79, 24, 79, 0, 1, 9, 39, 41, 245, 15, 10, 5, 24, 39, 58, 41, 324
INVAR-4, Run: 003, P, 0, 127, 0, 0, 0, 24, 24, 0, 0, 1, 1, 9, 39, 61, 259, 15, 10, 4, 24, 39, 58, 85, 259
INVAR-4, Run: 004, P, 0, 123, 0, 0, 0, 22, 22, 0, 0, 1, 1, 5, 39, 87, 294, 17, 3, 13, 22, 39, 58, 109, 294
INVAR-4, Run: 005, P, 0, 125, 0, 0, 0, 23, 23, 0, 0, 1, 1, 7, 39, 58, 361, 16, 9, 6, 23, 39, 58, 81, 361
INVAR-4, Run: 006, P, 0, 4, 0, 0, 0, 0, 123, 24, 123, 0, 1, 9, 39, 51, 288, 15, 11, 4, 24, 39, 58, 51, 411
INVAR-4, Run: 007, P, 0, 3, 0, 0, 0, 0, 120, 22, 120, 0, 1, 5, 39, 57, 208, 17, 9, 8, 22, 39, 58, 57, 328
INVAR-4, Run: 008, P, 0, 40, 0, 0, 0, 0, 87, 24, 87, 0, 1, 9, 39, 59, 161, 15, 11, 4, 24, 39, 58, 59, 248
INVAR-4, Run: 009, P, 0, 87, 0, 0, 0, 0, 40, 24, 40, 0, 1, 9, 39, 49, 180, 15, 9, 6, 24, 39, 58, 49, 220
INVAR-4, Run: 010, P, 0, 10, 0, 0, 0, 0, 117, 24, 117, 0, 1, 9, 39, 88, 211, 15, 8, 7, 24, 39, 58, 88, 328
INVAR-4, Run: 011, P, 0, 47, 0, 0, 0, 0, 80, 24, 80, 0, 1, 9, 39, 63, 352, 15, 9, 6, 24, 39, 58, 63, 432
INVAR-4, Run: 012, P, 0, 121, 0, 0, 0, 21, 21, 0, 0, 1, 1, 3, 39, 57, 275, 18, 8, 9, 21, 39, 58, 78, 275
INVAR-4, Run: 013, P, 0, 23, 0, 0, 0, 0, 106, 25, 106, 0, 1, 11, 39, 63, 251, 14, 10, 4, 25, 39, 58, 63, 357
INVAR-4, Run: 014, P, 0, 125, 0, 0, 0, 23, 23, 0, 0, 1, 1, 7, 39, 49, 300, 16, 11, 4, 23, 39, 58, 72, 300
INVAR-4, Run: 015, P, 0, 35, 0, 0, 0, 0, 94, 25, 94, 0, 1, 11, 39, 73, 462, 14, 9, 5, 25, 39, 58, 73, 556
INVAR-4, Run: 016, P, 0, 17, 0, 0, 0, 0, 108, 23, 108, 0, 1, 7, 39, 71, 375, 16, 11, 5, 23, 39, 58, 71, 483
INVAR-4, Run: 017, P, 0, 127, 0, 0, 0, 24, 24, 0, 0, 1, 1, 9, 39, 71, 278, 15, 8, 6, 24, 39, 58, 95, 278
INVAR-4, Run: 018, P, 0, 17, 0, 0, 0, 0, 114, 26, 114, 0, 1, 13, 39, 45, 233, 13, 11, 2, 26, 39, 58, 45, 347
INVAR-4, Run: 019, P, 0, 104, 0, 0, 0, 0, 23, 24, 23, 0, 1, 9, 39, 107, 627, 15, 12, 3, 24, 39, 58, 107, 650
INVAR-4, Run: 020, P, 0, 127, 0, 0, 0, 3, 7, 23, 4, 0, 1, 13, 39, 109, 340, 13, 8, 5, 26, 39, 58, 112, 344
INVAR-4, Run: 021, P, 0, 121, 0, 0, 0, 21, 21, 0, 0, 1, 1, 3, 39, 69, 296, 18, 8, 9, 21, 39, 58, 90, 296
INVAR-4, Run: 022, P, 0, 57, 0, 0, 0, 0, 70, 24, 70, 0, 1, 9, 39, 69, 423, 15, 12, 3, 24, 39, 58, 69, 493
INVAR-4, Run: 023, P, 0, 36, 0, 0, 0, 0, 87, 22, 87, 0, 1, 5, 39, 77, 384, 17, 6, 11, 22, 39, 58, 77, 471
INVAR-4, Run: 024, P, 0, 18, 0, 0, 0, 0, 109, 24, 109, 0, 1, 9, 39, 80, 233, 15, 8, 7, 24, 39, 58, 80, 342
INVAR-4, Run: 025, P, 0, 89, 0, 0, 0, 0, 38, 24, 38, 0, 1, 9, 39, 113, 308, 15, 7, 8, 24, 39, 58, 113, 346
INVAR-4, Run: 026, P, 0, 91, 0, 0, 0, 0, 38, 25, 38, 0, 1, 11, 39, 78, 286, 14, 10, 4, 25, 39, 58, 78, 324
INVAR-4, Run: 027, P, 0, 106, 0, 0, 0, 0, 21, 24, 21, 0, 1, 9, 39, 66, 429, 15, 12, 3, 24, 39, 58, 66, 450
INVAR-4, Run: 028, P, 0, 125, 0, 0, 0, 23, 23, 0, 0, 1, 1, 7, 39, 32, 259, 16, 10, 5, 23, 39, 58, 55, 259
INVAR-4, Run: 029, P, 0, 123, 0, 0, 0, 22, 22, 0, 0, 1, 1, 5, 39, 70, 323, 17, 10, 6, 22, 39, 58, 92, 323
INVAR-4, Run: 030, P, 0, 123, 0, 0, 0, 22, 22, 0, 0, 1, 1, 5, 39, 73, 222, 17, 10, 6, 22, 39, 58, 95, 222
INVAR-4, Run: 031, P, 0, 125, 0, 0, 0, 23, 23, 0, 0, 1, 1, 7, 39, 77, 276, 16, 8, 7, 23, 39, 58, 100, 276
INVAR-4, Run: 032, P, 0, 11, 0, 0, 0, 0, 116, 24, 116, 0, 1, 9, 39, 55, 219, 15, 10, 5, 24, 39, 58, 55, 335
INVAR-4, Run: 033, P, 0, 10, 0, 0, 0, 0, 121, 26, 121, 0, 1, 13, 39, 42, 178, 13, 8, 5, 26, 39, 58, 42, 299
INVAR-4, Run: 034, P, 0, 29, 0, 0, 0, 0, 96, 23, 96, 0, 1, 7, 39, 62, 186, 16, 10, 6, 23, 39, 58, 62, 282
INVAR-4, Run: 035, P, 0, 123, 0, 0, 0, 22, 22, 0, 0, 1, 1, 5, 39, 40, 223, 17, 10, 6, 22, 39, 58, 62, 223
INVAR-4, Run: 036, P, 0, 125, 0, 0, 0, 23, 23, 0, 0, 1, 1, 7, 39, 41, 262, 16, 9, 6, 23, 39, 58, 64, 262
INVAR-4, Run: 037, P, 0, 68, 0, 0, 0, 0, 61, 25, 61, 0, 1, 11, 39, 94, 187, 14, 9, 5, 25, 39, 58, 94, 248
INVAR-4, Run: 038, P, 0, 127, 0, 0, 0, 24, 24, 0, 0, 1, 1, 9, 39, 33, 181, 15, 11, 3, 24, 39, 58, 57, 181
INVAR-4, Run: 039, P, 0, 115, 0, 0, 0, 2, 14, 22, 12, 0, 1, 9, 39, 43, 260, 15, 13, 2, 24, 39, 58, 45, 272
INVAR-4, Run: 040, P, 0, 32, 0, 0, 0, 0, 93, 23, 93, 0, 1, 7, 39, 50, 191, 16, 11, 5, 23, 39, 58, 50, 284
INVAR-4, Run: 041, P, 0, 125, 0, 0, 0, 23, 23, 0, 0, 1, 1, 7, 39, 56, 200, 16, 9, 6, 23, 39, 58, 79, 200
INVAR-4, Run: 042, P, 0, 123, 0, 0, 0, 22, 22, 0, 0, 1, 1, 5, 39, 49, 262, 17, 10, 6, 22, 39, 58, 71, 262
INVAR-4, Run: 043, P, 0, 112, 0, 0, 0, 0, 11, 22, 11, 0, 1, 5, 39, 82, 337, 17, 11, 6, 22, 39, 58, 82, 348
INVAR-4, Run: 044, P, 0, 34, 0, 0, 0, 0, 91, 23, 91, 0, 1, 7, 39, 83, 278, 16, 9, 7, 23, 39, 58, 83, 369
INVAR-4, Run: 045, P, 0, 125, 0, 0, 0, 23, 23, 0, 0, 1, 1, 7, 39, 44, 215, 16, 11, 4, 23, 39, 58, 67, 215
INVAR-4, Run: 046, P, 0, 123, 0, 0, 0, 22, 22, 0, 0, 1, 1, 5, 39, 71, 282, 17, 6, 10, 22, 39, 58, 93, 282
INVAR-4, Run: 047, P, 0, 69, 0, 0, 0, 0, 56, 23, 56, 0, 1, 7, 39, 60, 252, 16, 6, 10, 23, 39, 58, 60, 308
INVAR-4, Run: 048, P, 0, 22, 0, 0, 0, 0, 107, 25, 107, 0, 1, 11, 39, 92, 459, 14, 10, 4, 25, 39, 58, 92, 566
INVAR-4, Run: 049, P, 0, 127, 0, 0, 0, 24, 24, 0, 0, 1, 1, 9, 39, 87, 251, 15, 8, 6, 24, 39, 58, 111, 251
INVAR-4, Run: 050, P, 0, 119, 0, 0, 0, 20, 20, 0, 0, 1, 1, 1, 39, 58, 342, 19, 12, 6, 20, 39, 58, 78, 342
INVAR-4, Run: 051, P, 0, 114, 0, 0, 0, 0, 15, 25, 15, 0, 1, 11, 39, 130, 537, 14, 10, 4, 25, 39, 58, 130, 552
INVAR-4, Run: 052, P, 0, 37, 0, 0, 0, 0, 92, 25, 92, 0, 1, 11, 39, 67, 375, 14, 12, 2, 25, 39, 58, 67, 467
INVAR-4, Run: 053, P, 0, 129, 0, 0, 0, 25, 25, 0, 0, 1, 1, 11, 39, 31, 335, 14, 12, 1, 25, 39, 58, 56, 335
INVAR-4, Run: 054, P, 0, 106, 0, 0, 0, 0, 21, 24, 21, 0, 1, 9, 39, 63, 204, 15, 9, 6, 24, 39, 58, 63, 225
INVAR-4, Run: 055, P, 0, 43, 0, 0, 0, 0, 82, 23, 82, 0, 1, 7, 39, 52, 324, 16, 9, 7, 23, 39, 58, 52, 406
INVAR-4, Run: 056, P, 0, 123, 0, 0, 0, 22, 22, 0, 0, 1, 1, 5, 39, 66, 277, 17, 10, 6, 22, 39, 58, 88, 277
INVAR-4, Run: 057, P, 0, 66, 0, 0, 0, 0, 61, 24, 61, 0, 1, 9, 39, 64, 348, 15, 11, 4, 24, 39, 58, 64, 409
INVAR-4, Run: 058, P, 0, 56, 0, 0, 0, 0, 65, 21, 65, 0, 1, 3, 39, 51, 260, 18, 13, 5, 21, 39, 58, 51, 325
INVAR-4, Run: 059, P, 0, 10, 0, 0, 0, 0, 117, 24, 117, 0, 1, 9, 39, 63, 318, 15, 13, 2, 24, 39, 58, 63, 435
INVAR-4, Run: 060, P, 0, 47, 0, 0, 0, 0, 78, 23, 78, 0, 1, 7, 39, 47, 279, 16, 11, 5, 23, 39, 58, 47, 357
INVAR-4, Run: 061, P, 0, 69, 0, 0, 0, 0, 56, 23, 56, 0, 1, 7, 39, 87, 344, 16, 11, 5, 23, 39, 58, 87, 400
INVAR-4, Run: 062, P, 0, 123, 0, 0, 0, 22, 22, 0, 0, 1, 1, 5, 39, 86, 468, 17, 10, 6, 22, 39, 58, 108, 468
INVAR-4, Run: 063, P, 0, 129, 0, 0, 0, 25, 25, 0, 0, 1, 1, 11, 39, 55, 329, 14, 9, 4, 25, 39, 58, 80, 329
INVAR-4, Run: 064, P, 0, 18, 0, 0, 0, 0, 105, 22, 105, 0, 1, 5, 39, 49, 216, 17, 12, 5, 22, 39, 58, 49, 321
INVAR-4, Run: 065, P, 0, 117, 0, 0, 0, 1, 13, 24, 12, 0, 1, 11, 39, 126, 473, 14, 9, 5, 25, 39, 58, 127, 485
INVAR-4, Run: 066, P, 0, 127, 0, 0, 0, 24, 24, 0, 0, 1, 1, 9, 39, 74, 296, 15, 10, 4, 24, 39, 58, 98, 296
INVAR-4, Run: 067, P, 0, 20, 0, 0, 0, 0, 103, 22, 103, 0, 1, 5, 39, 53, 188, 17, 11, 6, 22, 39, 58, 53, 291
INVAR-4, Run: 068, P, 0, 10, 0, 0, 0, 0, 117, 24, 117, 0, 1, 9, 39, 52, 191, 15, 8, 7, 24, 39, 58, 52, 308
INVAR-4, Run: 069, P, 0, 127, 0, 0, 0, 24, 24, 0, 0, 1, 1, 9, 39, 56, 288, 15, 7, 7, 24, 39, 58, 80, 288
INVAR-4, Run: 070, P, 0, 129, 0, 0, 0, 25, 25, 0, 0, 1, 1, 11, 39, 107, 324, 14, 8, 5, 25, 39, 58, 132, 324
INVAR-4, Run: 071, P, 0, 127, 0, 0, 0, 24, 24, 0, 0, 1, 1, 9, 39, 70, 408, 15, 11, 3, 24, 39, 58, 94, 408
INVAR-4, Run: 072, P, 0, 123, 0, 0, 0, 22, 22, 0, 0, 1, 1, 5, 39, 65, 341, 17, 6, 10, 22, 39, 58, 87, 341
INVAR-4, Run: 073, P, 0, 92, 0, 0, 0, 0, 35, 24, 35, 0, 1, 9, 39, 79, 360, 15, 10, 5, 24, 39, 58, 79, 395
INVAR-4, Run: 074, P, 0, 15, 0, 0, 0, 0, 112, 24, 112, 0, 1, 9, 39, 58, 286, 15, 9, 6, 24, 39, 58, 58, 398
INVAR-4, Run: 075, P, 0, 7, 0, 0, 0, 0, 120, 24, 120, 0, 1, 9, 39, 34, 272, 15, 9, 6, 24, 39, 58, 34, 392
INVAR-4, Run: 076, P, 0, 9, 0, 0, 0, 0, 124, 27, 124, 0, 1, 15, 39, 29, 85, 12, 8, 4, 27, 39, 58, 29, 209
INVAR-4, Run: 077, P, 0, 127, 0, 0, 0, 24, 24, 0, 0, 1, 1, 9, 39, 32, 263, 15, 10, 4, 24, 39, 58, 56, 263
INVAR-4, Run: 078, P, 0, 29, 0, 0, 0, 0, 98, 24, 98, 0, 1, 9, 39, 44, 259, 15, 9, 6, 24, 39, 58, 44, 357
INVAR-4, Run: 079, P, 0, 123, 0, 0, 0, 22, 22, 0, 0, 1, 1, 5, 39, 87, 406, 17, 9, 7, 22, 39, 58, 109, 406
INVAR-4, Run: 080, P, 0, 41, 0, 0, 0, 0, 86, 24, 86, 0, 1, 9, 39, 36, 245, 15, 11, 4, 24, 39, 58, 36, 331
INVAR-4, Run: 081, P, 0, 123, 0, 0, 0, 22, 22, 0, 0, 1, 1, 5, 39, 65, 286, 17, 7, 9, 22, 39, 58, 87, 286
INVAR-4, Run: 082, P, 0, 16, 0, 0, 0, 0, 113, 25, 113, 0, 1, 11, 39, 25, 173, 14, 11, 3, 25, 39, 58, 25, 286
INVAR-4, Run: 083, P, 0, 125, 0, 0, 0, 23, 23, 0, 0, 1, 1, 7, 39, 50, 282, 16, 9, 6, 23, 39, 58, 73, 282
INVAR-4, Run: 084, P, 0, 89, 0, 0, 0, 0, 38, 24, 38, 0, 1, 9, 39, 41, 134, 15, 12, 3, 24, 39, 58, 41, 172
INVAR-4, Run: 085, P, 0, 11, 0, 0, 0, 0, 120, 26, 120, 0, 1, 13, 39, 42, 162, 13, 7, 6, 26, 39, 58, 42, 282
INVAR-4, Run: 086, P, 0, 125, 0, 0, 0, 23, 23, 0, 0, 1, 1, 7, 39, 69, 395, 16, 14, 1, 23, 39, 58, 92, 395
INVAR-4, Run: 087, P, 0, 77, 0, 0, 0, 0, 54, 26, 54, 0, 1, 13, 39, 45, 160, 13, 11, 2, 26, 39, 58, 45, 214
INVAR-4, Run: 088, P, 0, 19, 0, 0, 0, 0, 106, 23, 106, 0, 1, 7, 39, 106, 505, 16, 10, 6, 23, 39, 58, 106, 611
INVAR-4, Run: 089, P, 0, 20, 0, 0, 0, 0, 109, 25, 109, 0, 1, 11, 39, 44, 211, 14, 11, 3, 25, 39, 58, 44, 320
INVAR-4, Run: 090, P, 0, 129, 0, 0, 0, 25, 25, 0, 0, 1, 1, 11, 39, 74, 395, 14, 9, 4, 25, 39, 58, 99, 395
INVAR-4, Run: 091, P, 0, 87, 0, 0, 0, 0, 42, 25, 42, 0, 1, 11, 39, 37, 291, 14, 12, 2, 25, 39, 58, 37, 333
INVAR-4, Run: 092, P, 0, 9, 0, 0, 0, 0, 120, 25, 120, 0, 1, 11, 39, 49, 180, 14, 10, 4, 25, 39, 58, 49, 300
INVAR-4, Run: 093, P, 0, 19, 0, 0, 0, 0, 112, 26, 112, 0, 1, 13, 39, 64, 352, 13, 10, 3, 26, 39, 58, 64, 464
INVAR-4, Run: 094, P, 0, 86, 0, 0, 0, 0, 41, 24, 41, 0, 1, 9, 39, 58, 285, 15, 13, 2, 24, 39, 58, 58, 326
INVAR-4, Run: 095, P, 0, 50, 0, 0, 0, 0, 73, 22, 73, 0, 1, 5, 39, 69, 369, 17, 13, 4, 22, 39, 58, 69, 442
INVAR-4, Run: 096, P, 0, 123, 0, 0, 0, 22, 22, 0, 0, 1, 1, 5, 39, 57, 277, 17, 8, 8, 22, 39, 58, 79, 277
INVAR-4, Run: 097, P, 0, 123, 0, 0, 0, 22, 22, 0, 0, 1, 1, 5, 39, 61, 190, 17, 10, 6, 22, 39, 58, 83, 190
INVAR-4, Run: 098, P, 0, 125, 0, 0, 0, 23, 23, 0, 0, 1, 1, 7, 39, 34, 289, 16, 12, 3, 23, 39, 58, 57, 289
INVAR-4, Run: 099, P, 0, 123, 0, 0, 0, 22, 22, 0, 0, 1, 1, 5, 39, 60, 249, 17, 12, 4, 22, 39, 58, 82, 249
INVAR-4, Run: 100, P, 0, 125, 0, 0, 0, 23, 23, 0, 0, 1, 1, 7, 39, 51, 230, 16, 7, 8, 23, 39, 58, 74, 230
INVAR-5, Run: 001, P, 0, 169, 0, 0, 0, 31, 31, 0, 0, 1, 1, 9, 53, 134, 549, 22, 16, 5, 31, 53, 79, 165, 549
INVAR-5, Run: 002, P, 0, 167, 0, 0, 0, 30, 30, 0, 0, 1, 1, 7, 53, 129, 406, 23, 12, 10, 30, 53, 79, 159, 406
INVAR-5, Run: 003, P, 0, 165, 0, 0, 0, 29, 29, 0, 0, 1, 1, 5, 53, 109, 589, 24, 16, 7, 29, 53, 79, 138, 589
INVAR-5, Run: 004, P, 0, 30, 0, 0, 0, 0, 139, 31, 139, 0, 1, 9, 53, 65, 258, 22, 13, 9, 31, 53, 79, 65, 397
INVAR-5, Run: 005, P, 0, 36, 0, 0, 0, 0, 137, 33, 137, 0, 1, 13, 53, 88, 376, 20, 12, 8, 33, 53, 79, 88, 513
INVAR-5, Run: 006, P, 0, 88, 0, 0, 0, 0, 85, 33, 85, 0, 1, 13, 53, 136, 712, 20, 14, 6, 33, 53, 79, 136, 797
INVAR-5, Run: 007, P, 0, 1, 0, 0, 0, 0, 166, 30, 166, 0, 1, 7, 53, 90, 490, 23, 15, 8, 30, 53, 79, 90, 656
INVAR-5, Run: 008, P, 0, 96, 0, 0, 0, 0, 77, 33, 77, 0, 1, 13, 53, 90, 681, 20, 13, 7, 33, 53, 79, 90, 758
INVAR-5, Run: 009, P, 0, 18, 0, 0, 0, 0, 153, 32, 153, 0, 1, 11, 53, 169, 659, 21, 14, 7, 32, 53, 79, 169, 812
INVAR-5, Run: 010, P, 0, 175, 0, 0, 0, 34, 34, 0, 0, 1, 1, 15, 53, 140, 773, 19, 14, 4, 34, 53, 79, 174, 773
INVAR-5, Run: 011, P, 0, 12, 0, 0, 0, 0, 155, 30, 155, 0, 1, 7, 53, 109, 427, 23, 16, 7, 30, 53, 79, 109, 582
INVAR-5, Run: 012, P, 0, 167, 0, 0, 0, 30, 30, 0, 0, 1, 1, 7, 53, 47, 450, 23, 16, 6, 30, 53, 79, 77, 450
INVAR-5, Run: 013, P, 0, 171, 0, 0, 0, 32, 32, 0, 0, 1, 1, 11, 53, 99, 459, 21, 14, 6, 32, 53, 79, 131, 459
INVAR-5, Run: 014, P, 0, 8, 0, 0, 0, 0, 167, 34, 167, 0, 1, 15, 53, 63, 431, 19, 18, 1, 34, 53, 79, 63, 598
INVAR-5, Run: 015, P, 0, 12, 0, 0, 0, 0, 163, 34, 163, 0, 1, 15, 53, 99, 544, 19, 10, 9, 34, 53, 79, 99, 707
INVAR-5, Run: 016, P, 0, 173, 0, 0, 0, 33, 33, 0, 0, 1, 1, 13, 53, 161, 834, 20, 12, 7, 33, 53, 79, 194, 834
INVAR-5, Run: 017, P, 0, 171, 0, 0, 0, 32, 32, 0, 0, 1, 1, 11, 53, 132, 432, 21, 10, 10, 32, 53, 79, 164, 432
INVAR-5, Run: 018, P, 0, 11, 0, 0, 0, 0, 158, 31, 158, 0, 1, 9, 53, 86, 336, 22, 12, 10, 31, 53, 79, 86, 494
INVAR-5, Run: 019, P, 0, 167, 0, 0, 0, 30, 30, 0, 0, 1, 1, 7, 53, 123, 565, 23, 10, 12, 30, 53, 79, 153, 565
INVAR-5, Run: 020, P, 0, 165, 0, 0, 0, 29, 29, 0, 0, 1, 1, 5, 53, 87, 358, 24, 13, 10, 29, 53, 79, 116, 358
INVAR-5, Run: 021, P, 0, 30, 0, 0, 0, 0, 137, 30, 137, 0, 1, 7, 53, 128, 735, 23, 14, 9, 30, 53, 79, 128, 872
INVAR-5, Run: 022, P, 0, 5, 0, 0, 0, 0, 164, 31, 164, 0, 1, 9, 53, 140, 505, 22, 15, 7, 31, 53, 79, 140, 669
INVAR-5, Run: 023, P, 0, 9, 0, 0, 0, 0, 166, 34, 166, 0, 1, 15, 53, 99, 516, 19, 13, 6, 34, 53, 79, 99, 682
INVAR-5, Run: 024, P, 0, 167, 0, 0, 0, 30, 30, 0, 0, 1, 1, 7, 53, 98, 596, 23, 14, 8, 30, 53, 79, 128, 596
INVAR-5, Run: 025, P, 0, 169, 0, 0, 0, 31, 31, 0, 0, 1, 1, 9, 53, 91, 495, 22, 16, 5, 31, 53, 79, 122, 495
INVAR-5, Run: 026, P, 0, 167, 0, 0, 0, 30, 30, 0, 0, 1, 1, 7, 53, 143, 603, 23, 10, 12, 30, 53, 79, 173, 603
INVAR-5, Run: 027, P, 0, 169, 0, 0, 0, 31, 31, 0, 0, 1, 1, 9, 53, 138, 573, 22, 10, 11, 31, 53, 79, 169, 573
INVAR-5, Run: 028, P, 0, 169, 0, 0, 0, 31, 31, 0, 0, 1, 1, 9, 53, 61, 266, 22, 14, 7, 31, 53, 79, 92, 266
INVAR-5, Run: 029, P, 0, 165, 0, 0, 0, 29, 29, 0, 0, 1, 1, 5, 53, 95, 517, 24, 18, 5, 29, 53, 79, 124, 517
INVAR-5, Run: 030, P, 0, 171, 0, 0, 0, 32, 32, 0, 0, 1, 1, 11, 53, 104, 511, 21, 16, 4, 32, 53, 79, 136, 511
INVAR-5, Run: 031, P, 0, 94, 0, 0, 0, 0, 77, 32, 77, 0, 1, 11, 53, 164, 622, 21, 14, 7, 32, 53, 79, 164, 699
INVAR-5, Run: 032, P, 0, 165, 0, 0, 0, 29, 29, 0, 0, 1, 1, 5, 53, 63, 380, 24, 17, 6, 29, 53, 79, 92, 380
INVAR-5, Run: 033, P, 0, 163, 0, 0, 0, 28, 28, 0, 0, 1, 1, 3, 53, 99, 429, 25, 14, 10, 28, 53, 79, 127, 429
INVAR-5, Run: 034, P, 0, 167, 0, 0, 0, 2, 8, 31, 6, 0, 1, 13, 53, 187, 524, 20, 12, 8, 33, 53, 79, 189, 530
INVAR-5, Run: 035, P, 0, 28, 0, 0, 0, 0, 143, 32, 143, 0, 1, 11, 53, 79, 640, 21, 15, 6, 32, 53, 79, 79, 783
INVAR-5, Run: 036, P, 0, 171, 0, 0, 0, 32, 32, 0, 0, 1, 1, 11, 53, 108, 393, 21, 14, 6, 32, 53, 79, 140, 393
INVAR-5, Run: 037, P, 0, 169, 0, 0, 0, 31, 31, 0, 0, 1, 1, 9, 53, 156, 492, 22, 13, 8, 31, 53, 79, 187, 492
INVAR-5, Run: 038, P, 0, 169, 0, 0, 0, 31, 31, 0, 0, 1, 1, 9, 53, 99, 504, 22, 15, 6, 31, 53, 79, 130, 504
INVAR-5, Run: 039, P, 0, 87, 0, 0, 0, 0, 86, 33, 86, 0, 1, 13, 53, 154, 620, 20, 10, 10, 33, 53, 79, 154, 706
INVAR-5, Run: 040, P, 0, 165, 0, 0, 0, 29, 29, 0, 0, 1, 1, 5, 53, 79, 340, 24, 15, 8, 29, 53, 79, 108, 340
INVAR-5, Run: 041, P, 0, 38, 0, 0, 0, 0, 127, 29, 127, 0, 1, 5, 53, 114, 450, 24, 20, 4, 29, 53, 79, 114, 577
INVAR-5, Run: 042, P, 0, 167, 0, 0, 0, 30, 30, 0, 0, 1, 1, 7, 53, 138, 655, 23, 10, 12, 30, 53, 79, 168, 655
INVAR-5, Run: 043, P, 0, 167, 0, 0, 0, 30, 30, 0, 0, 1, 1, 7, 53, 135, 697, 23, 16, 6, 30, 53, 79, 165, 697
INVAR-5, Run: 044, P, 0, 167, 0, 0, 0, 30, 30, 0, 0, 1, 1, 7, 53, 92, 509, 23, 15, 7, 30, 53, 79, 122, 509
INVAR-5, Run: 045, P, 0, 167, 0, 0, 0, 30, 30, 0, 0, 1, 1, 7, 53, 88, 364, 23, 16, 6, 30, 53, 79, 118, 364
INVAR-5, Run: 046, P, 0, 76, 0, 0, 0, 0, 91, 30, 91, 0, 1, 7, 53, 132, 386, 23, 11, 12, 30, 53, 79, 132, 477
INVAR-5, Run: 047, P, 0, 171, 0, 0, 0, 32, 32, 0, 0, 1, 1, 11, 53, 90, 420, 21, 11, 9, 32, 53, 79, 122, 420
INVAR-5, Run: 048, P, 0, 163, 0, 0, 0, 28, 28, 0, 0, 1, 1, 3, 53, 95, 453, 25, 17, 7, 28, 53, 79, 123, 453
INVAR-5, Run: 049, P, 0, 132, 0, 0, 0, 0, 45, 35, 45, 0, 1, 17, 53, 118, 546, 18, 10, 8, 35, 53, 79, 118, 591
INVAR-5, Run: 050, P, 0, 165, 0, 0, 0, 29, 29, 0, 0, 1, 1, 5, 53, 137, 533, 24, 9, 14, 29, 53, 79, 166, 533
INVAR-5, Run: 051, P, 0, 165, 0, 0, 0, 29, 29, 0, 0, 1, 1, 5, 53, 96, 373, 24, 13, 10, 29, 53, 79, 125, 373
INVAR-5, Run: 052, P, 0, 16, 0, 0, 0, 0, 161, 35, 161, 0, 1, 17, 53, 64, 399, 18, 12, 6, 35, 53, 79, 64, 560
INVAR-5, Run: 053, P, 0, 95, 0, 0, 0, 0, 78, 33, 78, 0, 1, 13, 53, 92, 506, 20, 14, 6, 33, 53, 79, 92, 584
INVAR-5, Run: 054, P, 0, 165, 0, 0, 0, 29, 29, 0, 0, 1, 1, 5, 53, 75, 346, 24, 17, 6, 29, 53, 79, 104, 346
INVAR-5, Run: 055, P, 0, 15, 0, 0, 0, 0, 158, 33, 158, 0, 1, 13, 53, 75, 387, 20, 15, 5, 33, 53, 79, 75, 545
INVAR-5, Run: 056, P, 0, 75, 0, 0, 0, 0, 96, 32, 96, 0, 1, 11, 53, 86, 521, 21, 15, 6, 32, 53, 79, 86, 617
INVAR-5, Run: 057, P, 0, 171, 0, 0, 0, 32, 32, 0, 0, 1, 1, 11, 53, 108, 330, 21, 15, 5, 32, 53, 79, 140, 330
INVAR-5, Run: 058, P, 0, 23, 0, 0, 0, 0, 146, 31, 146, 0, 1, 9, 53, 88, 442, 22, 15, 7, 31, 53, 79, 88, 588
INVAR-5, Run: 059, P, 0, 167, 0, 0, 0, 30, 30, 0, 0, 1, 1, 7, 53, 109, 344, 23, 10, 12, 30, 53, 79, 139, 344
INVAR-5, Run: 060, P, 0, 1, 0, 0, 0, 0, 170, 32, 170, 0, 1, 11, 53, 86, 369, 21, 11, 10, 32, 53, 79, 86, 539
INVAR-5, Run: 061, P, 0, 28, 0, 0, 0, 0, 147, 34, 147, 0, 1, 15, 53, 159, 485, 19, 12, 7, 34, 53, 79, 159, 632
INVAR-5, Run: 062, P, 0, 151, 0, 0, 0, 0, 20, 32, 20, 0, 1, 11, 53, 112, 463, 21, 11, 10, 32, 53, 79, 112, 483
INVAR-5, Run: 063, P, 0, 167, 0, 0, 0, 30, 30, 0, 0, 1, 1, 7, 53, 106, 457, 23, 13, 9, 30, 53, 79, 136, 457
INVAR-5, Run: 064, P, 0, 173, 0, 0, 0, 33, 33, 0, 0, 1, 1, 13, 53, 65, 408, 20, 15, 4, 33, 53, 79, 98, 408
INVAR-5, Run: 065, P, 0, 24, 0, 0, 0, 0, 143, 30, 143, 0, 1, 7, 53, 106, 694, 23, 19, 4, 30, 53, 79, 106, 837
INVAR-5, Run: 066, P, 0, 167, 0, 0, 0, 30, 30, 0, 0, 1, 1, 7, 53, 71, 501, 23, 15, 7, 30, 53, 79, 101, 501
INVAR-5, Run: 067, P, 0, 121, 0, 0, 0, 0, 52, 33, 52, 0, 1, 13, 53, 180, 716, 20, 13, 7, 33, 53, 79, 180, 768
INVAR-5, Run: 068, P, 0, 45, 0, 0, 0, 0, 128, 33, 128, 0, 1, 13, 53, 83, 499, 20, 17, 3, 33, 53, 79, 83, 627
INVAR-5, Run: 069, P, 0, 169, 0, 0, 0, 31, 31, 0, 0, 1, 1, 9, 53, 97, 502, 22, 14, 7, 31, 53, 79, 128, 502
INVAR-5, Run: 070, P, 0, 9, 0, 0, 0, 0, 164, 33, 164, 0, 1, 13, 53, 104, 489, 20, 16, 4, 33, 53, 79, 104, 653
INVAR-5, Run: 071, P, 0, 169, 0, 0, 0, 31, 31, 0, 0, 1, 1, 9, 53, 47, 382, 22, 13, 8, 31, 53, 79, 78, 382
INVAR-5, Run: 072, P, 0, 147, 0, 0, 0, 0, 32, 36, 32, 0, 1, 19, 53, 181, 797, 17, 14, 3, 36, 53, 79, 181, 829
INVAR-5, Run: 073, P, 0, 167, 0, 0, 0, 30, 30, 0, 0, 1, 1, 7, 53, 106, 435, 23, 16, 6, 30, 53, 79, 136, 435
INVAR-5, Run: 074, P, 0, 49, 0, 0, 0, 0, 118, 30, 118, 0, 1, 7, 53, 122, 622, 23, 16, 7, 30, 53, 79, 122, 740
INVAR-5, Run: 075, P, 0, 22, 0, 0, 0, 0, 155, 35, 155, 0, 1, 17, 53, 80, 448, 18, 15, 3, 35, 53, 79, 80, 603
INVAR-5, Run: 076, P, 0, 34, 0, 0, 0, 0, 135, 31, 135, 0, 1, 9, 53, 99, 452, 22, 15, 7, 31, 53, 79, 99, 587
INVAR-5, Run: 077, P, 0, 145, 0, 0, 0, 0, 26, 32, 26, 0, 1, 11, 53, 131, 617, 21, 13, 8, 32, 53, 79, 131, 643
INVAR-5, Run: 078, P, 0, 171, 0, 0, 0, 32, 32, 0, 0, 1, 1, 11, 53, 58, 418, 21, 13, 7, 32, 53, 79, 90, 418
INVAR-5, Run: 079, P, 0, 23, 0, 0, 0, 0, 146, 31, 146, 0, 1, 9, 53, 110, 286, 22, 13, 9, 31, 53, 79, 110, 432
INVAR-5, Run: 080, P, 0, 169, 0, 0, 0, 31, 31, 0, 0, 1, 1, 9, 53, 139, 391, 22, 14, 7, 31, 53, 79, 170, 391
INVAR-5, Run: 081, P, 0, 167, 0, 0, 0, 30, 30, 0, 0, 1, 1, 7, 53, 77, 461, 23, 15, 7, 30, 53, 79, 107, 461
INVAR-5, Run: 082, P, 0, 165, 0, 0, 0, 29, 29, 0, 0, 1, 1, 5, 53, 156, 540, 24, 10, 13, 29, 53, 79, 185, 540
INVAR-5, Run: 083, P, 0, 165, 0, 0, 0, 29, 29, 0, 0, 1, 1, 5, 53, 137, 641, 24, 16, 7, 29, 53, 79, 166, 641
INVAR-5, Run: 084, P, 0, 67, 0, 0, 0, 0, 102, 31, 102, 0, 1, 9, 53, 100, 416, 22, 17, 5, 31, 53, 79, 100, 518
INVAR-5, Run: 085, P, 0, 165, 0, 0, 0, 29, 29, 0, 0, 1, 1, 5, 53, 123, 448, 24, 12, 11, 29, 53, 79, 152, 448
INVAR-5, Run: 086, P, 0, 171, 0, 0, 0, 32, 32, 0, 0, 1, 1, 11, 53, 111, 562, 21, 13, 7, 32, 53, 79, 143, 562
INVAR-5, Run: 087, P, 0, 7, 0, 0, 0, 0, 166, 33, 166, 0, 1, 13, 53, 104, 598, 20, 14, 6, 33, 53, 79, 104, 764
INVAR-5, Run: 088, P, 0, 25, 0, 0, 0, 0, 150, 34, 150, 0, 1, 15, 53, 54, 492, 19, 16, 3, 34, 53, 79, 54, 642
INVAR-5, Run: 089, P, 0, 1, 0, 0, 0, 0, 168, 31, 168, 0, 1, 9, 53, 93, 362, 22, 9, 13, 31, 53, 79, 93, 530
INVAR-5, Run: 090, P, 0, 36, 0, 0, 0, 0, 133, 31, 133, 0, 1, 9, 53, 209, 726, 22, 14, 8, 31, 53, 79, 209, 859
INVAR-5, Run: 091, P, 0, 167, 0, 0, 0, 30, 30, 0, 0, 1, 1, 7, 53, 74, 280, 23, 15, 7, 30, 53, 79, 104, 280
INVAR-5, Run: 092, P, 0, 167, 0, 0, 0, 30, 30, 0, 0, 1, 1, 7, 53, 145, 632, 23, 16, 6, 30, 53, 79, 175, 632
INVAR-5, Run: 093, P, 0, 169, 0, 0, 0, 31, 31, 0, 0, 1, 1, 9, 53, 122, 499, 22, 8, 13, 31, 53, 79, 153, 499
INVAR-5, Run: 094, P, 0, 169, 0, 0, 0, 31, 31, 0, 0, 1, 1, 9, 53, 86, 452, 22, 19, 2, 31, 53, 79, 117, 452
INVAR-5, Run: 095, P, 0, 177, 0, 0, 0, 35, 35, 0, 0, 1, 1, 17, 53, 93, 643, 18, 14, 3, 35, 53, 79, 128, 643
INVAR-5, Run: 096, P, 0, 49, 0, 0, 0, 0, 124, 33, 124, 0, 1, 13, 53, 91, 279, 20, 15, 5, 33, 53, 79, 91, 403
INVAR-5, Run: 097, P, 0, 165, 0, 0, 0, 29, 29, 0, 0, 1, 1, 5, 53, 116, 529, 24, 16, 7, 29, 53, 79, 145, 529
INVAR-5, Run: 098, P, 0, 169, 0, 0, 0, 31, 31, 0, 0, 1, 1, 9, 53, 115, 618, 22, 12, 9, 31, 53, 79, 146, 618
INVAR-5, Run: 099, P, 0, 169, 0, 0, 0, 31, 31, 0, 0, 1, 1, 9, 53, 141, 531, 22, 9, 12, 31, 53, 79, 172, 531
INVAR-5, Run: 100, P, 0, 169, 0, 0, 0, 31, 31, 0, 0, 1, 1, 9, 53, 161, 648, 22, 16, 5, 31, 53, 79, 192, 648
INVAR-6, Run: 001, P, 0, 1, 0, 0, 0, 0, 536, 93, 536, 0, 1, 11, 175, 870, 3175, 82, 38, 44, 93, 175, 262, 870, 3711
INVAR-6, Run: 002, P, 0, 545, 0, 0, 0, 97, 97, 0, 0, 1, 1, 19, 175, 881, 3982, 78, 48, 29, 97, 175, 262, 978, 3982
INVAR-6, Run: 003, P, 0, 547, 0, 0, 0, 98, 98, 0, 0, 1, 1, 21, 175, 453, 2684, 77, 50, 26, 98, 175, 262, 551, 2684
INVAR-6, Run: 004, P, 0, 545, 0, 0, 0, 97, 97, 0, 0, 1, 1, 19, 175, 565, 4574, 78, 42, 35, 97, 175, 262, 662, 4574
INVAR-6, Run: 005, P, 0, 543, 0, 0, 0, 96, 96, 0, 0, 1, 1, 17, 175, 584, 3956, 79, 55, 23, 96, 175, 262, 680, 3956
INVAR-6, Run: 006, P, 0, 33, 0, 0, 0, 0, 516, 99, 516, 0, 1, 23, 175, 511, 3118, 76, 47, 29, 99, 175, 262, 511, 3634
INVAR-6, Run: 007, P, 0, 182, 0, 0, 0, 0, 365, 98, 365, 0, 1, 21, 175, 525, 2916, 77, 49, 28, 98, 175, 262, 525, 3281
INVAR-6, Run: 008, P, 0, 41, 0, 0, 0, 0, 504, 97, 504, 0, 1, 19, 175, 741, 3340, 78, 52, 26, 97, 175, 262, 741, 3844
INVAR-6, Run: 009, P, 0, 86, 0, 0, 0, 0, 469, 102, 469, 0, 1, 29, 175, 806, 3477, 73, 37, 36, 102, 175, 262, 806, 3946
INVAR-6, Run: 010, P, 0, 359, 0, 0, 0, 0, 190, 99, 190, 0, 1, 23, 175, 574, 3112, 76, 41, 35, 99, 175, 262, 574, 3302
INVAR-6, Run: 011, P, 0, 106, 0, 0, 0, 0, 433, 94, 433, 0, 1, 13, 175, 682, 3604, 81, 56, 25, 94, 175, 262, 682, 4037
INVAR-6, Run: 012, P, 0, 547, 0, 0, 0, 98, 98, 0, 0, 1, 1, 21, 175, 604, 3115, 77, 45, 31, 98, 175, 262, 702, 3115
INVAR-6, Run: 013, P, 0, 208, 0, 0, 0, 0, 347, 102, 347, 0, 1, 29, 175, 822, 4637, 73, 55, 18, 102, 175, 262, 822, 4984
INVAR-6, Run: 014, P, 0, 100, 0, 0, 0, 0, 443, 96, 443, 0, 1, 17, 175, 606, 3304, 79, 53, 26, 96, 175, 262, 606, 3747
INVAR-6, Run: 015, P, 0, 547, 0, 0, 0, 98, 98, 0, 0, 1, 1, 21, 175, 621, 3305, 77, 49, 27, 98, 175, 262, 719, 3305
INVAR-6, Run: 016, P, 0, 545, 0, 0, 0, 97, 97, 0, 0, 1, 1, 19, 175, 927, 4243, 78, 47, 30, 97, 175, 262, 1024, 4243
INVAR-6, Run: 017, P, 0, 222, 0, 0, 0, 0, 321, 96, 321, 0, 1, 17, 175, 837, 3815, 79, 50, 29, 96, 175, 262, 837, 4136
INVAR-6, Run: 018, P, 0, 80, 0, 0, 0, 0, 471, 100, 471, 0, 1, 25, 175, 634, 3606, 75, 43, 32, 100, 175, 262, 634, 4077
INVAR-6, Run: 019, P, 0, 545, 0, 0, 0, 97, 97, 0, 0, 1, 1, 19, 175, 501, 3484, 78, 47, 30, 97, 175, 262, 598, 3484
INVAR-6, Run: 020, P, 0, 543, 0, 0, 0, 96, 96, 0, 0, 1, 1, 17, 175, 637, 3557, 79, 56, 22, 96, 175, 262, 733, 3557
INVAR-6, Run: 021, P, 0, 107, 0, 0, 0, 0, 438, 97, 438, 0, 1, 19, 175, 536, 2924, 78, 57, 21, 97, 175, 262, 536, 3362
INVAR-6, Run: 022, P, 0, 541, 0, 0, 0, 95, 95, 0, 0, 1, 1, 15, 175, 760, 3395, 80, 55, 24, 95, 175, 262, 855, 3395
INVAR-6, Run: 023, P, 0, 541, 0, 0, 0, 95, 95, 0, 0, 1, 1, 15, 175, 706, 3456, 80, 52, 27, 95, 175, 262, 801, 3456
INVAR-6, Run: 024, P, 0, 39, 0, 0, 0, 0, 506, 97, 506, 0, 1, 19, 175, 640, 3601, 78, 48, 30, 97, 175, 262, 640, 4107
INVAR-6, Run: 025, P, 0, 195, 0, 0, 0, 0, 346, 95, 346, 0, 1, 15, 175, 553, 3071, 80, 53, 27, 95, 175, 262, 553, 3417
INVAR-6, Run: 026, P, 0, 545, 0, 0, 0, 97, 97, 0, 0, 1, 1, 19, 175, 656, 2599, 78, 46, 31, 97, 175, 262, 753, 2599
INVAR-6, Run: 027, P, 0, 104, 0, 0, 0, 0, 437, 95, 437, 0, 1, 15, 175, 690, 4239, 80, 57, 23, 95, 175, 262, 690, 4676
INVAR-6, Run: 028, P, 0, 179, 0, 0, 0, 0, 360, 94, 360, 0, 1, 13, 175, 511, 3327, 81, 46, 35, 94, 175, 262, 511, 3687
INVAR-6, Run: 029, P, 0, 541, 0, 0, 0, 95, 95, 0, 0, 1, 1, 15, 175, 703, 3020, 80, 43, 36, 95, 175, 262, 798, 3020
INVAR-6, Run: 030, P, 0, 541, 0, 0, 0, 95, 95, 0, 0, 1, 1, 15, 175, 759, 2643, 80, 46, 33, 95, 175, 262, 854, 2643
INVAR-6, Run: 031, P, 0, 547, 0, 0, 0, 98, 98, 0, 0, 1, 1, 21, 175, 848, 3727, 77, 48, 28, 98, 175, 262, 946, 3727
INVAR-6, Run: 032, P, 0, 2, 0, 0, 0, 0, 545, 98, 545, 0, 1, 21, 175, 518, 2534, 77, 56, 21, 98, 175, 262, 518, 3079
INVAR-6, Run: 033, P, 0, 1, 0, 0, 0, 0, 542, 96, 542, 0, 1, 17, 175, 614, 3154, 79, 54, 25, 96, 175, 262, 614, 3696
INVAR-6, Run: 034, P, 0, 543, 0, 0, 0, 96, 96, 0, 0, 1, 1, 17, 175, 773, 3793, 79, 47, 31, 96, 175, 262, 869, 3793
INVAR-6, Run: 035, P, 0, 371, 0, 0, 0, 0, 170, 95, 170, 0, 1, 15, 175, 670, 3029, 80, 48, 32, 95, 175, 262, 670, 3199
INVAR-6, Run: 036, P, 0, 535, 0, 0, 0, 92, 92, 0, 0, 1, 1, 9, 175, 555, 3239, 83, 57, 25, 92, 175, 262, 647, 3239
INVAR-6, Run: 037, P, 0, 27, 0, 0, 0, 0, 514, 95, 514, 0, 1, 15, 175, 551, 3184, 80, 53, 27, 95, 175, 262, 551, 3698
INVAR-6, Run: 038, P, 0, 545, 0, 0, 0, 97, 97, 0, 0, 1, 1, 19, 175, 602, 3996, 78, 52, 25, 97, 175, 262, 699, 3996
INVAR-6, Run: 039, P, 0, 161, 0, 0, 0, 0, 384, 97, 384, 0, 1, 19, 175, 899, 4224, 78, 43, 35, 97, 175, 262, 899, 4608
INVAR-6, Run: 040, P, 0, 553, 0, 0, 0, 101, 101, 0, 0, 1, 1, 27, 175, 684, 4224, 74, 48, 25, 101, 175, 262, 785, 4224
INVAR-6, Run: 041, P, 0, 342, 0, 0, 0, 0, 199, 95, 199, 0, 1, 15, 175, 583, 3584, 80, 48, 32, 95, 175, 262, 583, 3783
INVAR-6, Run: 042, P, 0, 65, 0, 0, 0, 0, 482, 98, 482, 0, 1, 21, 175, 670, 3487, 77, 42, 35, 98, 175, 262, 670, 3969
INVAR-6, Run: 043, P, 0, 539, 0, 0, 0, 94, 94, 0, 0, 1, 1, 13, 175, 838, 3218, 81, 46, 34, 94, 175, 262, 932, 3218
INVAR-6, Run: 044, P, 0, 543, 0, 0, 0, 96, 96, 0, 0, 1, 1, 17, 175, 595, 2787, 79, 48, 30, 96, 175, 262, 691, 2787
INVAR-6, Run: 045, P, 0, 18, 0, 0, 0, 0, 531, 99, 531, 0, 1, 23, 175, 627, 2833, 76, 46, 30, 99, 175, 262, 627, 3364
INVAR-6, Run: 046, P, 0, 361, 0, 0, 0, 0, 182, 96, 182, 0, 1, 17, 175, 989, 4213, 79, 49, 30, 96, 175, 262, 989, 4395
INVAR-6, Run: 047, P, 0, 543, 0, 0, 0, 96, 96, 0, 0, 1, 1, 17, 175, 736, 4435, 79, 52, 26, 96, 175, 262, 832, 4435
INVAR-6, Run: 048, P, 0, 254, 0, 0, 0, 0, 293, 98, 293, 0, 1, 21, 175, 846, 4472, 77, 43, 34, 98, 175, 262, 846, 4765
INVAR-6, Run: 049, P, 0, 232, 0, 0, 0, 0, 317, 99, 317, 0, 1, 23, 175, 851, 4437, 76, 43, 33, 99, 175, 262, 851, 4754
INVAR-6, Run: 050, P, 0, 120, 0, 0, 0, 0, 425, 97, 425, 0, 1, 19, 175, 702, 2691, 78, 49, 29, 97, 175, 262, 702, 3116
INVAR-6, Run: 051, P, 0, 198, 0, 0, 0, 0, 341, 94, 341, 0, 1, 13, 175, 693, 3210, 81, 51, 30, 94, 175, 262, 693, 3551
INVAR-6, Run: 052, P, 0, 543, 0, 0, 0, 96, 96, 0, 0, 1, 1, 17, 175, 594, 3206, 79, 45, 33, 96, 175, 262, 690, 3206
INVAR-6, Run: 053, P, 0, 541, 0, 0, 0, 95, 95, 0, 0, 1, 1, 15, 175, 547, 3154, 80, 54, 25, 95, 175, 262, 642, 3154
INVAR-6, Run: 054, P, 0, 547, 0, 0, 0, 98, 98, 0, 0, 1, 1, 21, 175, 736, 3441, 77, 46, 30, 98, 175, 262, 834, 3441
INVAR-6, Run: 055, P, 0, 146, 0, 0, 0, 0, 395, 95, 395, 0, 1, 15, 175, 600, 2819, 80, 48, 32, 95, 175, 262, 600, 3214
INVAR-6, Run: 056, P, 0, 547, 0, 0, 0, 98, 98, 0, 0, 1, 1, 21, 175, 620, 4152, 77, 52, 24, 98, 175, 262, 718, 4152
INVAR-6, Run: 057, P, 0, 153, 0, 0, 0, 0, 398, 100, 398, 0, 1, 25, 175, 621, 3109, 75, 46, 29, 100, 175, 262, 621, 3507
INVAR-6, Run: 058, P, 0, 317, 0, 0, 0, 0, 236, 101, 236, 0, 1, 27, 175, 767, 3573, 74, 46, 28, 101, 175, 262, 767, 3809
INVAR-6, Run: 059, P, 0, 551, 0, 0, 0, 100, 100, 0, 0, 1, 1, 25, 175, 860, 4422, 75, 45, 29, 100, 175, 262, 960, 4422
INVAR-6, Run: 060, P, 0, 466, 0, 0, 0, 0, 81, 98, 81, 0, 1, 21, 175, 894, 3470, 77, 46, 31, 98, 175, 262, 894, 3551
INVAR-6, Run: 061, P, 0, 430, 0, 0, 0, 0, 113, 96, 113, 0, 1, 17, 175, 664, 2854, 79, 47, 32, 96, 175, 262, 664, 2967
INVAR-6, Run: 062, P, 0, 543, 0, 0, 0, 96, 96, 0, 0, 1, 1, 17, 175, 819, 3136, 79, 51, 27, 96, 175, 262, 915, 3136
INVAR-6, Run: 063, P, 0, 423, 0, 0, 0, 0, 128, 100, 128, 0, 1, 25, 175, 974, 4414, 75, 48, 27, 100, 175, 262, 974, 4542
INVAR-6, Run: 064, P, 0, 547, 0, 0, 0, 98, 98, 0, 0, 1, 1, 21, 175, 489, 3250, 77, 44, 32, 98, 175, 262, 587, 3250
INVAR-6, Run: 065, P, 0, 541, 0, 0, 0, 95, 95, 0, 0, 1, 1, 15, 175, 552, 2655, 80, 45, 34, 95, 175, 262, 647, 2655
INVAR-6, Run: 066, P, 0, 223, 0, 0, 0, 0, 322, 97, 322, 0, 1, 19, 175, 563, 3339, 78, 51, 27, 97, 175, 262, 563, 3661
INVAR-6, Run: 067, P, 0, 549, 0, 0, 0, 99, 99, 0, 0, 1, 1, 23, 175, 787, 3711, 76, 55, 20, 99, 175, 262, 886, 3711
INVAR-6, Run: 068, P, 0, 219, 0, 0, 0, 0, 324, 96, 324, 0, 1, 17, 175, 586, 3127, 79, 56, 23, 96, 175, 262, 586, 3451
INVAR-6, Run: 069, P, 0, 277, 0, 0, 0, 0, 266, 96, 266, 0, 1, 17, 175, 643, 3172, 79, 48, 31, 96, 175, 262, 643, 3438
INVAR-6, Run: 070, P, 0, 545, 0, 0, 0, 97, 97, 0, 0, 1, 1, 19, 175, 927, 4439, 78, 46, 31, 97, 175, 262, 1024, 4439
INVAR-6, Run: 071, P, 0, 545, 0, 0, 0, 97, 97, 0, 0, 1, 1, 19, 175, 722, 4122, 78, 50, 27, 97, 175, 262, 819, 4122
INVAR-6, Run: 072, P, 0, 371, 0, 0, 0, 0, 172, 96, 172, 0, 1, 17, 175, 599, 3527, 79, 49, 30, 96, 175, 262, 599, 3699
INVAR-6, Run: 073, P, 0, 360, 0, 0, 0, 0, 185, 97, 185, 0, 1, 19, 175, 518, 3742, 78, 56, 22, 97, 175, 262, 518, 3927
INVAR-6, Run: 074, P, 0, 537, 0, 0, 0, 93, 93, 0, 0, 1, 1, 11, 175, 681, 2983, 82, 50, 31, 93, 175, 262, 774, 2983
INVAR-6, Run: 075, P, 0, 301, 0, 0, 0, 0, 248, 99, 248, 0, 1, 23, 175, 676, 4015, 76, 48, 28, 99, 175, 262, 676, 4263
INVAR-6, Run: 076, P, 0, 539, 0, 0, 0, 94, 94, 0, 0, 1, 1, 13, 175, 702, 3279, 81, 49, 31, 94, 175, 262, 796, 3279
INVAR-6, Run: 077, P, 0, 7, 0, 0, 0, 0, 540, 98, 540, 0, 1, 21, 175, 671, 3324, 77, 42, 35, 98, 175, 262, 671, 3864
INVAR-6, Run: 078, P, 0, 33, 0, 0, 0, 0, 518, 100, 518, 0, 1, 25, 175, 738, 3724, 75, 43, 32, 100, 175, 262, 738, 4242
INVAR-6, Run: 079, P, 0, 547, 0, 0, 0, 98, 98, 0, 0, 1, 1, 21, 175, 736, 3750, 77, 49, 27, 98, 175, 262, 834, 3750
INVAR-6, Run: 080, P, 0, 549, 0, 0, 0, 99, 99, 0, 0, 1, 1, 23, 175, 709, 3914, 76, 52, 23, 99, 175, 262, 808, 3914
INVAR-6, Run: 081, P, 0, 78, 0, 0, 0, 0, 471, 99, 471, 0, 1, 23, 175, 684, 3625, 76, 56, 20, 99, 175, 262, 684, 4096
INVAR-6, Run: 082, P, 0, 549, 0, 0, 0, 99, 99, 0, 0, 1, 1, 23, 175, 700, 4294, 76, 46, 29, 99, 175, 262, 799, 4294
INVAR-6, Run: 083, P, 0, 543, 0, 0, 0, 96, 96, 0, 0, 1, 1, 17, 175, 486, 2691, 79, 53, 25, 96, 175, 262, 582, 2691
INVAR-6, Run: 084, P, 0, 25, 0, 0, 0, 0, 518, 96, 518, 0, 1, 17, 175, 637, 3442, 79, 44, 35, 96, 175, 262, 637, 3960
INVAR-6, Run: 085, P, 0, 547, 0, 0, 0, 98, 98, 0, 0, 1, 1, 21, 175, 664, 3624, 77, 52, 24, 98, 175, 262, 762, 3624
INVAR-6, Run: 086, P, 0, 547, 0, 0, 0, 98, 98, 0, 0, 1, 1, 21, 175, 895, 3475, 77, 51, 25, 98, 175, 262, 993, 3475
INVAR-6, Run: 087, P, 0, 54, 0, 0, 0, 0, 491, 97, 491, 0, 1, 19, 175, 724, 3756, 78, 53, 25, 97, 175, 262, 724, 4247
INVAR-6, Run: 088, P, 0, 549, 0, 0, 0, 99, 99, 0, 0, 1, 1, 23, 175, 640, 3123, 76, 47, 28, 99, 175, 262, 739, 3123
INVAR-6, Run: 089, P, 0, 212, 0, 0, 0, 0, 339, 100, 339, 0, 1, 25, 175, 559, 3643, 75, 57, 18, 100, 175, 262, 559, 3982
INVAR-6, Run: 090, P, 0, 543, 0, 0, 0, 96, 96, 0, 0, 1, 1, 17, 175, 595, 3997, 79, 51, 27, 96, 175, 262, 691, 3997
INVAR-6, Run: 091, P, 0, 287, 0, 0, 0, 0, 258, 97, 258, 0, 1, 19, 175, 725, 3643, 78, 59, 19, 97, 175, 262, 725, 3901
INVAR-6, Run: 092, P, 0, 541, 0, 0, 0, 95, 95, 0, 0, 1, 1, 15, 175, 560, 2881, 80, 48, 31, 95, 175, 262, 655, 2881
INVAR-6, Run: 093, P, 0, 539, 0, 0, 0, 94, 94, 0, 0, 1, 1, 13, 175, 629, 2782, 81, 52, 28, 94, 175, 262, 723, 2782
INVAR-6, Run: 094, P, 0, 40, 0, 0, 0, 0, 511, 100, 511, 0, 1, 25, 175, 610, 2900, 75, 49, 26, 100, 175, 262, 610, 3411
INVAR-6, Run: 095, P, 0, 318, 0, 0, 0, 0, 227, 97, 227, 0, 1, 19, 175, 538, 3727, 78, 60, 18, 97, 175, 262, 538, 3954
INVAR-6, Run: 096, P, 0, 200, 0, 0, 0, 0, 347, 98, 347, 0, 1, 21, 175, 689, 4063, 77, 46, 31, 98, 175, 262, 689, 4410
INVAR-6, Run: 097, P, 0, 48, 0, 0, 0, 0, 495, 96, 495, 0, 1, 17, 175, 608, 3765, 79, 51, 28, 96, 175, 262, 608, 4260
INVAR-6, Run: 098, P, 0, 79, 0, 0, 0, 0, 462, 95, 462, 0, 1, 15, 175, 689, 2790, 80, 49, 31, 95, 175, 262, 689, 3252
INVAR-6, Run: 099, P, 0, 476, 0, 0, 0, 0, 69, 97, 69, 0, 1, 19, 175, 812, 3976, 78, 45, 33, 97, 175, 262, 812, 4045
INVAR-6, Run: 100, P, 0, 541, 0, 0, 0, 95, 95, 0, 0, 1, 1, 15, 175, 731, 4131, 80, 48, 31, 95, 175, 262, 826, 4131
INVAR-7, Run: 001, P, 0, 0, 0, 0, 0, 0, 0, 0, 0, 0, 0, 0, 0, 0, 0, 0, 0, 0, 0, 0, 0, 0, 0
INVAR-7, Run: 002, P, 0, 0, 0, 0, 0, 0, 0, 0, 0, 0, 0, 0, 0, 0, 0, 0, 0, 0, 0, 0, 0, 0, 0
INVAR-7, Run: 003, P, 0, 0, 0, 0, 0, 0, 0, 0, 0, 0, 0, 0, 0, 0, 0, 0, 0, 0, 0, 0, 0, 0, 0
INVAR-7, Run: 004, P, 0, 0, 0, 0, 0, 0, 0, 0, 0, 0, 0, 0, 0, 0, 0, 0, 0, 0, 0, 0, 0, 0, 0
INVAR-7, Run: 005, P, 0, 0, 0, 0, 0, 0, 0, 0, 0, 0, 0, 0, 0, 0, 0, 0, 0, 0, 0, 0, 0, 0, 0
INVAR-7, Run: 006, P, 0, 0, 0, 0, 0, 0, 0, 0, 0, 0, 0, 0, 0, 0, 0, 0, 0, 0, 0, 0, 0, 0, 0
INVAR-7, Run: 007, P, 0, 0, 0, 0, 0, 0, 0, 0, 0, 0, 0, 0, 0, 0, 0, 0, 0, 0, 0, 0, 0, 0, 0
INVAR-7, Run: 008, P, 0, 0, 0, 0, 0, 0, 0, 0, 0, 0, 0, 0, 0, 0, 0, 0, 0, 0, 0, 0, 0, 0, 0
INVAR-7, Run: 009, P, 0, 0, 0, 0, 0, 0, 0, 0, 0, 0, 0, 0, 0, 0, 0, 0, 0, 0, 0, 0, 0, 0, 0
INVAR-7, Run: 010, P, 0, 0, 0, 0, 0, 0, 0, 0, 0, 0, 0, 0, 0, 0, 0, 0, 0, 0, 0, 0, 0, 0, 0
INVAR-7, Run: 011, P, 0, 0, 0, 0, 0, 0, 0, 0, 0, 0, 0, 0, 0, 0, 0, 0, 0, 0, 0, 0, 0, 0, 0
INVAR-7, Run: 012, P, 0, 0, 0, 0, 0, 0, 0, 0, 0, 0, 0, 0, 0, 0, 0, 0, 0, 0, 0, 0, 0, 0, 0
INVAR-7, Run: 013, P, 0, 0, 0, 0, 0, 0, 0, 0, 0, 0, 0, 0, 0, 0, 0, 0, 0, 0, 0, 0, 0, 0, 0
INVAR-7, Run: 014, P, 0, 0, 0, 0, 0, 0, 0, 0, 0, 0, 0, 0, 0, 0, 0, 0, 0, 0, 0, 0, 0, 0, 0
INVAR-7, Run: 015, P, 0, 0, 0, 0, 0, 0, 0, 0, 0, 0, 0, 0, 0, 0, 0, 0, 0, 0, 0, 0, 0, 0, 0
INVAR-7, Run: 016, P, 0, 0, 0, 0, 0, 0, 0, 0, 0, 0, 0, 0, 0, 0, 0, 0, 0, 0, 0, 0, 0, 0, 0
INVAR-7, Run: 017, P, 0, 0, 0, 0, 0, 0, 0, 0, 0, 0, 0, 0, 0, 0, 0, 0, 0, 0, 0, 0, 0, 0, 0
INVAR-7, Run: 018, P, 0, 0, 0, 0, 0, 0, 0, 0, 0, 0, 0, 0, 0, 0, 0, 0, 0, 0, 0, 0, 0, 0, 0
INVAR-7, Run: 019, P, 0, 0, 0, 0, 0, 0, 0, 0, 0, 0, 0, 0, 0, 0, 0, 0, 0, 0, 0, 0, 0, 0, 0
INVAR-7, Run: 020, P, 0, 0, 0, 0, 0, 0, 0, 0, 0, 0, 0, 0, 0, 0, 0, 0, 0, 0, 0, 0, 0, 0, 0
INVAR-7, Run: 021, P, 0, 0, 0, 0, 0, 0, 0, 0, 0, 0, 0, 0, 0, 0, 0, 0, 0, 0, 0, 0, 0, 0, 0
INVAR-7, Run: 022, P, 0, 0, 0, 0, 0, 0, 0, 0, 0, 0, 0, 0, 0, 0, 0, 0, 0, 0, 0, 0, 0, 0, 0
INVAR-7, Run: 023, P, 0, 0, 0, 0, 0, 0, 0, 0, 0, 0, 0, 0, 0, 0, 0, 0, 0, 0, 0, 0, 0, 0, 0
INVAR-7, Run: 024, P, 0, 0, 0, 0, 0, 0, 0, 0, 0, 0, 0, 0, 0, 0, 0, 0, 0, 0, 0, 0, 0, 0, 0
INVAR-7, Run: 025, P, 0, 0, 0, 0, 0, 0, 0, 0, 0, 0, 0, 0, 0, 0, 0, 0, 0, 0, 0, 0, 0, 0, 0
INVAR-7, Run: 026, P, 0, 0, 0, 0, 0, 0, 0, 0, 0, 0, 0, 0, 0, 0, 0, 0, 0, 0, 0, 0, 0, 0, 0
INVAR-7, Run: 027, P, 0, 0, 0, 0, 0, 0, 0, 0, 0, 0, 0, 0, 0, 0, 0, 0, 0, 0, 0, 0, 0, 0, 0
INVAR-7, Run: 028, P, 0, 0, 0, 0, 0, 0, 0, 0, 0, 0, 0, 0, 0, 0, 0, 0, 0, 0, 0, 0, 0, 0, 0
INVAR-7, Run: 029, P, 0, 0, 0, 0, 0, 0, 0, 0, 0, 0, 0, 0, 0, 0, 0, 0, 0, 0, 0, 0, 0, 0, 0
INVAR-7, Run: 030, P, 0, 0, 0, 0, 0, 0, 0, 0, 0, 0, 0, 0, 0, 0, 0, 0, 0, 0, 0, 0, 0, 0, 0
INVAR-7, Run: 031, P, 0, 0, 0, 0, 0, 0, 0, 0, 0, 0, 0, 0, 0, 0, 0, 0, 0, 0, 0, 0, 0, 0, 0
INVAR-7, Run: 032, P, 0, 0, 0, 0, 0, 0, 0, 0, 0, 0, 0, 0, 0, 0, 0, 0, 0, 0, 0, 0, 0, 0, 0
INVAR-7, Run: 033, P, 0, 0, 0, 0, 0, 0, 0, 0, 0, 0, 0, 0, 0, 0, 0, 0, 0, 0, 0, 0, 0, 0, 0
INVAR-7, Run: 034, P, 0, 0, 0, 0, 0, 0, 0, 0, 0, 0, 0, 0, 0, 0, 0, 0, 0, 0, 0, 0, 0, 0, 0
INVAR-7, Run: 035, P, 0, 0, 0, 0, 0, 0, 0, 0, 0, 0, 0, 0, 0, 0, 0, 0, 0, 0, 0, 0, 0, 0, 0
INVAR-7, Run: 036, P, 0, 0, 0, 0, 0, 0, 0, 0, 0, 0, 0, 0, 0, 0, 0, 0, 0, 0, 0, 0, 0, 0, 0
INVAR-7, Run: 037, P, 0, 0, 0, 0, 0, 0, 0, 0, 0, 0, 0, 0, 0, 0, 0, 0, 0, 0, 0, 0, 0, 0, 0
INVAR-7, Run: 038, P, 0, 0, 0, 0, 0, 0, 0, 0, 0, 0, 0, 0, 0, 0, 0, 0, 0, 0, 0, 0, 0, 0, 0
INVAR-7, Run: 039, P, 0, 0, 0, 0, 0, 0, 0, 0, 0, 0, 0, 0, 0, 0, 0, 0, 0, 0, 0, 0, 0, 0, 0
INVAR-7, Run: 040, P, 0, 0, 0, 0, 0, 0, 0, 0, 0, 0, 0, 0, 0, 0, 0, 0, 0, 0, 0, 0, 0, 0, 0
INVAR-7, Run: 041, P, 0, 0, 0, 0, 0, 0, 0, 0, 0, 0, 0, 0, 0, 0, 0, 0, 0, 0, 0, 0, 0, 0, 0
INVAR-7, Run: 042, P, 0, 0, 0, 0, 0, 0, 0, 0, 0, 0, 0, 0, 0, 0, 0, 0, 0, 0, 0, 0, 0, 0, 0
INVAR-7, Run: 043, P, 0, 0, 0, 0, 0, 0, 0, 0, 0, 0, 0, 0, 0, 0, 0, 0, 0, 0, 0, 0, 0, 0, 0
INVAR-7, Run: 044, P, 0, 0, 0, 0, 0, 0, 0, 0, 0, 0, 0, 0, 0, 0, 0, 0, 0, 0, 0, 0, 0, 0, 0
INVAR-7, Run: 045, P, 0, 0, 0, 0, 0, 0, 0, 0, 0, 0, 0, 0, 0, 0, 0, 0, 0, 0, 0, 0, 0, 0, 0
INVAR-7, Run: 046, P, 0, 0, 0, 0, 0, 0, 0, 0, 0, 0, 0, 0, 0, 0, 0, 0, 0, 0, 0, 0, 0, 0, 0
INVAR-7, Run: 047, P, 0, 0, 0, 0, 0, 0, 0, 0, 0, 0, 0, 0, 0, 0, 0, 0, 0, 0, 0, 0, 0, 0, 0
INVAR-7, Run: 048, P, 0, 0, 0, 0, 0, 0, 0, 0, 0, 0, 0, 0, 0, 0, 0, 0, 0, 0, 0, 0, 0, 0, 0
INVAR-7, Run: 049, P, 0, 0, 0, 0, 0, 0, 0, 0, 0, 0, 0, 0, 0, 0, 0, 0, 0, 0, 0, 0, 0, 0, 0
INVAR-7, Run: 050, P, 0, 0, 0, 0, 0, 0, 0, 0, 0, 0, 0, 0, 0, 0, 0, 0, 0, 0, 0, 0, 0, 0, 0
INVAR-7, Run: 051, P, 0, 0, 0, 0, 0, 0, 0, 0, 0, 0, 0, 0, 0, 0, 0, 0, 0, 0, 0, 0, 0, 0, 0
INVAR-7, Run: 052, P, 0, 0, 0, 0, 0, 0, 0, 0, 0, 0, 0, 0, 0, 0, 0, 0, 0, 0, 0, 0, 0, 0, 0
INVAR-7, Run: 053, P, 0, 0, 0, 0, 0, 0, 0, 0, 0, 0, 0, 0, 0, 0, 0, 0, 0, 0, 0, 0, 0, 0, 0
INVAR-7, Run: 054, P, 0, 0, 0, 0, 0, 0, 0, 0, 0, 0, 0, 0, 0, 0, 0, 0, 0, 0, 0, 0, 0, 0, 0
INVAR-7, Run: 055, P, 0, 0, 0, 0, 0, 0, 0, 0, 0, 0, 0, 0, 0, 0, 0, 0, 0, 0, 0, 0, 0, 0, 0
INVAR-7, Run: 056, P, 0, 0, 0, 0, 0, 0, 0, 0, 0, 0, 0, 0, 0, 0, 0, 0, 0, 0, 0, 0, 0, 0, 0
INVAR-7, Run: 057, P, 0, 0, 0, 0, 0, 0, 0, 0, 0, 0, 0, 0, 0, 0, 0, 0, 0, 0, 0, 0, 0, 0, 0
INVAR-7, Run: 058, P, 0, 0, 0, 0, 0, 0, 0, 0, 0, 0, 0, 0, 0, 0, 0, 0, 0, 0, 0, 0, 0, 0, 0
INVAR-7, Run: 059, P, 0, 0, 0, 0, 0, 0, 0, 0, 0, 0, 0, 0, 0, 0, 0, 0, 0, 0, 0, 0, 0, 0, 0
INVAR-7, Run: 060, P, 0, 0, 0, 0, 0, 0, 0, 0, 0, 0, 0, 0, 0, 0, 0, 0, 0, 0, 0, 0, 0, 0, 0
INVAR-7, Run: 061, P, 0, 0, 0, 0, 0, 0, 0, 0, 0, 0, 0, 0, 0, 0, 0, 0, 0, 0, 0, 0, 0, 0, 0
INVAR-7, Run: 062, P, 0, 0, 0, 0, 0, 0, 0, 0, 0, 0, 0, 0, 0, 0, 0, 0, 0, 0, 0, 0, 0, 0, 0
INVAR-7, Run: 063, P, 0, 0, 0, 0, 0, 0, 0, 0, 0, 0, 0, 0, 0, 0, 0, 0, 0, 0, 0, 0, 0, 0, 0
INVAR-7, Run: 064, P, 0, 0, 0, 0, 0, 0, 0, 0, 0, 0, 0, 0, 0, 0, 0, 0, 0, 0, 0, 0, 0, 0, 0
INVAR-7, Run: 065, P, 0, 0, 0, 0, 0, 0, 0, 0, 0, 0, 0, 0, 0, 0, 0, 0, 0, 0, 0, 0, 0, 0, 0
INVAR-7, Run: 066, P, 0, 0, 0, 0, 0, 0, 0, 0, 0, 0, 0, 0, 0, 0, 0, 0, 0, 0, 0, 0, 0, 0, 0
INVAR-7, Run: 067, P, 0, 0, 0, 0, 0, 0, 0, 0, 0, 0, 0, 0, 0, 0, 0, 0, 0, 0, 0, 0, 0, 0, 0
INVAR-7, Run: 068, P, 0, 0, 0, 0, 0, 0, 0, 0, 0, 0, 0, 0, 0, 0, 0, 0, 0, 0, 0, 0, 0, 0, 0
INVAR-7, Run: 069, P, 0, 0, 0, 0, 0, 0, 0, 0, 0, 0, 0, 0, 0, 0, 0, 0, 0, 0, 0, 0, 0, 0, 0
INVAR-7, Run: 070, P, 0, 0, 0, 0, 0, 0, 0, 0, 0, 0, 0, 0, 0, 0, 0, 0, 0, 0, 0, 0, 0, 0, 0
INVAR-7, Run: 071, P, 0, 0, 0, 0, 0, 0, 0, 0, 0, 0, 0, 0, 0, 0, 0, 0, 0, 0, 0, 0, 0, 0, 0
INVAR-7, Run: 072, P, 0, 0, 0, 0, 0, 0, 0, 0, 0, 0, 0, 0, 0, 0, 0, 0, 0, 0, 0, 0, 0, 0, 0
INVAR-7, Run: 073, P, 0, 0, 0, 0, 0, 0, 0, 0, 0, 0, 0, 0, 0, 0, 0, 0, 0, 0, 0, 0, 0, 0, 0
INVAR-7, Run: 074, P, 0, 0, 0, 0, 0, 0, 0, 0, 0, 0, 0, 0, 0, 0, 0, 0, 0, 0, 0, 0, 0, 0, 0
INVAR-7, Run: 075, P, 0, 0, 0, 0, 0, 0, 0, 0, 0, 0, 0, 0, 0, 0, 0, 0, 0, 0, 0, 0, 0, 0, 0
INVAR-7, Run: 076, P, 0, 0, 0, 0, 0, 0, 0, 0, 0, 0, 0, 0, 0, 0, 0, 0, 0, 0, 0, 0, 0, 0, 0
INVAR-7, Run: 077, P, 0, 0, 0, 0, 0, 0, 0, 0, 0, 0, 0, 0, 0, 0, 0, 0, 0, 0, 0, 0, 0, 0, 0
INVAR-7, Run: 078, P, 0, 0, 0, 0, 0, 0, 0, 0, 0, 0, 0, 0, 0, 0, 0, 0, 0, 0, 0, 0, 0, 0, 0
INVAR-7, Run: 079, P, 0, 0, 0, 0, 0, 0, 0, 0, 0, 0, 0, 0, 0, 0, 0, 0, 0, 0, 0, 0, 0, 0, 0
INVAR-7, Run: 080, P, 0, 0, 0, 0, 0, 0, 0, 0, 0, 0, 0, 0, 0, 0, 0, 0, 0, 0, 0, 0, 0, 0, 0
INVAR-7, Run: 081, P, 0, 0, 0, 0, 0, 0, 0, 0, 0, 0, 0, 0, 0, 0, 0, 0, 0, 0, 0, 0, 0, 0, 0
INVAR-7, Run: 082, P, 0, 0, 0, 0, 0, 0, 0, 0, 0, 0, 0, 0, 0, 0, 0, 0, 0, 0, 0, 0, 0, 0, 0
INVAR-7, Run: 083, P, 0, 0, 0, 0, 0, 0, 0, 0, 0, 0, 0, 0, 0, 0, 0, 0, 0, 0, 0, 0, 0, 0, 0
INVAR-7, Run: 084, P, 0, 0, 0, 0, 0, 0, 0, 0, 0, 0, 0, 0, 0, 0, 0, 0, 0, 0, 0, 0, 0, 0, 0
INVAR-7, Run: 085, P, 0, 0, 0, 0, 0, 0, 0, 0, 0, 0, 0, 0, 0, 0, 0, 0, 0, 0, 0, 0, 0, 0, 0
INVAR-7, Run: 086, P, 0, 0, 0, 0, 0, 0, 0, 0, 0, 0, 0, 0, 0, 0, 0, 0, 0, 0, 0, 0, 0, 0, 0
INVAR-7, Run: 087, P, 0, 0, 0, 0, 0, 0, 0, 0, 0, 0, 0, 0, 0, 0, 0, 0, 0, 0, 0, 0, 0, 0, 0
INVAR-7, Run: 088, P, 0, 0, 0, 0, 0, 0, 0, 0, 0, 0, 0, 0, 0, 0, 0, 0, 0, 0, 0, 0, 0, 0, 0
INVAR-7, Run: 089, P, 0, 0, 0, 0, 0, 0, 0, 0, 0, 0, 0, 0, 0, 0, 0, 0, 0, 0, 0, 0, 0, 0, 0
INVAR-7, Run: 090, P, 0, 0, 0, 0, 0, 0, 0, 0, 0, 0, 0, 0, 0, 0, 0, 0, 0, 0, 0, 0, 0, 0, 0
INVAR-7, Run: 091, P, 0, 0, 0, 0, 0, 0, 0, 0, 0, 0, 0, 0, 0, 0, 0, 0, 0, 0, 0, 0, 0, 0, 0
INVAR-7, Run: 092, P, 0, 0, 0, 0, 0, 0, 0, 0, 0, 0, 0, 0, 0, 0, 0, 0, 0, 0, 0, 0, 0, 0, 0
INVAR-7, Run: 093, P, 0, 0, 0, 0, 0, 0, 0, 0, 0, 0, 0, 0, 0, 0, 0, 0, 0, 0, 0, 0, 0, 0, 0
INVAR-7, Run: 094, P, 0, 0, 0, 0, 0, 0, 0, 0, 0, 0, 0, 0, 0, 0, 0, 0, 0, 0, 0, 0, 0, 0, 0
INVAR-7, Run: 095, P, 0, 0, 0, 0, 0, 0, 0, 0, 0, 0, 0, 0, 0, 0, 0, 0, 0, 0, 0, 0, 0, 0, 0
INVAR-7, Run: 096, P, 0, 0, 0, 0, 0, 0, 0, 0, 0, 0, 0, 0, 0, 0, 0, 0, 0, 0, 0, 0, 0, 0, 0
INVAR-7, Run: 097, P, 0, 0, 0, 0, 0, 0, 0, 0, 0, 0, 0, 0, 0, 0, 0, 0, 0, 0, 0, 0, 0, 0, 0
INVAR-7, Run: 098, P, 0, 0, 0, 0, 0, 0, 0, 0, 0, 0, 0, 0, 0, 0, 0, 0, 0, 0, 0, 0, 0, 0, 0
INVAR-7, Run: 099, P, 0, 0, 0, 0, 0, 0, 0, 0, 0, 0, 0, 0, 0, 0, 0, 0, 0, 0, 0, 0, 0, 0, 0
INVAR-7, Run: 100, P, 0, 0, 0, 0, 0, 0, 0, 0, 0, 0, 0, 0, 0, 0, 0, 0, 0, 0, 0, 0, 0, 0, 0
INVAR-8, Run: 001, P, 0, 156, 0, 0, 0, 28, 28, 0, 0, 1, 0, 6, 50, 113, 572, 22, 12, 9, 28, 50, 75, 141, 572
INVAR-8, Run: 002, P, 0, 58, 0, 0, 0, 0, 100, 29, 100, 0, 0, 8, 50, 88, 377, 21, 12, 9, 29, 50, 75, 88, 477
INVAR-8, Run: 003, P, 0, 156, 0, 0, 0, 28, 28, 0, 0, 1, 0, 6, 50, 133, 505, 22, 11, 10, 28, 50, 75, 161, 505
INVAR-8, Run: 004, P, 0, 30, 0, 0, 0, 0, 126, 28, 126, 0, 0, 6, 50, 100, 401, 22, 13, 9, 28, 50, 75, 100, 527
INVAR-8, Run: 005, P, 0, 3, 0, 0, 0, 0, 157, 30, 157, 0, 0, 10, 50, 126, 378, 20, 13, 7, 30, 50, 75, 126, 535
INVAR-8, Run: 006, P, 0, 158, 0, 0, 0, 29, 29, 0, 0, 1, 0, 8, 50, 107, 423, 21, 13, 7, 29, 50, 75, 136, 423
INVAR-8, Run: 007, P, 0, 158, 0, 0, 0, 29, 29, 0, 0, 1, 0, 8, 50, 125, 316, 21, 12, 8, 29, 50, 75, 154, 316
INVAR-8, Run: 008, P, 0, 156, 0, 0, 0, 28, 28, 0, 0, 1, 0, 6, 50, 87, 692, 22, 14, 7, 28, 50, 75, 115, 692
INVAR-8, Run: 009, P, 0, 16, 0, 0, 0, 0, 138, 27, 138, 0, 0, 4, 50, 123, 601, 23, 14, 9, 27, 50, 75, 123, 739
INVAR-8, Run: 010, P, 0, 24, 0, 0, 0, 0, 138, 31, 138, 0, 0, 12, 50, 112, 473, 19, 14, 5, 31, 50, 75, 112, 611
INVAR-8, Run: 011, P, 0, 110, 0, 0, 0, 0, 52, 31, 52, 0, 0, 12, 50, 98, 521, 19, 11, 8, 31, 50, 75, 98, 573
INVAR-8, Run: 012, P, 0, 162, 0, 0, 0, 31, 31, 0, 0, 1, 0, 12, 50, 99, 402, 19, 13, 5, 31, 50, 75, 130, 402
INVAR-8, Run: 013, P, 0, 156, 0, 0, 0, 28, 28, 0, 0, 1, 0, 6, 50, 141, 412, 22, 11, 10, 28, 50, 75, 169, 412
INVAR-8, Run: 014, P, 0, 162, 0, 0, 0, 31, 31, 0, 0, 1, 0, 12, 50, 66, 548, 19, 13, 5, 31, 50, 75, 97, 548
INVAR-8, Run: 015, P, 0, 28, 0, 0, 0, 0, 134, 31, 134, 0, 0, 12, 50, 84, 327, 19, 11, 8, 31, 50, 75, 84, 461
INVAR-8, Run: 016, P, 0, 162, 0, 0, 0, 31, 31, 0, 0, 1, 0, 12, 50, 110, 356, 19, 9, 9, 31, 50, 75, 141, 356
INVAR-8, Run: 017, P, 0, 99, 0, 0, 0, 0, 55, 27, 55, 0, 0, 4, 50, 138, 432, 23, 15, 8, 27, 50, 75, 138, 487
INVAR-8, Run: 018, P, 0, 160, 0, 0, 0, 30, 30, 0, 0, 1, 0, 10, 50, 100, 358, 20, 6, 13, 30, 50, 75, 130, 358
INVAR-8, Run: 019, P, 0, 160, 0, 0, 0, 30, 30, 0, 0, 1, 0, 10, 50, 106, 384, 20, 8, 11, 30, 50, 75, 136, 384
INVAR-8, Run: 020, P, 0, 158, 0, 0, 0, 29, 29, 0, 0, 1, 0, 8, 50, 69, 311, 21, 11, 9, 29, 50, 75, 98, 311
INVAR-8, Run: 021, P, 0, 158, 0, 0, 0, 29, 29, 0, 0, 1, 0, 8, 50, 98, 337, 21, 9, 11, 29, 50, 75, 127, 337
INVAR-8, Run: 022, P, 0, 119, 0, 0, 0, 0, 43, 31, 43, 0, 0, 12, 50, 134, 518, 19, 10, 9, 31, 50, 75, 134, 561
INVAR-8, Run: 023, P, 0, 156, 0, 0, 0, 28, 28, 0, 0, 1, 0, 6, 50, 133, 471, 22, 12, 9, 28, 50, 75, 161, 471
INVAR-8, Run: 024, P, 0, 160, 0, 0, 0, 30, 30, 0, 0, 1, 0, 10, 50, 81, 402, 20, 12, 7, 30, 50, 75, 111, 402
INVAR-8, Run: 025, P, 0, 121, 0, 0, 0, 0, 37, 29, 37, 0, 0, 8, 50, 100, 366, 21, 15, 6, 29, 50, 75, 100, 403
INVAR-8, Run: 026, P, 0, 26, 0, 0, 0, 0, 134, 30, 134, 0, 0, 10, 50, 75, 441, 20, 13, 7, 30, 50, 75, 75, 575
INVAR-8, Run: 027, P, 0, 45, 0, 0, 0, 0, 117, 31, 117, 0, 0, 12, 50, 115, 476, 19, 12, 7, 31, 50, 75, 115, 593
INVAR-8, Run: 028, P, 0, 69, 0, 0, 0, 0, 91, 30, 91, 0, 0, 10, 50, 81, 301, 20, 14, 6, 30, 50, 75, 81, 392
INVAR-8, Run: 029, P, 0, 39, 0, 0, 0, 0, 119, 29, 119, 0, 0, 8, 50, 83, 374, 21, 12, 9, 29, 50, 75, 83, 493
INVAR-8, Run: 030, P, 0, 156, 0, 0, 0, 28, 28, 0, 0, 1, 0, 6, 50, 81, 379, 22, 12, 9, 28, 50, 75, 109, 379
INVAR-8, Run: 031, P, 0, 22, 0, 0, 0, 0, 138, 30, 138, 0, 0, 10, 50, 83, 262, 20, 14, 6, 30, 50, 75, 83, 400
INVAR-8, Run: 032, P, 0, 31, 0, 0, 0, 0, 135, 33, 135, 0, 0, 16, 50, 36, 234, 17, 11, 6, 33, 50, 75, 36, 369
INVAR-8, Run: 033, P, 0, 50, 0, 0, 0, 0, 114, 32, 114, 0, 0, 14, 50, 138, 907, 18, 9, 9, 32, 50, 75, 138, 1021
INVAR-8, Run: 034, P, 0, 11, 0, 0, 0, 0, 149, 30, 149, 0, 0, 10, 50, 56, 314, 20, 14, 6, 30, 50, 75, 56, 463
INVAR-8, Run: 035, P, 0, 5, 0, 0, 0, 0, 153, 29, 153, 0, 0, 8, 50, 78, 356, 21, 14, 7, 29, 50, 75, 78, 509
INVAR-8, Run: 036, P, 0, 59, 0, 0, 0, 0, 103, 31, 103, 0, 0, 12, 50, 86, 279, 19, 11, 8, 31, 50, 75, 86, 382
INVAR-8, Run: 037, P, 0, 158, 0, 0, 0, 29, 29, 0, 0, 1, 0, 8, 50, 47, 395, 21, 14, 6, 29, 50, 75, 76, 395
INVAR-8, Run: 038, P, 0, 164, 0, 0, 0, 32, 32, 0, 0, 1, 0, 14, 50, 88, 359, 18, 15, 2, 32, 50, 75, 120, 359
INVAR-8, Run: 039, P, 0, 164, 0, 0, 0, 32, 32, 0, 0, 1, 0, 14, 50, 114, 667, 18, 15, 2, 32, 50, 75, 146, 667
INVAR-8, Run: 040, P, 0, 162, 0, 0, 0, 31, 31, 0, 0, 1, 0, 12, 50, 98, 388, 19, 10, 8, 31, 50, 75, 129, 388
INVAR-8, Run: 041, P, 0, 70, 0, 0, 0, 0, 92, 31, 92, 0, 0, 12, 50, 83, 551, 19, 16, 3, 31, 50, 75, 83, 643
INVAR-8, Run: 042, P, 0, 64, 0, 0, 0, 0, 94, 29, 94, 0, 0, 8, 50, 55, 301, 21, 15, 6, 29, 50, 75, 55, 395
INVAR-8, Run: 043, P, 0, 11, 0, 0, 0, 0, 151, 31, 151, 0, 0, 12, 50, 52, 502, 19, 15, 4, 31, 50, 75, 52, 653
INVAR-8, Run: 044, P, 0, 40, 0, 0, 0, 0, 122, 31, 122, 0, 0, 12, 50, 52, 452, 19, 16, 3, 31, 50, 75, 52, 574
INVAR-8, Run: 045, P, 0, 90, 0, 0, 0, 0, 68, 29, 68, 0, 0, 8, 50, 125, 526, 21, 11, 10, 29, 50, 75, 125, 594
INVAR-8, Run: 046, P, 0, 126, 0, 0, 0, 0, 34, 30, 34, 0, 0, 10, 50, 76, 487, 20, 11, 9, 30, 50, 75, 76, 521
INVAR-8, Run: 047, P, 0, 154, 0, 0, 0, 27, 27, 0, 0, 1, 0, 4, 50, 100, 321, 23, 16, 6, 27, 50, 75, 127, 321
INVAR-8, Run: 048, P, 0, 132, 0, 0, 0, 1, 25, 27, 24, 0, 0, 6, 50, 111, 448, 22, 13, 9, 28, 50, 75, 112, 472
INVAR-8, Run: 049, P, 0, 123, 0, 0, 0, 0, 39, 31, 39, 0, 0, 12, 50, 75, 376, 19, 9, 10, 31, 50, 75, 75, 415
INVAR-8, Run: 050, P, 0, 154, 0, 0, 0, 27, 27, 0, 0, 1, 0, 4, 50, 80, 441, 23, 15, 7, 27, 50, 75, 107, 441
INVAR-8, Run: 051, P, 0, 154, 0, 0, 0, 27, 27, 0, 0, 1, 0, 4, 50, 66, 260, 23, 13, 9, 27, 50, 75, 93, 260
INVAR-8, Run: 052, P, 0, 158, 0, 0, 0, 29, 29, 0, 0, 1, 0, 8, 50, 58, 466, 21, 14, 6, 29, 50, 75, 87, 466
INVAR-8, Run: 053, P, 0, 125, 0, 0, 0, 0, 35, 30, 35, 0, 0, 10, 50, 110, 442, 20, 10, 10, 30, 50, 75, 110, 477
INVAR-8, Run: 054, P, 0, 160, 0, 0, 0, 30, 30, 0, 0, 1, 0, 10, 50, 77, 452, 20, 9, 10, 30, 50, 75, 107, 452
INVAR-8, Run: 055, P, 0, 127, 0, 0, 0, 0, 33, 30, 33, 0, 0, 10, 50, 80, 496, 20, 12, 8, 30, 50, 75, 80, 529
INVAR-8, Run: 056, P, 0, 79, 0, 0, 0, 0, 77, 28, 77, 0, 0, 6, 50, 96, 416, 22, 17, 5, 28, 50, 75, 96, 493
INVAR-8, Run: 057, P, 0, 60, 0, 0, 0, 0, 98, 29, 98, 0, 0, 8, 50, 84, 378, 21, 9, 12, 29, 50, 75, 84, 476
INVAR-8, Run: 058, P, 0, 69, 0, 0, 0, 0, 93, 31, 93, 0, 0, 12, 50, 97, 343, 19, 8, 11, 31, 50, 75, 97, 436
INVAR-8, Run: 059, P, 0, 20, 0, 0, 0, 0, 138, 29, 138, 0, 0, 8, 50, 86, 240, 21, 15, 6, 29, 50, 75, 86, 378
INVAR-8, Run: 060, P, 0, 91, 0, 0, 0, 0, 67, 29, 67, 0, 0, 8, 50, 68, 457, 21, 15, 6, 29, 50, 75, 68, 524
INVAR-8, Run: 061, P, 0, 34, 0, 0, 0, 0, 124, 29, 124, 0, 0, 8, 50, 142, 712, 21, 13, 8, 29, 50, 75, 142, 836
INVAR-8, Run: 062, P, 0, 88, 0, 0, 0, 0, 70, 29, 70, 0, 0, 8, 50, 106, 408, 21, 15, 6, 29, 50, 75, 106, 478
INVAR-8, Run: 063, P, 0, 124, 0, 0, 0, 0, 32, 28, 32, 0, 0, 6, 50, 105, 418, 22, 14, 8, 28, 50, 75, 105, 450
INVAR-8, Run: 064, P, 0, 48, 0, 0, 0, 0, 112, 30, 112, 0, 0, 10, 50, 114, 417, 20, 15, 5, 30, 50, 75, 114, 529
INVAR-8, Run: 065, P, 0, 37, 0, 0, 0, 0, 123, 30, 123, 0, 0, 10, 50, 97, 415, 20, 10, 10, 30, 50, 75, 97, 538
INVAR-8, Run: 066, P, 0, 156, 0, 0, 0, 28, 28, 0, 0, 1, 0, 6, 50, 83, 321, 22, 15, 6, 28, 50, 75, 111, 321
INVAR-8, Run: 067, P, 0, 42, 0, 0, 0, 0, 116, 29, 116, 0, 0, 8, 50, 91, 416, 21, 13, 8, 29, 50, 75, 91, 532
INVAR-8, Run: 068, P, 0, 156, 0, 0, 0, 28, 28, 0, 0, 1, 0, 6, 50, 93, 388, 22, 15, 6, 28, 50, 75, 121, 388
INVAR-8, Run: 069, P, 0, 156, 0, 0, 0, 28, 28, 0, 0, 1, 0, 6, 50, 46, 274, 22, 15, 6, 28, 50, 75, 74, 274
INVAR-8, Run: 070, P, 0, 49, 0, 0, 0, 0, 107, 28, 107, 0, 0, 6, 50, 89, 379, 22, 13, 9, 28, 50, 75, 89, 486
INVAR-8, Run: 071, P, 0, 97, 0, 0, 0, 0, 59, 28, 59, 0, 0, 6, 50, 92, 543, 22, 13, 9, 28, 50, 75, 92, 602
INVAR-8, Run: 072, P, 0, 5, 0, 0, 0, 0, 159, 32, 159, 0, 0, 14, 50, 99, 417, 18, 13, 5, 32, 50, 75, 99, 576
INVAR-8, Run: 073, P, 0, 152, 0, 0, 0, 26, 26, 0, 0, 1, 0, 2, 50, 83, 339, 24, 12, 11, 26, 50, 75, 109, 339
INVAR-8, Run: 074, P, 0, 168, 0, 0, 0, 34, 34, 0, 0, 1, 0, 18, 50, 79, 409, 16, 13, 2, 34, 50, 75, 113, 409
INVAR-8, Run: 075, P, 0, 160, 0, 0, 0, 30, 30, 0, 0, 1, 0, 10, 50, 93, 324, 20, 9, 10, 30, 50, 75, 123, 324
INVAR-8, Run: 076, P, 0, 156, 0, 0, 0, 28, 28, 0, 0, 1, 0, 6, 50, 67, 326, 22, 10, 11, 28, 50, 75, 95, 326
INVAR-8, Run: 077, P, 0, 160, 0, 0, 0, 30, 30, 0, 0, 1, 0, 10, 50, 94, 331, 20, 12, 7, 30, 50, 75, 124, 331
INVAR-8, Run: 078, P, 0, 160, 0, 0, 0, 30, 30, 0, 0, 1, 0, 10, 50, 100, 486, 20, 14, 5, 30, 50, 75, 130, 486
INVAR-8, Run: 079, P, 0, 164, 0, 0, 0, 32, 32, 0, 0, 1, 0, 14, 50, 80, 310, 18, 11, 6, 32, 50, 75, 112, 310
INVAR-8, Run: 080, P, 0, 158, 0, 0, 0, 29, 29, 0, 0, 1, 0, 8, 50, 128, 672, 21, 10, 10, 29, 50, 75, 157, 672
INVAR-8, Run: 081, P, 0, 114, 0, 0, 0, 0, 44, 29, 44, 0, 0, 8, 50, 88, 438, 21, 15, 6, 29, 50, 75, 88, 482
INVAR-8, Run: 082, P, 0, 156, 0, 0, 0, 28, 28, 0, 0, 1, 0, 6, 50, 110, 369, 22, 11, 10, 28, 50, 75, 138, 369
INVAR-8, Run: 083, P, 0, 46, 0, 0, 0, 0, 112, 29, 112, 0, 0, 8, 50, 89, 259, 21, 14, 7, 29, 50, 75, 89, 371
INVAR-8, Run: 084, P, 0, 21, 0, 0, 0, 0, 141, 31, 141, 0, 0, 12, 50, 91, 353, 19, 13, 6, 31, 50, 75, 91, 494
INVAR-8, Run: 085, P, 0, 27, 0, 0, 0, 0, 135, 31, 135, 0, 0, 12, 50, 104, 427, 19, 15, 4, 31, 50, 75, 104, 562
INVAR-8, Run: 086, P, 0, 58, 0, 0, 0, 0, 100, 29, 100, 0, 0, 8, 50, 87, 522, 21, 12, 9, 29, 50, 75, 87, 622
INVAR-8, Run: 087, P, 0, 121, 0, 0, 0, 0, 35, 28, 35, 0, 0, 6, 50, 84, 387, 22, 14, 8, 28, 50, 75, 84, 422
INVAR-8, Run: 088, P, 0, 164, 0, 0, 0, 32, 32, 0, 0, 1, 0, 14, 50, 171, 733, 18, 14, 3, 32, 50, 75, 203, 733
INVAR-8, Run: 089, P, 0, 158, 0, 0, 0, 29, 29, 0, 0, 1, 0, 8, 50, 134, 563, 21, 14, 6, 29, 50, 75, 163, 563
INVAR-8, Run: 090, P, 0, 73, 0, 0, 0, 0, 85, 29, 85, 0, 0, 8, 50, 115, 512, 21, 13, 8, 29, 50, 75, 115, 597
INVAR-8, Run: 091, P, 0, 158, 0, 0, 0, 29, 29, 0, 0, 1, 0, 8, 50, 96, 491, 21, 9, 11, 29, 50, 75, 125, 491
INVAR-8, Run: 092, P, 0, 156, 0, 0, 0, 28, 28, 0, 0, 1, 0, 6, 50, 104, 482, 22, 12, 9, 28, 50, 75, 132, 482
INVAR-8, Run: 093, P, 0, 158, 0, 0, 0, 29, 29, 0, 0, 1, 0, 8, 50, 141, 617, 21, 11, 9, 29, 50, 75, 170, 617
INVAR-8, Run: 094, P, 0, 160, 0, 0, 0, 30, 30, 0, 0, 1, 0, 10, 50, 104, 786, 20, 13, 6, 30, 50, 75, 134, 786
INVAR-8, Run: 095, P, 0, 55, 0, 0, 0, 0, 107, 31, 107, 0, 0, 12, 50, 47, 381, 19, 16, 3, 31, 50, 75, 47, 488
INVAR-8, Run: 096, P, 0, 160, 0, 0, 0, 30, 30, 0, 0, 1, 0, 10, 50, 89, 476, 20, 11, 8, 30, 50, 75, 119, 476
INVAR-8, Run: 097, P, 0, 160, 0, 0, 0, 30, 30, 0, 0, 1, 0, 10, 50, 138, 423, 20, 14, 5, 30, 50, 75, 168, 423
INVAR-8, Run: 098, P, 0, 33, 0, 0, 0, 0, 129, 31, 129, 0, 0, 12, 50, 66, 170, 19, 14, 5, 31, 50, 75, 66, 299
INVAR-8, Run: 099, P, 0, 26, 0, 0, 0, 0, 130, 28, 130, 0, 0, 6, 50, 73, 276, 22, 17, 5, 28, 50, 75, 73, 406
INVAR-8, Run: 100, P, 0, 4, 0, 0, 0, 0, 154, 29, 154, 0, 0, 8, 50, 53, 380, 21, 16, 5, 29, 50, 75, 53, 534
INVAR-9, Run: 001, P, 0, 1, 0, 0, 0, 0, 315, 58, 315, 0, 0, 16, 100, 267, 1581, 42, 32, 10, 58, 100, 150, 267, 1896
INVAR-9, Run: 002, P, 0, 83, 0, 0, 0, 0, 227, 55, 227, 0, 0, 10, 100, 276, 1506, 45, 27, 18, 55, 100, 150, 276, 1733
INVAR-9, Run: 003, P, 0, 309, 0, 0, 0, 5, 14, 54, 9, 0, 0, 18, 100, 263, 1533, 41, 27, 14, 59, 100, 150, 268, 1542
INVAR-9, Run: 004, P, 0, 131, 0, 0, 0, 0, 175, 53, 175, 0, 0, 6, 100, 241, 1257, 47, 31, 16, 53, 100, 150, 241, 1432
INVAR-9, Run: 005, P, 0, 90, 0, 0, 0, 0, 220, 55, 220, 0, 0, 10, 100, 282, 1772, 45, 29, 16, 55, 100, 150, 282, 1992
INVAR-9, Run: 006, P, 0, 66, 0, 0, 0, 0, 246, 56, 246, 0, 0, 12, 100, 268, 1220, 44, 28, 16, 56, 100, 150, 268, 1466
INVAR-9, Run: 007, P, 0, 12, 0, 0, 0, 0, 306, 59, 306, 0, 0, 18, 100, 183, 1119, 41, 29, 12, 59, 100, 150, 183, 1425
INVAR-9, Run: 008, P, 0, 222, 0, 0, 0, 0, 90, 56, 90, 0, 0, 12, 100, 346, 1616, 44, 25, 19, 56, 100, 150, 346, 1706
INVAR-9, Run: 009, P, 0, 314, 0, 0, 0, 57, 57, 0, 0, 1, 0, 14, 100, 291, 1413, 43, 31, 11, 57, 100, 150, 348, 1413
INVAR-9, Run: 010, P, 0, 141, 0, 0, 0, 0, 169, 55, 169, 0, 0, 10, 100, 293, 1341, 45, 29, 16, 55, 100, 150, 293, 1510
INVAR-9, Run: 011, P, 0, 95, 0, 0, 0, 0, 221, 58, 221, 0, 0, 16, 100, 243, 1000, 42, 26, 16, 58, 100, 150, 243, 1221
INVAR-9, Run: 012, P, 0, 97, 0, 0, 0, 0, 221, 59, 221, 0, 0, 18, 100, 285, 1100, 41, 18, 23, 59, 100, 150, 285, 1321
INVAR-9, Run: 013, P, 0, 7, 0, 0, 0, 0, 309, 58, 309, 0, 0, 16, 100, 273, 990, 42, 26, 16, 58, 100, 150, 273, 1299
INVAR-9, Run: 014, P, 0, 320, 0, 0, 0, 60, 60, 0, 0, 1, 0, 20, 100, 269, 1736, 40, 27, 12, 60, 100, 150, 329, 1736
INVAR-9, Run: 015, P, 0, 316, 0, 0, 0, 58, 58, 0, 0, 1, 0, 16, 100, 204, 1534, 42, 32, 9, 58, 100, 150, 262, 1534
INVAR-9, Run: 016, P, 0, 23, 0, 0, 0, 0, 287, 55, 287, 0, 0, 10, 100, 351, 1218, 45, 26, 19, 55, 100, 150, 351, 1505
INVAR-9, Run: 017, P, 0, 281, 0, 0, 0, 0, 29, 55, 29, 0, 0, 10, 100, 404, 1475, 45, 23, 22, 55, 100, 150, 404, 1504
INVAR-9, Run: 018, P, 0, 314, 0, 0, 0, 57, 57, 0, 0, 1, 0, 14, 100, 318, 1293, 43, 24, 18, 57, 100, 150, 375, 1293
INVAR-9, Run: 019, P, 0, 314, 0, 0, 0, 57, 57, 0, 0, 1, 0, 14, 100, 437, 2088, 43, 28, 14, 57, 100, 150, 494, 2088
INVAR-9, Run: 020, P, 0, 306, 0, 0, 0, 53, 53, 0, 0, 1, 0, 6, 100, 258, 1856, 47, 32, 14, 53, 100, 150, 311, 1856
INVAR-9, Run: 021, P, 0, 163, 0, 0, 0, 0, 153, 58, 153, 0, 0, 16, 100, 328, 1867, 42, 33, 9, 58, 100, 150, 328, 2020
INVAR-9, Run: 022, P, 0, 314, 0, 0, 0, 57, 57, 0, 0, 1, 0, 14, 100, 331, 1343, 43, 29, 13, 57, 100, 150, 388, 1343
INVAR-9, Run: 023, P, 0, 314, 0, 0, 0, 57, 57, 0, 0, 1, 0, 14, 100, 355, 1754, 43, 28, 14, 57, 100, 150, 412, 1754
INVAR-9, Run: 024, P, 0, 310, 0, 0, 0, 55, 55, 0, 0, 1, 0, 10, 100, 229, 1182, 45, 30, 14, 55, 100, 150, 284, 1182
INVAR-9, Run: 025, P, 0, 312, 0, 0, 0, 56, 56, 0, 0, 1, 0, 12, 100, 254, 1938, 44, 25, 18, 56, 100, 150, 310, 1938
INVAR-9, Run: 026, P, 0, 19, 0, 0, 0, 0, 295, 57, 295, 0, 0, 14, 100, 288, 1570, 43, 22, 21, 57, 100, 150, 288, 1865
INVAR-9, Run: 027, P, 0, 318, 0, 0, 0, 59, 59, 0, 0, 1, 0, 18, 100, 317, 1810, 41, 27, 13, 59, 100, 150, 376, 1810
INVAR-9, Run: 028, P, 0, 310, 0, 0, 0, 55, 55, 0, 0, 1, 0, 10, 100, 373, 2307, 45, 28, 16, 55, 100, 150, 428, 2307
INVAR-9, Run: 029, P, 0, 314, 0, 0, 0, 57, 57, 0, 0, 1, 0, 14, 100, 401, 1315, 43, 21, 21, 57, 100, 150, 458, 1315
INVAR-9, Run: 030, P, 0, 132, 0, 0, 0, 0, 180, 56, 180, 0, 0, 12, 100, 323, 1288, 44, 18, 26, 56, 100, 150, 323, 1468
INVAR-9, Run: 031, P, 0, 152, 0, 0, 0, 0, 166, 59, 166, 0, 0, 18, 100, 304, 1834, 41, 28, 13, 59, 100, 150, 304, 2000
INVAR-9, Run: 032, P, 0, 12, 0, 0, 0, 0, 304, 58, 304, 0, 0, 16, 100, 272, 1161, 42, 32, 10, 58, 100, 150, 272, 1465
INVAR-9, Run: 033, P, 0, 55, 0, 0, 0, 0, 263, 59, 263, 0, 0, 18, 100, 251, 1024, 41, 19, 22, 59, 100, 150, 251, 1287
INVAR-9, Run: 034, P, 0, 312, 0, 0, 0, 56, 56, 0, 0, 1, 0, 12, 100, 250, 1697, 44, 23, 20, 56, 100, 150, 306, 1697
INVAR-9, Run: 035, P, 0, 165, 0, 0, 0, 0, 147, 56, 147, 0, 0, 12, 100, 462, 1702, 44, 27, 17, 56, 100, 150, 462, 1849
INVAR-9, Run: 036, P, 0, 314, 0, 0, 0, 57, 57, 0, 0, 1, 0, 14, 100, 461, 1920, 43, 23, 19, 57, 100, 150, 518, 1920
INVAR-9, Run: 037, P, 0, 80, 0, 0, 0, 0, 236, 58, 236, 0, 0, 16, 100, 329, 1646, 42, 25, 17, 58, 100, 150, 329, 1882
INVAR-9, Run: 038, P, 0, 258, 0, 0, 0, 0, 56, 57, 56, 0, 0, 14, 100, 313, 1578, 43, 21, 22, 57, 100, 150, 313, 1634
INVAR-9, Run: 039, P, 0, 161, 0, 0, 0, 0, 153, 57, 153, 0, 0, 14, 100, 192, 1045, 43, 30, 13, 57, 100, 150, 192, 1198
INVAR-9, Run: 040, P, 0, 45, 0, 0, 0, 0, 271, 58, 271, 0, 0, 16, 100, 221, 1449, 42, 28, 14, 58, 100, 150, 221, 1720
INVAR-9, Run: 041, P, 0, 21, 0, 0, 0, 0, 299, 60, 299, 0, 0, 20, 100, 218, 969, 40, 27, 13, 60, 100, 150, 218, 1268
INVAR-9, Run: 042, P, 0, 312, 0, 0, 0, 56, 56, 0, 0, 1, 0, 12, 100, 403, 1246, 44, 22, 21, 56, 100, 150, 459, 1246
INVAR-9, Run: 043, P, 0, 314, 0, 0, 0, 57, 57, 0, 0, 1, 0, 14, 100, 256, 1453, 43, 29, 13, 57, 100, 150, 313, 1453
INVAR-9, Run: 044, P, 0, 312, 0, 0, 0, 56, 56, 0, 0, 1, 0, 12, 100, 178, 962, 44, 31, 12, 56, 100, 150, 234, 962
INVAR-9, Run: 045, P, 0, 82, 0, 0, 0, 0, 236, 59, 236, 0, 0, 18, 100, 335, 1666, 41, 20, 21, 59, 100, 150, 335, 1902
INVAR-9, Run: 046, P, 0, 310, 0, 0, 0, 55, 55, 0, 0, 1, 0, 10, 100, 323, 1691, 45, 29, 15, 55, 100, 150, 378, 1691
INVAR-9, Run: 047, P, 0, 310, 0, 0, 0, 55, 55, 0, 0, 1, 0, 10, 100, 378, 1742, 45, 29, 15, 55, 100, 150, 433, 1742
INVAR-9, Run: 048, P, 0, 133, 0, 0, 0, 0, 183, 58, 183, 0, 0, 16, 100, 294, 1363, 42, 24, 18, 58, 100, 150, 294, 1546
INVAR-9, Run: 049, P, 0, 314, 0, 0, 0, 57, 57, 0, 0, 1, 0, 14, 100, 268, 1557, 43, 26, 16, 57, 100, 150, 325, 1557
INVAR-9, Run: 050, P, 0, 51, 0, 0, 0, 0, 265, 58, 265, 0, 0, 16, 100, 297, 1740, 42, 25, 17, 58, 100, 150, 297, 2005
INVAR-9, Run: 051, P, 0, 174, 0, 0, 0, 0, 138, 56, 138, 0, 0, 12, 100, 280, 1243, 44, 33, 11, 56, 100, 150, 280, 1381
INVAR-9, Run: 052, P, 0, 318, 0, 0, 0, 59, 59, 0, 0, 1, 0, 18, 100, 183, 1281, 41, 28, 12, 59, 100, 150, 242, 1281
INVAR-9, Run: 053, P, 0, 71, 0, 0, 0, 0, 249, 60, 249, 0, 0, 20, 100, 271, 1262, 40, 30, 10, 60, 100, 150, 271, 1511
INVAR-9, Run: 054, P, 0, 264, 0, 0, 0, 0, 54, 59, 54, 0, 0, 18, 100, 331, 1607, 41, 27, 14, 59, 100, 150, 331, 1661
INVAR-9, Run: 055, P, 0, 50, 0, 0, 0, 0, 264, 57, 264, 0, 0, 14, 100, 208, 1232, 43, 29, 14, 57, 100, 150, 208, 1496
INVAR-9, Run: 056, P, 0, 181, 0, 0, 0, 0, 137, 59, 137, 0, 0, 18, 100, 223, 1253, 41, 25, 16, 59, 100, 150, 223, 1390
INVAR-9, Run: 057, P, 0, 312, 0, 0, 0, 56, 56, 0, 0, 1, 0, 12, 100, 305, 1674, 44, 29, 14, 56, 100, 150, 361, 1674
INVAR-9, Run: 058, P, 0, 316, 0, 0, 0, 58, 58, 0, 0, 1, 0, 16, 100, 317, 1969, 42, 27, 14, 58, 100, 150, 375, 1969
INVAR-9, Run: 059, P, 0, 13, 0, 0, 0, 0, 293, 53, 293, 0, 0, 6, 100, 318, 1339, 47, 29, 18, 53, 100, 150, 318, 1632
INVAR-9, Run: 060, P, 0, 314, 0, 0, 0, 57, 57, 0, 0, 1, 0, 14, 100, 295, 1555, 43, 26, 16, 57, 100, 150, 352, 1555
INVAR-9, Run: 061, P, 0, 162, 0, 0, 0, 0, 150, 56, 150, 0, 0, 12, 100, 254, 1349, 44, 28, 16, 56, 100, 150, 254, 1499
INVAR-9, Run: 062, P, 0, 310, 0, 0, 0, 55, 55, 0, 0, 1, 0, 10, 100, 266, 1353, 45, 23, 21, 55, 100, 150, 321, 1353
INVAR-9, Run: 063, P, 0, 22, 0, 0, 0, 0, 292, 57, 292, 0, 0, 14, 100, 230, 1259, 43, 28, 15, 57, 100, 150, 230, 1551
INVAR-9, Run: 064, P, 0, 17, 0, 0, 0, 0, 297, 57, 297, 0, 0, 14, 100, 336, 1161, 43, 23, 20, 57, 100, 150, 336, 1458
INVAR-9, Run: 065, P, 0, 304, 0, 0, 0, 52, 52, 0, 0, 1, 0, 4, 100, 367, 1685, 48, 35, 12, 52, 100, 150, 419, 1685
INVAR-9, Run: 066, P, 0, 17, 0, 0, 0, 0, 297, 57, 297, 0, 0, 14, 100, 273, 1641, 43, 23, 20, 57, 100, 150, 273, 1938
INVAR-9, Run: 067, P, 0, 310, 0, 0, 0, 55, 55, 0, 0, 1, 0, 10, 100, 282, 1483, 45, 27, 17, 55, 100, 150, 337, 1483
INVAR-9, Run: 068, P, 0, 314, 0, 0, 0, 57, 57, 0, 0, 1, 0, 14, 100, 352, 1899, 43, 31, 11, 57, 100, 150, 409, 1899
INVAR-9, Run: 069, P, 0, 89, 0, 0, 0, 0, 229, 59, 229, 0, 0, 18, 100, 231, 709, 41, 24, 17, 59, 100, 150, 231, 938
INVAR-9, Run: 070, P, 0, 310, 0, 0, 0, 55, 55, 0, 0, 1, 0, 10, 100, 299, 1460, 45, 29, 15, 55, 100, 150, 354, 1460
INVAR-9, Run: 071, P, 0, 38, 0, 0, 0, 0, 270, 54, 270, 0, 0, 8, 100, 304, 1383, 46, 30, 16, 54, 100, 150, 304, 1653
INVAR-9, Run: 072, P, 0, 163, 0, 0, 0, 0, 151, 57, 151, 0, 0, 14, 100, 282, 1083, 43, 25, 18, 57, 100, 150, 282, 1234
INVAR-9, Run: 073, P, 0, 320, 0, 0, 0, 60, 60, 0, 0, 1, 0, 20, 100, 253, 1482, 40, 25, 14, 60, 100, 150, 313, 1482
INVAR-9, Run: 074, P, 0, 77, 0, 0, 0, 0, 235, 56, 235, 0, 0, 12, 100, 194, 1117, 44, 26, 18, 56, 100, 150, 194, 1352
INVAR-9, Run: 075, P, 0, 93, 0, 0, 0, 0, 221, 57, 221, 0, 0, 14, 100, 242, 1090, 43, 29, 14, 57, 100, 150, 242, 1311
INVAR-9, Run: 076, P, 0, 318, 0, 0, 0, 59, 59, 0, 0, 1, 0, 18, 100, 427, 1277, 41, 24, 16, 59, 100, 150, 486, 1277
INVAR-9, Run: 077, P, 0, 52, 0, 0, 0, 0, 262, 57, 262, 0, 0, 14, 100, 258, 1184, 43, 27, 16, 57, 100, 150, 258, 1446
INVAR-9, Run: 078, P, 0, 144, 0, 0, 0, 0, 178, 61, 178, 0, 0, 22, 100, 312, 1842, 39, 25, 14, 61, 100, 150, 312, 2020
INVAR-9, Run: 079, P, 0, 63, 0, 0, 0, 0, 255, 59, 255, 0, 0, 18, 100, 265, 1463, 41, 27, 14, 59, 100, 150, 265, 1718
INVAR-9, Run: 080, P, 0, 308, 0, 0, 0, 54, 54, 0, 0, 1, 0, 8, 100, 275, 1542, 46, 32, 13, 54, 100, 150, 329, 1542
INVAR-9, Run: 081, P, 0, 128, 0, 0, 0, 0, 186, 57, 186, 0, 0, 14, 100, 266, 1433, 43, 23, 20, 57, 100, 150, 266, 1619
INVAR-9, Run: 082, P, 0, 43, 0, 0, 0, 0, 277, 60, 277, 0, 0, 20, 100, 325, 1206, 40, 24, 16, 60, 100, 150, 325, 1483
INVAR-9, Run: 083, P, 0, 310, 0, 0, 0, 55, 55, 0, 0, 1, 0, 10, 100, 311, 1856, 45, 33, 11, 55, 100, 150, 366, 1856
INVAR-9, Run: 084, P, 0, 314, 0, 0, 0, 57, 57, 0, 0, 1, 0, 14, 100, 390, 1745, 43, 28, 14, 57, 100, 150, 447, 1745
INVAR-9, Run: 085, P, 0, 310, 0, 0, 0, 55, 55, 0, 0, 1, 0, 10, 100, 353, 1386, 45, 29, 15, 55, 100, 150, 408, 1386
INVAR-9, Run: 086, P, 0, 310, 0, 0, 0, 55, 55, 0, 0, 1, 0, 10, 100, 321, 1396, 45, 24, 20, 55, 100, 150, 376, 1396
INVAR-9, Run: 087, P, 0, 31, 0, 0, 0, 0, 285, 58, 285, 0, 0, 16, 100, 257, 1293, 42, 28, 14, 58, 100, 150, 257, 1578
INVAR-9, Run: 088, P, 0, 312, 0, 0, 0, 56, 56, 0, 0, 1, 0, 12, 100, 240, 955, 44, 21, 22, 56, 100, 150, 296, 955
INVAR-9, Run: 089, P, 0, 10, 0, 0, 0, 0, 310, 60, 310, 0, 0, 20, 100, 212, 1465, 40, 29, 11, 60, 100, 150, 212, 1775
INVAR-9, Run: 090, P, 0, 50, 0, 0, 0, 0, 264, 57, 264, 0, 0, 14, 100, 429, 2239, 43, 25, 18, 57, 100, 150, 429, 2503
INVAR-9, Run: 091, P, 0, 308, 0, 0, 0, 54, 54, 0, 0, 1, 0, 8, 100, 344, 1617, 46, 22, 23, 54, 100, 150, 398, 1617
INVAR-9, Run: 092, P, 0, 310, 0, 0, 0, 55, 55, 0, 0, 1, 0, 10, 100, 344, 1313, 45, 27, 17, 55, 100, 150, 399, 1313
INVAR-9, Run: 093, P, 0, 20, 0, 0, 0, 0, 292, 56, 292, 0, 0, 12, 100, 231, 1141, 44, 31, 13, 56, 100, 150, 231, 1433
INVAR-9, Run: 094, P, 0, 72, 0, 0, 0, 0, 242, 57, 242, 0, 0, 14, 100, 217, 1227, 43, 29, 14, 57, 100, 150, 217, 1469
INVAR-9, Run: 095, P, 0, 31, 0, 0, 0, 0, 279, 55, 279, 0, 0, 10, 100, 242, 1135, 45, 31, 14, 55, 100, 150, 242, 1414
INVAR-9, Run: 096, P, 0, 50, 0, 0, 0, 0, 270, 60, 270, 0, 0, 20, 100, 169, 1246, 40, 31, 9, 60, 100, 150, 169, 1516
INVAR-9, Run: 097, P, 0, 37, 0, 0, 0, 0, 281, 59, 281, 0, 0, 18, 100, 271, 1193, 41, 27, 14, 59, 100, 150, 271, 1474
INVAR-9, Run: 098, P, 0, 312, 0, 0, 0, 56, 56, 0, 0, 1, 0, 12, 100, 305, 1901, 44, 36, 7, 56, 100, 150, 361, 1901
INVAR-9, Run: 099, P, 0, 312, 0, 0, 0, 56, 56, 0, 0, 1, 0, 12, 100, 323, 1522, 44, 31, 12, 56, 100, 150, 379, 1522
INVAR-9, Run: 100, P, 0, 316, 0, 0, 0, 58, 58, 0, 0, 1, 0, 16, 100, 309, 1178, 42, 25, 16, 58, 100, 150, 367, 1178
